PokerStars Hand #254375873978:  Hold'em No Limit ($0.50/$1.00 USD) - 2025/01/14 0:38:50 WET [2025/01/14 19:38:50 ET]
Table 'Phaetusa III' 6-max Seat #6 is the button
Seat 1: sutata ($108.57 in chips) 
Seat 2: uuzka ($100 in chips) 
Seat 3: biggg_guyyy ($84.05 in chips) 
Seat 4: MaRKiToScoK ($101.50 in chips) 
Seat 5: nikalas22 ($102.94 in chips) 
Seat 6: BeauParleur ($100 in chips) 
sutata: posts small blind $0.50
uuzka: posts big blind $1
*** HOLE CARDS ***
biggg_guyyy: calls $1
MaRKiToScoK: folds 
nikalas22: folds 
BeauParleur: folds 
sutata: folds 
uuzka: checks 
*** FLOP *** [5c 5s 3h]
uuzka: checks 
biggg_guyyy: checks 
*** TURN *** [5c 5s 3h] [9s]
uuzka: bets $1.09
biggg_guyyy: raises $2.28 to $3.37
uuzka: folds 
Uncalled bet ($2.28) returned to biggg_guyyy
biggg_guyyy collected $4.45 from pot
*** SUMMARY ***
Total pot $4.68 | Rake $0.23 
Board [5c 5s 3h 9s]
Seat 1: sutata (small blind) folded before Flop
Seat 2: uuzka (big blind) folded on the Turn
Seat 3: biggg_guyyy collected ($4.45)
Seat 4: MaRKiToScoK folded before Flop (didn't bet)
Seat 5: nikalas22 folded before Flop (didn't bet)
Seat 6: BeauParleur (button) folded before Flop (didn't bet)



PokerStars Hand #254375884165:  Hold'em No Limit ($0.50/$1.00 USD) - 2025/01/14 0:39:43 WET [2025/01/14 19:39:43 ET]
Table 'Phaetusa III' 6-max Seat #1 is the button
Seat 1: sutata ($108.07 in chips) 
Seat 2: uuzka ($100 in chips) 
Seat 3: biggg_guyyy ($86.41 in chips) 
Seat 4: MaRKiToScoK ($101.50 in chips) 
Seat 5: nikalas22 ($102.94 in chips) 
Seat 6: BeauParleur ($100 in chips) 
uuzka: posts small blind $0.50
biggg_guyyy: posts big blind $1
*** HOLE CARDS ***
MaRKiToScoK: raises $1.10 to $2.10
nikalas22: folds 
BeauParleur: folds 
sutata: calls $2.10
uuzka: folds 
biggg_guyyy: folds 
*** FLOP *** [8c Jc Qc]
MaRKiToScoK: bets $1.13
sutata: calls $1.13
*** TURN *** [8c Jc Qc] [4s]
MaRKiToScoK: checks 
sutata: checks 
*** RIVER *** [8c Jc Qc 4s] [7s]
MaRKiToScoK: checks 
sutata: bets $4.99
MaRKiToScoK: folds 
Uncalled bet ($4.99) returned to sutata
sutata collected $7.56 from pot
sutata: doesn't show hand 
*** SUMMARY ***
Total pot $7.96 | Rake $0.40 
Board [8c Jc Qc 4s 7s]
Seat 1: sutata (button) collected ($7.56)
Seat 2: uuzka (small blind) folded before Flop
Seat 3: biggg_guyyy (big blind) folded before Flop
Seat 4: MaRKiToScoK folded on the River
Seat 5: nikalas22 folded before Flop (didn't bet)
Seat 6: BeauParleur folded before Flop (didn't bet)



PokerStars Hand #254375891667:  Hold'em No Limit ($0.50/$1.00 USD) - 2025/01/14 0:40:22 WET [2025/01/14 19:40:22 ET]
Table 'Phaetusa III' 6-max Seat #2 is the button
Seat 1: sutata ($112.40 in chips) 
Seat 2: uuzka ($100 in chips) 
Seat 3: biggg_guyyy ($85.41 in chips) 
Seat 4: MaRKiToScoK ($100 in chips) 
Seat 5: nikalas22 ($102.94 in chips) 
Seat 6: BeauParleur ($100 in chips) 
biggg_guyyy: posts small blind $0.50
MaRKiToScoK: posts big blind $1
*** HOLE CARDS ***
nikalas22: folds 
BeauParleur: folds 
sutata: folds 
uuzka: folds 
biggg_guyyy: calls $0.50
MaRKiToScoK: raises $3 to $4
biggg_guyyy: calls $3
*** FLOP *** [Ts 7s 6s]
biggg_guyyy: bets $7.60
MaRKiToScoK: folds 
Uncalled bet ($7.60) returned to biggg_guyyy
biggg_guyyy collected $7.60 from pot
*** SUMMARY ***
Total pot $8 | Rake $0.40 
Board [Ts 7s 6s]
Seat 1: sutata folded before Flop (didn't bet)
Seat 2: uuzka (button) folded before Flop (didn't bet)
Seat 3: biggg_guyyy (small blind) collected ($7.60)
Seat 4: MaRKiToScoK (big blind) folded on the Flop
Seat 5: nikalas22 folded before Flop (didn't bet)
Seat 6: BeauParleur folded before Flop (didn't bet)



PokerStars Hand #254375897515:  Hold'em No Limit ($0.50/$1.00 USD) - 2025/01/14 0:40:53 WET [2025/01/14 19:40:53 ET]
Table 'Phaetusa III' 6-max Seat #3 is the button
Seat 1: sutata ($112.40 in chips) 
Seat 2: uuzka ($100 in chips) 
Seat 3: biggg_guyyy ($89.01 in chips) 
Seat 4: MaRKiToScoK ($100 in chips) 
Seat 5: nikalas22 ($102.94 in chips) 
Seat 6: BeauParleur ($100 in chips) 
MaRKiToScoK: posts small blind $0.50
nikalas22: posts big blind $1
*** HOLE CARDS ***
BeauParleur: folds 
sutata: folds 
uuzka: raises $1.50 to $2.50
biggg_guyyy: calls $2.50
MaRKiToScoK: calls $2
nikalas22: folds 
*** FLOP *** [5s 6s 2s]
MaRKiToScoK: checks 
uuzka: checks 
biggg_guyyy: bets $8.08
MaRKiToScoK has timed out
MaRKiToScoK: folds 
uuzka: folds 
Uncalled bet ($8.08) returned to biggg_guyyy
biggg_guyyy collected $8.08 from pot
*** SUMMARY ***
Total pot $8.50 | Rake $0.42 
Board [5s 6s 2s]
Seat 1: sutata folded before Flop (didn't bet)
Seat 2: uuzka folded on the Flop
Seat 3: biggg_guyyy (button) collected ($8.08)
Seat 4: MaRKiToScoK (small blind) folded on the Flop
Seat 5: nikalas22 (big blind) folded before Flop
Seat 6: BeauParleur folded before Flop (didn't bet)



PokerStars Hand #254375913817:  Hold'em No Limit ($0.50/$1.00 USD) - 2025/01/14 0:42:16 WET [2025/01/14 19:42:16 ET]
Table 'Phaetusa III' 6-max Seat #4 is the button
Seat 3: biggg_guyyy ($94.59 in chips) is sitting out
Seat 1: sutata ($112.40 in chips) 
Seat 2: uuzka ($100 in chips) 
Seat 4: MaRKiToScoK ($100 in chips) 
Seat 5: nikalas22 ($101.94 in chips) 
Seat 6: BeauParleur ($100 in chips) 
nikalas22: posts small blind $0.50
BeauParleur: posts big blind $1
*** HOLE CARDS ***
sutata: folds 
biggg_guyyy leaves the table
uuzka: folds 
MaRKiToScoK: folds 
nikalas22: raises $2 to $3
BeauParleur: folds 
Uncalled bet ($2) returned to nikalas22
nikalas22 collected $2 from pot
nikalas22: doesn't show hand 
*** SUMMARY ***
Total pot $2 | Rake $0 
Seat 3: biggg_guyyy
Seat 1: sutata folded before Flop (didn't bet)
Seat 2: uuzka folded before Flop (didn't bet)
Seat 4: MaRKiToScoK (button) folded before Flop (didn't bet)
Seat 5: nikalas22 (small blind) collected ($2)
Seat 6: BeauParleur (big blind) folded before Flop



PokerStars Hand #254375917424:  Hold'em No Limit ($0.50/$1.00 USD) - 2025/01/14 0:42:34 WET [2025/01/14 19:42:34 ET]
Table 'Phaetusa III' 6-max Seat #5 is the button
Seat 1: sutata ($112.40 in chips) is sitting out
Seat 2: uuzka ($100 in chips) is sitting out
Seat 4: MaRKiToScoK ($100 in chips) 
Seat 5: nikalas22 ($102.94 in chips) 
Seat 6: BeauParleur ($100 in chips) 
BeauParleur: posts small blind $0.50
sutata: is sitting out 
uuzka: is sitting out 
MaRKiToScoK: posts big blind $1
*** HOLE CARDS ***
nikalas22: folds 
sutata leaves the table
BeauParleur: raises $2 to $3
MaRKiToScoK: folds 
Uncalled bet ($2) returned to BeauParleur
BeauParleur collected $2 from pot
BeauParleur: doesn't show hand 
*** SUMMARY ***
Total pot $2 | Rake $0 
Seat 1: sutata
Seat 2: uuzka
Seat 4: MaRKiToScoK (big blind) folded before Flop
Seat 5: nikalas22 (button) folded before Flop (didn't bet)
Seat 6: BeauParleur (small blind) collected ($2)



PokerStars Hand #254375922492:  Hold'em No Limit ($0.50/$1.00 USD) - 2025/01/14 0:43:01 WET [2025/01/14 19:43:01 ET]
Table 'Phaetusa III' 6-max Seat #4 is the button
Seat 2: uuzka ($100 in chips) is sitting out
Seat 5: nikalas22 ($102.94 in chips) is sitting out
Seat 4: MaRKiToScoK ($100 in chips) 
Seat 6: BeauParleur ($101 in chips) 
MaRKiToScoK: posts small blind $0.50
nikalas22: is sitting out 
BeauParleur: posts big blind $1
*** HOLE CARDS ***
MaRKiToScoK: raises $1.75 to $2.75
nikalas22 leaves the table
BeauParleur: raises $8.25 to $11
MaRKiToScoK: folds 
Uncalled bet ($8.25) returned to BeauParleur
BeauParleur collected $5.50 from pot
BeauParleur: doesn't show hand 
*** SUMMARY ***
Total pot $5.50 | Rake $0 
Seat 2: uuzka
Seat 5: nikalas22
Seat 4: MaRKiToScoK (button) (small blind) folded before Flop
Seat 6: BeauParleur (big blind) collected ($5.50)



