PokerStars Hand #254515896214:  Hold'em No Limit ($0.50/$1.00 USD) - 2025/01/23 16:55:17 WET [2025/01/23 11:55:17 ET]
Table 'Helewalda IV' 6-max Seat #6 is the button
Seat 2: Evelexy1 ($101.50 in chips) is sitting out
Seat 1: reiyser ($100 in chips) 
Seat 3: fugitive-Ty3 ($100 in chips) 
Seat 6: Eredar5 ($100 in chips) 
reiyser: posts small blind $0.50
fugitive-Ty3: posts big blind $1
*** HOLE CARDS ***
Evelexy1 leaves the table
Eredar5: folds 
reiyser: raises $1.80 to $2.80
fugitive-Ty3: folds 
Uncalled bet ($1.80) returned to reiyser
reiyser collected $2 from pot
reiyser: doesn't show hand 
*** SUMMARY ***
Total pot $2 | Rake $0 
Seat 2: Evelexy1
Seat 1: reiyser (small blind) collected ($2)
Seat 3: fugitive-Ty3 (big blind) folded before Flop
Seat 6: Eredar5 (button) folded before Flop (didn't bet)



PokerStars Hand #254515921661:  Hold'em No Limit ($0.50/$1.00 USD) - 2025/01/23 16:57:59 WET [2025/01/23 11:57:59 ET]
Table 'Helewalda IV' 6-max Seat #1 is the button
Seat 1: Evelexy1 ($101.50 in chips) 
Seat 2: AIien Hand ($100 in chips) 
Seat 3: IvelinKocev1337 ($53.23 in chips) 
Seat 4: nastja336 ($100 in chips) 
Seat 5: blistein ($100 in chips) 
Seat 6: Alinyr ($100 in chips) 
AIien Hand: posts small blind $0.50
IvelinKocev1337: posts big blind $1
*** HOLE CARDS ***
nastja336: folds 
blistein: folds 
Alinyr: raises $1.28 to $2.28
Evelexy1: raises $4.56 to $6.84
AIien Hand: folds 
IvelinKocev1337: folds 
Alinyr: folds 
Uncalled bet ($4.56) returned to Evelexy1
Evelexy1 collected $6.06 from pot
Evelexy1: doesn't show hand 
*** SUMMARY ***
Total pot $6.06 | Rake $0 
Seat 1: Evelexy1 (button) collected ($6.06)
Seat 2: AIien Hand (small blind) folded before Flop
Seat 3: IvelinKocev1337 (big blind) folded before Flop
Seat 4: nastja336 folded before Flop (didn't bet)
Seat 5: blistein folded before Flop (didn't bet)
Seat 6: Alinyr folded before Flop



PokerStars Hand #254515924045:  Hold'em No Limit ($0.50/$1.00 USD) - 2025/01/23 16:58:15 WET [2025/01/23 11:58:15 ET]
Table 'Helewalda IV' 6-max Seat #2 is the button
Seat 2: AIien Hand ($100 in chips) 
Seat 3: IvelinKocev1337 ($53.23 in chips) 
Seat 4: nastja336 ($100 in chips) 
Seat 5: blistein ($100 in chips) 
Seat 6: Alinyr ($100 in chips) 
IvelinKocev1337: posts small blind $0.50
nastja336: posts big blind $1
*** HOLE CARDS ***
blistein: folds 
Alinyr: folds 
AIien Hand: folds 
IvelinKocev1337: raises $2 to $3
jeffy27dt1 joins the table at seat #1 
nastja336: calls $2
*** FLOP *** [2c Kh 8h]
IvelinKocev1337: bets $1.71
nastja336: calls $1.71
*** TURN *** [2c Kh 8h] [Js]
IvelinKocev1337: bets $4.48
nastja336: folds 
Uncalled bet ($4.48) returned to IvelinKocev1337
IvelinKocev1337 collected $8.95 from pot
IvelinKocev1337: doesn't show hand 
*** SUMMARY ***
Total pot $9.42 | Rake $0.47 
Board [2c Kh 8h Js]
Seat 2: AIien Hand (button) folded before Flop (didn't bet)
Seat 3: IvelinKocev1337 (small blind) collected ($8.95)
Seat 4: nastja336 (big blind) folded on the Turn
Seat 5: blistein folded before Flop (didn't bet)
Seat 6: Alinyr folded before Flop (didn't bet)



PokerStars Hand #254515929137:  Hold'em No Limit ($0.50/$1.00 USD) - 2025/01/23 16:58:48 WET [2025/01/23 11:58:48 ET]
Table 'Helewalda IV' 6-max Seat #3 is the button
Seat 1: jeffy27dt1 ($100 in chips) is sitting out
Seat 2: AIien Hand ($100 in chips) 
Seat 3: IvelinKocev1337 ($57.47 in chips) 
Seat 4: nastja336 ($100 in chips) 
Seat 5: blistein ($100 in chips) 
Seat 6: Alinyr ($100 in chips) 
nastja336: posts small blind $0.50
blistein: posts big blind $1
jeffy27dt1: sits out 
*** HOLE CARDS ***
Alinyr: raises $1.05 to $2.05
AIien Hand: folds 
IvelinKocev1337: folds 
nastja336: raises $9.95 to $12
blistein: folds 
Alinyr: folds 
Uncalled bet ($9.95) returned to nastja336
nastja336 collected $5.10 from pot
nastja336: doesn't show hand 
*** SUMMARY ***
Total pot $5.10 | Rake $0 
Seat 1: jeffy27dt1
Seat 2: AIien Hand folded before Flop (didn't bet)
Seat 3: IvelinKocev1337 (button) folded before Flop (didn't bet)
Seat 4: nastja336 (small blind) collected ($5.10)
Seat 5: blistein (big blind) folded before Flop
Seat 6: Alinyr folded before Flop



PokerStars Hand #254515932339:  Hold'em No Limit ($0.50/$1.00 USD) - 2025/01/23 16:59:09 WET [2025/01/23 11:59:09 ET]
Table 'Helewalda IV' 6-max Seat #4 is the button
Seat 1: jeffy27dt1 ($100 in chips) is sitting out
Seat 2: AIien Hand ($100 in chips) 
Seat 3: IvelinKocev1337 ($57.47 in chips) 
Seat 4: nastja336 ($103.05 in chips) 
Seat 5: blistein ($100 in chips) 
Seat 6: Alinyr ($100 in chips) 
blistein: posts small blind $0.50
Alinyr: posts big blind $1
jeffy27dt1: sits out 
*** HOLE CARDS ***
AIien Hand: folds 
IvelinKocev1337: raises $1 to $2
nastja336: raises $4 to $6
blistein: raises $13 to $19
Alinyr: folds 
IvelinKocev1337: raises $38.47 to $57.47 and is all-in
nastja336: folds 
blistein: calls $38.47
*** FLOP *** [3h As 7d]
*** TURN *** [3h As 7d] [8d]
*** RIVER *** [3h As 7d 8d] [9h]
*** SHOW DOWN ***
blistein: shows [Kd Kh] (a pair of Kings)
IvelinKocev1337: shows [Td Ad] (a pair of Aces)
IvelinKocev1337 collected $119.44 from pot
*** SUMMARY ***
Total pot $121.94 | Rake $2.50 
Board [3h As 7d 8d 9h]
Seat 1: jeffy27dt1
Seat 2: AIien Hand folded before Flop (didn't bet)
Seat 3: IvelinKocev1337 showed [Td Ad] and won ($119.44) with a pair of Aces
Seat 4: nastja336 (button) folded before Flop
Seat 5: blistein (small blind) showed [Kd Kh] and lost with a pair of Kings
Seat 6: Alinyr (big blind) folded before Flop



PokerStars Hand #254515938578:  Hold'em No Limit ($0.50/$1.00 USD) - 2025/01/23 16:59:49 WET [2025/01/23 11:59:49 ET]
Table 'Helewalda IV' 6-max Seat #5 is the button
Seat 1: jeffy27dt1 ($100 in chips) 
Seat 2: AIien Hand ($100 in chips) 
Seat 3: IvelinKocev1337 ($119.44 in chips) 
Seat 4: nastja336 ($100 in chips) 
Seat 5: blistein ($100 in chips) 
Seat 6: Alinyr ($100 in chips) 
Alinyr: posts small blind $0.50
jeffy27dt1: posts big blind $1
*** HOLE CARDS ***
AIien Hand: folds 
IvelinKocev1337: folds 
nastja336: raises $1.50 to $2.50
blistein: folds 
Alinyr: folds 
jeffy27dt1: folds 
Uncalled bet ($1.50) returned to nastja336
nastja336 collected $2.50 from pot
nastja336: doesn't show hand 
*** SUMMARY ***
Total pot $2.50 | Rake $0 
Seat 1: jeffy27dt1 (big blind) folded before Flop
Seat 2: AIien Hand folded before Flop (didn't bet)
Seat 3: IvelinKocev1337 folded before Flop (didn't bet)
Seat 4: nastja336 collected ($2.50)
Seat 5: blistein (button) folded before Flop (didn't bet)
Seat 6: Alinyr (small blind) folded before Flop



PokerStars Hand #254515941192:  Hold'em No Limit ($0.50/$1.00 USD) - 2025/01/23 17:00:05 WET [2025/01/23 12:00:05 ET]
Table 'Helewalda IV' 6-max Seat #6 is the button
Seat 1: jeffy27dt1 ($100 in chips) 
Seat 2: AIien Hand ($100 in chips) 
Seat 3: IvelinKocev1337 ($119.44 in chips) 
Seat 4: nastja336 ($101.50 in chips) 
Seat 5: blistein ($100 in chips) 
Seat 6: Alinyr ($100 in chips) 
jeffy27dt1: posts small blind $0.50
AIien Hand: posts big blind $1
*** HOLE CARDS ***
IvelinKocev1337: folds 
nastja336: raises $1.50 to $2.50
blistein: folds 
Alinyr: folds 
jeffy27dt1: folds 
AIien Hand: folds 
Uncalled bet ($1.50) returned to nastja336
nastja336 collected $2.50 from pot
nastja336: doesn't show hand 
*** SUMMARY ***
Total pot $2.50 | Rake $0 
Seat 1: jeffy27dt1 (small blind) folded before Flop
Seat 2: AIien Hand (big blind) folded before Flop
Seat 3: IvelinKocev1337 folded before Flop (didn't bet)
Seat 4: nastja336 collected ($2.50)
Seat 5: blistein folded before Flop (didn't bet)
Seat 6: Alinyr (button) folded before Flop (didn't bet)



PokerStars Hand #254515944892:  Hold'em No Limit ($0.50/$1.00 USD) - 2025/01/23 17:00:28 WET [2025/01/23 12:00:28 ET]
Table 'Helewalda IV' 6-max Seat #1 is the button
Seat 1: jeffy27dt1 ($100 in chips) 
Seat 2: AIien Hand ($100 in chips) 
Seat 3: IvelinKocev1337 ($119.44 in chips) 
Seat 4: nastja336 ($103 in chips) 
Seat 5: blistein ($100 in chips) 
Seat 6: Alinyr ($100 in chips) 
AIien Hand: posts small blind $0.50
IvelinKocev1337: posts big blind $1
*** HOLE CARDS ***
nastja336: folds 
blistein: folds 
Alinyr: folds 
jeffy27dt1: raises $1.50 to $2.50
AIien Hand: folds 
IvelinKocev1337: calls $1.50
*** FLOP *** [Td 6d 9s]
IvelinKocev1337: checks 
jeffy27dt1: bets $3.92
IvelinKocev1337: calls $3.92
*** TURN *** [Td 6d 9s] [6h]
IvelinKocev1337: checks 
jeffy27dt1: checks 
*** RIVER *** [Td 6d 9s 6h] [6s]
IvelinKocev1337: checks 
jeffy27dt1: bets $22.23
IvelinKocev1337: folds 
Uncalled bet ($22.23) returned to jeffy27dt1
jeffy27dt1 collected $12.67 from pot
jeffy27dt1: doesn't show hand 
*** SUMMARY ***
Total pot $13.34 | Rake $0.67 
Board [Td 6d 9s 6h 6s]
Seat 1: jeffy27dt1 (button) collected ($12.67)
Seat 2: AIien Hand (small blind) folded before Flop
Seat 3: IvelinKocev1337 (big blind) folded on the River
Seat 4: nastja336 folded before Flop (didn't bet)
Seat 5: blistein folded before Flop (didn't bet)
Seat 6: Alinyr folded before Flop (didn't bet)



PokerStars Hand #254515959507:  Hold'em No Limit ($0.50/$1.00 USD) - 2025/01/23 17:01:50 WET [2025/01/23 12:01:50 ET]
Table 'Helewalda IV' 6-max Seat #2 is the button
Seat 4: nastja336 ($103 in chips) is sitting out
Seat 5: blistein ($100 in chips) is sitting out
Seat 1: jeffy27dt1 ($106.25 in chips) 
Seat 2: AIien Hand ($100 in chips) 
Seat 3: IvelinKocev1337 ($113.02 in chips) 
Seat 6: Alinyr ($100 in chips) 
IvelinKocev1337: posts small blind $0.50
nastja336: is sitting out 
blistein: is sitting out 
Alinyr: posts big blind $1
*** HOLE CARDS ***
nastja336 leaves the table
blistein leaves the table
tintin641 joins the table at seat #5 
jeffy27dt1: raises $1.50 to $2.50
AIien Hand: folds 
Joe_Li7 joins the table at seat #4 
IvelinKocev1337: raises $5.50 to $8
Alinyr: folds 
jeffy27dt1: folds 
Uncalled bet ($5.50) returned to IvelinKocev1337
IvelinKocev1337 collected $6 from pot
IvelinKocev1337: doesn't show hand 
*** SUMMARY ***
Total pot $6 | Rake $0 
Seat 4: nastja336
Seat 5: blistein
Seat 1: jeffy27dt1 folded before Flop
Seat 2: AIien Hand (button) folded before Flop (didn't bet)
Seat 3: IvelinKocev1337 (small blind) collected ($6)
Seat 6: Alinyr (big blind) folded before Flop



PokerStars Hand #254515966382:  Hold'em No Limit ($0.50/$1.00 USD) - 2025/01/23 17:02:26 WET [2025/01/23 12:02:26 ET]
Table 'Helewalda IV' 6-max Seat #3 is the button
Seat 4: Joe_Li7 ($100 in chips) is sitting out
Seat 5: tintin641 ($100 in chips) is sitting out
Seat 1: jeffy27dt1 ($103.75 in chips) 
Seat 2: AIien Hand ($100 in chips) 
Seat 3: IvelinKocev1337 ($116.52 in chips) 
Seat 6: Alinyr ($100 in chips) 
Alinyr: posts small blind $0.50
jeffy27dt1: posts big blind $1
*** HOLE CARDS ***
AIien Hand: folds 
IvelinKocev1337: folds 
Alinyr: folds 
Uncalled bet ($0.50) returned to jeffy27dt1
jeffy27dt1 collected $1 from pot
jeffy27dt1: doesn't show hand 
*** SUMMARY ***
Total pot $1 | Rake $0 
Seat 4: Joe_Li7
Seat 5: tintin641
Seat 1: jeffy27dt1 (big blind) collected ($1)
Seat 2: AIien Hand folded before Flop (didn't bet)
Seat 3: IvelinKocev1337 (button) folded before Flop (didn't bet)
Seat 6: Alinyr (small blind) folded before Flop



PokerStars Hand #254515968167:  Hold'em No Limit ($0.50/$1.00 USD) - 2025/01/23 17:02:35 WET [2025/01/23 12:02:35 ET]
Table 'Helewalda IV' 6-max Seat #6 is the button
Seat 4: Joe_Li7 ($100 in chips) is sitting out
Seat 5: tintin641 ($100 in chips) is sitting out
Seat 1: jeffy27dt1 ($104.25 in chips) 
Seat 2: AIien Hand ($100 in chips) 
Seat 3: IvelinKocev1337 ($116.52 in chips) 
Seat 6: Alinyr ($100 in chips) 
jeffy27dt1: posts small blind $0.50
AIien Hand: posts big blind $1
Joe_Li7: sits out 
tintin641: sits out 
*** HOLE CARDS ***
IvelinKocev1337: folds 
Alinyr: raises $1.50 to $2.50
jeffy27dt1: folds 
AIien Hand: folds 
Uncalled bet ($1.50) returned to Alinyr
Alinyr collected $2.50 from pot
Alinyr: doesn't show hand 
*** SUMMARY ***
Total pot $2.50 | Rake $0 
Seat 4: Joe_Li7
Seat 5: tintin641
Seat 1: jeffy27dt1 (small blind) folded before Flop
Seat 2: AIien Hand (big blind) folded before Flop
Seat 3: IvelinKocev1337 folded before Flop (didn't bet)
Seat 6: Alinyr (button) collected ($2.50)



PokerStars Hand #254515971830:  Hold'em No Limit ($0.50/$1.00 USD) - 2025/01/23 17:02:53 WET [2025/01/23 12:02:53 ET]
Table 'Helewalda IV' 6-max Seat #1 is the button
Seat 4: Joe_Li7 ($100 in chips) is sitting out
Seat 5: tintin641 ($100 in chips) is sitting out
Seat 1: jeffy27dt1 ($103.75 in chips) 
Seat 2: AIien Hand ($100 in chips) 
Seat 3: IvelinKocev1337 ($116.52 in chips) 
Seat 6: Alinyr ($101.50 in chips) 
AIien Hand: posts small blind $0.50
IvelinKocev1337: posts big blind $1
Joe_Li7: sits out 
tintin641: sits out 
*** HOLE CARDS ***
Alinyr: folds 
jeffy27dt1: folds 
AIien Hand: raises $2 to $3
IvelinKocev1337: calls $2
*** FLOP *** [8h Kd Js]
AIien Hand: checks 
IvelinKocev1337: checks 
*** TURN *** [8h Kd Js] [Ts]
AIien Hand: bets $4.10
IvelinKocev1337: calls $4.10
*** RIVER *** [8h Kd Js Ts] [2c]
AIien Hand: bets $14.45
IvelinKocev1337: folds 
Uncalled bet ($14.45) returned to AIien Hand
AIien Hand collected $13.49 from pot
AIien Hand: doesn't show hand 
*** SUMMARY ***
Total pot $14.20 | Rake $0.71 
Board [8h Kd Js Ts 2c]
Seat 4: Joe_Li7
Seat 5: tintin641
Seat 1: jeffy27dt1 (button) folded before Flop (didn't bet)
Seat 2: AIien Hand (small blind) collected ($13.49)
Seat 3: IvelinKocev1337 (big blind) folded on the River
Seat 6: Alinyr folded before Flop (didn't bet)



PokerStars Hand #254515983778:  Hold'em No Limit ($0.50/$1.00 USD) - 2025/01/23 17:03:53 WET [2025/01/23 12:03:53 ET]
Table 'Helewalda IV' 6-max Seat #2 is the button
Seat 5: tintin641 ($100 in chips) is sitting out
Seat 1: jeffy27dt1 ($103.75 in chips) 
Seat 2: AIien Hand ($106.39 in chips) 
Seat 3: IvelinKocev1337 ($109.42 in chips) 
Seat 4: Joe_Li7 ($100 in chips) 
Seat 6: Alinyr ($101.50 in chips) 
IvelinKocev1337: posts small blind $0.50
Joe_Li7: posts big blind $1
tintin641: sits out 
*** HOLE CARDS ***
Alinyr: folds 
jeffy27dt1: folds 
AIien Hand: folds 
IvelinKocev1337: calls $0.50
Joe_Li7: checks 
*** FLOP *** [Ad 4h Qc]
IvelinKocev1337: checks 
Joe_Li7: checks 
*** TURN *** [Ad 4h Qc] [4d]
IvelinKocev1337: bets $1
Joe_Li7: folds 
Uncalled bet ($1) returned to IvelinKocev1337
IvelinKocev1337 collected $1.90 from pot
IvelinKocev1337: doesn't show hand 
*** SUMMARY ***
Total pot $2 | Rake $0.10 
Board [Ad 4h Qc 4d]
Seat 5: tintin641
Seat 1: jeffy27dt1 folded before Flop (didn't bet)
Seat 2: AIien Hand (button) folded before Flop (didn't bet)
Seat 3: IvelinKocev1337 (small blind) collected ($1.90)
Seat 4: Joe_Li7 (big blind) folded on the Turn
Seat 6: Alinyr folded before Flop (didn't bet)



PokerStars Hand #254515990199:  Hold'em No Limit ($0.50/$1.00 USD) - 2025/01/23 17:04:26 WET [2025/01/23 12:04:26 ET]
Table 'Helewalda IV' 6-max Seat #3 is the button
Seat 1: jeffy27dt1 ($103.75 in chips) 
Seat 2: AIien Hand ($106.39 in chips) 
Seat 3: IvelinKocev1337 ($110.32 in chips) 
Seat 4: Joe_Li7 ($100 in chips) 
Seat 5: tintin641 ($100 in chips) 
Seat 6: Alinyr ($101.50 in chips) 
Joe_Li7: posts small blind $0.50
tintin641: posts big blind $1
*** HOLE CARDS ***
Alinyr: folds 
jeffy27dt1: folds 
AIien Hand: raises $1.20 to $2.20
IvelinKocev1337: folds 
Joe_Li7: folds 
tintin641: folds 
Uncalled bet ($1.20) returned to AIien Hand
AIien Hand collected $2.50 from pot
AIien Hand: doesn't show hand 
*** SUMMARY ***
Total pot $2.50 | Rake $0 
Seat 1: jeffy27dt1 folded before Flop (didn't bet)
Seat 2: AIien Hand collected ($2.50)
Seat 3: IvelinKocev1337 (button) folded before Flop (didn't bet)
Seat 4: Joe_Li7 (small blind) folded before Flop
Seat 5: tintin641 (big blind) folded before Flop
Seat 6: Alinyr folded before Flop (didn't bet)



PokerStars Hand #254515993816:  Hold'em No Limit ($0.50/$1.00 USD) - 2025/01/23 17:04:44 WET [2025/01/23 12:04:44 ET]
Table 'Helewalda IV' 6-max Seat #4 is the button
Seat 1: jeffy27dt1 ($103.75 in chips) 
Seat 2: AIien Hand ($107.89 in chips) 
Seat 3: IvelinKocev1337 ($110.32 in chips) 
Seat 4: Joe_Li7 ($100 in chips) 
Seat 5: tintin641 ($100 in chips) 
Seat 6: Alinyr ($101.50 in chips) 
tintin641: posts small blind $0.50
Alinyr: posts big blind $1
*** HOLE CARDS ***
jeffy27dt1: folds 
AIien Hand: raises $1.20 to $2.20
IvelinKocev1337: folds 
Joe_Li7: folds 
tintin641: raises $8.80 to $11
Alinyr: folds 
AIien Hand: folds 
Uncalled bet ($8.80) returned to tintin641
tintin641 collected $5.40 from pot
tintin641: doesn't show hand 
*** SUMMARY ***
Total pot $5.40 | Rake $0 
Seat 1: jeffy27dt1 folded before Flop (didn't bet)
Seat 2: AIien Hand folded before Flop
Seat 3: IvelinKocev1337 folded before Flop (didn't bet)
Seat 4: Joe_Li7 (button) folded before Flop (didn't bet)
Seat 5: tintin641 (small blind) collected ($5.40)
Seat 6: Alinyr (big blind) folded before Flop



PokerStars Hand #254516001115:  Hold'em No Limit ($0.50/$1.00 USD) - 2025/01/23 17:05:20 WET [2025/01/23 12:05:20 ET]
Table 'Helewalda IV' 6-max Seat #5 is the button
Seat 1: jeffy27dt1 ($103.75 in chips) 
Seat 2: AIien Hand ($105.69 in chips) 
Seat 3: IvelinKocev1337 ($110.32 in chips) 
Seat 4: Joe_Li7 ($100 in chips) 
Seat 5: tintin641 ($103.20 in chips) 
Seat 6: Alinyr ($100.50 in chips) 
Alinyr: posts small blind $0.50
jeffy27dt1: posts big blind $1
*** HOLE CARDS ***
AIien Hand has timed out
AIien Hand: folds 
IvelinKocev1337: folds 
IvelinKocev1337 leaves the table
Joe_Li7: raises $1.20 to $2.20
tintin641: folds 
Alinyr: raises $9.80 to $12
jeffy27dt1: folds 
BrilliantDawn84 joins the table at seat #3 
AIien Hand leaves the table
StayFit4 joins the table at seat #2 
Joe_Li7: calls $9.80
*** FLOP *** [5h 4c 8c]
tintin641 leaves the table
Alinyr: checks 
Joe_Li7: bets $5.95
Alinyr: folds 
Uncalled bet ($5.95) returned to Joe_Li7
Joe_Li7 collected $23.75 from pot
*** SUMMARY ***
Total pot $25 | Rake $1.25 
Board [5h 4c 8c]
Seat 1: jeffy27dt1 (big blind) folded before Flop
Seat 2: AIien Hand folded before Flop (didn't bet)
Seat 3: IvelinKocev1337 folded before Flop (didn't bet)
Seat 4: Joe_Li7 collected ($23.75)
Seat 5: tintin641 (button) folded before Flop (didn't bet)
Seat 6: Alinyr (small blind) folded on the Flop



PokerStars Hand #254516012935:  Hold'em No Limit ($0.50/$1.00 USD) - 2025/01/23 17:06:18 WET [2025/01/23 12:06:18 ET]
Table 'Helewalda IV' 6-max Seat #6 is the button
Seat 3: BrilliantDawn84 ($100 in chips) is sitting out
Seat 1: jeffy27dt1 ($102.75 in chips) 
Seat 2: StayFit4 ($100 in chips) 
Seat 4: Joe_Li7 ($111.75 in chips) 
Seat 6: Alinyr ($100 in chips) 
jeffy27dt1: posts small blind $0.50
StayFit4: posts big blind $1
BrilliantDawn84: sits out 
*** HOLE CARDS ***
Joe_Li7: folds 
Joe_Li7 leaves the table
Alinyr: raises $1.50 to $2.50
jeffy27dt1: folds 
StayFit4: calls $1.50
*** FLOP *** [9h Jd 4h]
StayFit4: checks 
Alinyr: checks 
*** TURN *** [9h Jd 4h] [Kc]
StayFit4: checks 
Alinyr: checks 
*** RIVER *** [9h Jd 4h Kc] [9s]
StayFit4: checks 
Alinyr: bets $3.92
StayFit4: calls $3.92
*** SHOW DOWN ***
Alinyr: shows [8d Ks] (two pair, Kings and Nines)
StayFit4: shows [Th Kd] (two pair, Kings and Nines)
StayFit4 collected $6.34 from pot
Alinyr collected $6.33 from pot
*** SUMMARY ***
Total pot $13.34 | Rake $0.67 
Board [9h Jd 4h Kc 9s]
Seat 3: BrilliantDawn84
Seat 1: jeffy27dt1 (small blind) folded before Flop
Seat 2: StayFit4 (big blind) showed [Th Kd] and won ($6.34) with two pair, Kings and Nines
Seat 4: Joe_Li7 folded before Flop (didn't bet)
Seat 6: Alinyr (button) showed [8d Ks] and won ($6.33) with two pair, Kings and Nines



PokerStars Hand #254516022981:  Hold'em No Limit ($0.50/$1.00 USD) - 2025/01/23 17:07:08 WET [2025/01/23 12:07:08 ET]
Table 'Helewalda IV' 6-max Seat #1 is the button
Seat 1: jeffy27dt1 ($102.25 in chips) 
Seat 2: StayFit4 ($100 in chips) 
Seat 3: BrilliantDawn84 ($100 in chips) 
Seat 6: Alinyr ($100 in chips) 
StayFit4: posts small blind $0.50
BrilliantDawn84: posts big blind $1
*** HOLE CARDS ***
SGodoyJr joins the table at seat #4 
Alinyr: folds 
jeffy27dt1: folds 
StayFit4: raises $2 to $3
BrilliantDawn84: calls $2
*** FLOP *** [Jc 6s 5s]
StayFit4: bets $1.88
BrilliantDawn84: folds 
Uncalled bet ($1.88) returned to StayFit4
StayFit4 collected $5.70 from pot
StayFit4: doesn't show hand 
*** SUMMARY ***
Total pot $6 | Rake $0.30 
Board [Jc 6s 5s]
Seat 1: jeffy27dt1 (button) folded before Flop (didn't bet)
Seat 2: StayFit4 (small blind) collected ($5.70)
Seat 3: BrilliantDawn84 (big blind) folded on the Flop
Seat 6: Alinyr folded before Flop (didn't bet)



PokerStars Hand #254516027128:  Hold'em No Limit ($0.50/$1.00 USD) - 2025/01/23 17:07:29 WET [2025/01/23 12:07:29 ET]
Table 'Helewalda IV' 6-max Seat #2 is the button
Seat 1: jeffy27dt1 ($102.25 in chips) 
Seat 2: StayFit4 ($102.70 in chips) 
Seat 3: BrilliantDawn84 ($97 in chips) 
Seat 4: SGodoyJr ($100 in chips) 
Seat 6: Alinyr ($100 in chips) 
BrilliantDawn84: posts small blind $0.50
SGodoyJr: posts big blind $1
*** HOLE CARDS ***
Alinyr: folds 
Dbackhouse1 joins the table at seat #5 
jeffy27dt1: folds 
Dbackhouse1 is disconnected 
StayFit4: raises $1.50 to $2.50
BrilliantDawn84: folds 
SGodoyJr: folds 
Uncalled bet ($1.50) returned to StayFit4
StayFit4 collected $2.50 from pot
StayFit4: doesn't show hand 
*** SUMMARY ***
Total pot $2.50 | Rake $0 
Seat 1: jeffy27dt1 folded before Flop (didn't bet)
Seat 2: StayFit4 (button) collected ($2.50)
Seat 3: BrilliantDawn84 (small blind) folded before Flop
Seat 4: SGodoyJr (big blind) folded before Flop
Seat 6: Alinyr folded before Flop (didn't bet)



PokerStars Hand #254516030687:  Hold'em No Limit ($0.50/$1.00 USD) - 2025/01/23 17:07:46 WET [2025/01/23 12:07:46 ET]
Table 'Helewalda IV' 6-max Seat #3 is the button
Seat 1: jeffy27dt1 ($102.25 in chips) 
Seat 2: StayFit4 ($104.20 in chips) 
Seat 3: BrilliantDawn84 ($96.50 in chips) 
Seat 4: SGodoyJr ($100 in chips) 
Seat 5: Dbackhouse1 ($59.87 in chips) 
Seat 6: Alinyr ($100 in chips) 
SGodoyJr: posts small blind $0.50
Dbackhouse1: posts big blind $1
*** HOLE CARDS ***
Alinyr: folds 
jeffy27dt1: folds 
StayFit4: folds 
BrilliantDawn84: folds 
SGodoyJr: folds 
Uncalled bet ($0.50) returned to Dbackhouse1
Dbackhouse1 collected $1 from pot
*** SUMMARY ***
Total pot $1 | Rake $0 
Seat 1: jeffy27dt1 folded before Flop (didn't bet)
Seat 2: StayFit4 folded before Flop (didn't bet)
Seat 3: BrilliantDawn84 (button) folded before Flop (didn't bet)
Seat 4: SGodoyJr (small blind) folded before Flop
Seat 5: Dbackhouse1 (big blind) collected ($1)
Seat 6: Alinyr folded before Flop (didn't bet)



PokerStars Hand #254516033624:  Hold'em No Limit ($0.50/$1.00 USD) - 2025/01/23 17:08:01 WET [2025/01/23 12:08:01 ET]
Table 'Helewalda IV' 6-max Seat #4 is the button
Seat 1: jeffy27dt1 ($102.25 in chips) is sitting out
Seat 2: StayFit4 ($104.20 in chips) is sitting out
Seat 6: Alinyr ($100 in chips) is sitting out
Seat 3: BrilliantDawn84 ($96.50 in chips) 
Seat 4: SGodoyJr ($100 in chips) 
Seat 5: Dbackhouse1 ($60.37 in chips) 
Dbackhouse1: posts small blind $0.50
Alinyr: is sitting out 
jeffy27dt1: is sitting out 
StayFit4: is sitting out 
BrilliantDawn84: posts big blind $1
*** HOLE CARDS ***
SGodoyJr: raises $1.50 to $2.50
Alinyr leaves the table
Dbackhouse1: folds 
BrilliantDawn84: folds 
Uncalled bet ($1.50) returned to SGodoyJr
SGodoyJr collected $2.50 from pot
SGodoyJr: doesn't show hand 
*** SUMMARY ***
Total pot $2.50 | Rake $0 
Seat 1: jeffy27dt1
Seat 2: StayFit4
Seat 6: Alinyr
Seat 3: BrilliantDawn84 (big blind) folded before Flop
Seat 4: SGodoyJr (button) collected ($2.50)
Seat 5: Dbackhouse1 (small blind) folded before Flop



PokerStars Hand #254516035242:  Hold'em No Limit ($0.50/$1.00 USD) - 2025/01/23 17:08:09 WET [2025/01/23 12:08:09 ET]
Table 'Helewalda IV' 6-max Seat #5 is the button
Seat 1: jeffy27dt1 ($102.25 in chips) is sitting out
Seat 2: StayFit4 ($104.20 in chips) is sitting out
Seat 3: BrilliantDawn84 ($95.50 in chips) 
Seat 4: SGodoyJr ($101.50 in chips) 
Seat 5: Dbackhouse1 ($59.87 in chips) 
BrilliantDawn84: posts small blind $0.50
SGodoyJr: posts big blind $1
*** HOLE CARDS ***
reiyser joins the table at seat #6 
Dbackhouse1: folds 
BrilliantDawn84: raises $1.50 to $2.50
SGodoyJr: raises $6.50 to $9
BrilliantDawn84: folds 
Uncalled bet ($6.50) returned to SGodoyJr
SGodoyJr collected $5 from pot
SGodoyJr: doesn't show hand 
*** SUMMARY ***
Total pot $5 | Rake $0 
Seat 1: jeffy27dt1
Seat 2: StayFit4
Seat 3: BrilliantDawn84 (small blind) folded before Flop
Seat 4: SGodoyJr (big blind) collected ($5)
Seat 5: Dbackhouse1 (button) folded before Flop (didn't bet)



PokerStars Hand #254516039243:  Hold'em No Limit ($0.50/$1.00 USD) - 2025/01/23 17:08:29 WET [2025/01/23 12:08:29 ET]
Table 'Helewalda IV' 6-max Seat #3 is the button
Seat 1: jeffy27dt1 ($102.25 in chips) is sitting out
Seat 2: StayFit4 ($104.20 in chips) is sitting out
Seat 6: reiyser ($101 in chips) is sitting out
Seat 3: BrilliantDawn84 ($93 in chips) 
Seat 4: SGodoyJr ($104 in chips) 
Seat 5: Dbackhouse1 ($59.87 in chips) 
SGodoyJr: posts small blind $0.50
Dbackhouse1: posts big blind $1
reiyser: sits out 
jeffy27dt1: sits out 
StayFit4: sits out 
*** HOLE CARDS ***
BrilliantDawn84: folds 
SGodoyJr: raises $2 to $3
Dbackhouse1: folds 
Uncalled bet ($2) returned to SGodoyJr
SGodoyJr collected $2 from pot
SGodoyJr: doesn't show hand 
*** SUMMARY ***
Total pot $2 | Rake $0 
Seat 1: jeffy27dt1
Seat 2: StayFit4
Seat 6: reiyser
Seat 3: BrilliantDawn84 (button) folded before Flop (didn't bet)
Seat 4: SGodoyJr (small blind) collected ($2)
Seat 5: Dbackhouse1 (big blind) folded before Flop



PokerStars Hand #254516041597:  Hold'em No Limit ($0.50/$1.00 USD) - 2025/01/23 17:08:40 WET [2025/01/23 12:08:40 ET]
Table 'Helewalda IV' 6-max Seat #4 is the button
Seat 1: jeffy27dt1 ($102.25 in chips) is sitting out
Seat 2: StayFit4 ($104.20 in chips) is sitting out
Seat 3: BrilliantDawn84 ($100 in chips) 
Seat 4: SGodoyJr ($105 in chips) 
Seat 5: Dbackhouse1 ($58.87 in chips) 
Seat 6: reiyser ($101 in chips) 
Dbackhouse1: posts small blind $0.50
reiyser: posts big blind $1
jeffy27dt1: sits out 
StayFit4: sits out 
*** HOLE CARDS ***
BrilliantDawn84: raises $1.50 to $2.50
SGodoyJr: folds 
Dbackhouse1: calls $2
reiyser: folds 
*** FLOP *** [8d 6d Ts]
Dbackhouse1: checks 
BrilliantDawn84: bets $2.85
Dbackhouse1: folds 
Uncalled bet ($2.85) returned to BrilliantDawn84
BrilliantDawn84 collected $5.70 from pot
BrilliantDawn84: doesn't show hand 
*** SUMMARY ***
Total pot $6 | Rake $0.30 
Board [8d 6d Ts]
Seat 1: jeffy27dt1
Seat 2: StayFit4
Seat 3: BrilliantDawn84 collected ($5.70)
Seat 4: SGodoyJr (button) folded before Flop (didn't bet)
Seat 5: Dbackhouse1 (small blind) folded on the Flop
Seat 6: reiyser (big blind) folded before Flop



PokerStars Hand #254516045950:  Hold'em No Limit ($0.50/$1.00 USD) - 2025/01/23 17:09:02 WET [2025/01/23 12:09:02 ET]
Table 'Helewalda IV' 6-max Seat #5 is the button
Seat 2: StayFit4 ($104.20 in chips) is sitting out
Seat 1: jeffy27dt1 ($102.25 in chips) 
Seat 3: BrilliantDawn84 ($103.20 in chips) 
Seat 4: SGodoyJr ($105 in chips) 
Seat 5: Dbackhouse1 ($56.37 in chips) 
Seat 6: reiyser ($100 in chips) 
reiyser: posts small blind $0.50
jeffy27dt1: posts big blind $1
StayFit4: sits out 
*** HOLE CARDS ***
BrilliantDawn84: folds 
SGodoyJr: folds 
Dbackhouse1: folds 
reiyser: raises $1.80 to $2.80
jeffy27dt1: raises $7.20 to $10
reiyser: calls $7.20
*** FLOP *** [Ac 8c Js]
reiyser: checks 
jeffy27dt1: bets $6.27
reiyser: folds 
Uncalled bet ($6.27) returned to jeffy27dt1
jeffy27dt1 collected $19 from pot
jeffy27dt1: doesn't show hand 
*** SUMMARY ***
Total pot $20 | Rake $1 
Board [Ac 8c Js]
Seat 2: StayFit4
Seat 1: jeffy27dt1 (big blind) collected ($19)
Seat 3: BrilliantDawn84 folded before Flop (didn't bet)
Seat 4: SGodoyJr folded before Flop (didn't bet)
Seat 5: Dbackhouse1 (button) folded before Flop (didn't bet)
Seat 6: reiyser (small blind) folded on the Flop



PokerStars Hand #254516056663:  Hold'em No Limit ($0.50/$1.00 USD) - 2025/01/23 17:09:54 WET [2025/01/23 12:09:54 ET]
Table 'Helewalda IV' 6-max Seat #6 is the button
Seat 1: jeffy27dt1 ($111.25 in chips) 
Seat 2: StayFit4 ($104.20 in chips) 
Seat 3: BrilliantDawn84 ($103.20 in chips) 
Seat 4: SGodoyJr ($105 in chips) 
Seat 5: Dbackhouse1 ($56.37 in chips) 
Seat 6: reiyser ($100 in chips) 
jeffy27dt1: posts small blind $0.50
StayFit4: posts big blind $1
*** HOLE CARDS ***
BrilliantDawn84: raises $1.50 to $2.50
SGodoyJr: folds 
Dbackhouse1: folds 
reiyser: folds 
jeffy27dt1: folds 
StayFit4: calls $1.50
*** FLOP *** [7c 5h 8h]
StayFit4: checks 
BrilliantDawn84: bets $2.61
StayFit4: calls $2.61
*** TURN *** [7c 5h 8h] [4h]
StayFit4: bets $3.36
BrilliantDawn84: folds 
Uncalled bet ($3.36) returned to StayFit4
StayFit4 collected $10.18 from pot
StayFit4: doesn't show hand 
*** SUMMARY ***
Total pot $10.72 | Rake $0.54 
Board [7c 5h 8h 4h]
Seat 1: jeffy27dt1 (small blind) folded before Flop
Seat 2: StayFit4 (big blind) collected ($10.18)
Seat 3: BrilliantDawn84 folded on the Turn
Seat 4: SGodoyJr folded before Flop (didn't bet)
Seat 5: Dbackhouse1 folded before Flop (didn't bet)
Seat 6: reiyser (button) folded before Flop (didn't bet)



PokerStars Hand #254516070578:  Hold'em No Limit ($0.50/$1.00 USD) - 2025/01/23 17:11:01 WET [2025/01/23 12:11:01 ET]
Table 'Helewalda IV' 6-max Seat #1 is the button
Seat 1: jeffy27dt1 ($110.75 in chips) 
Seat 2: StayFit4 ($109.27 in chips) 
Seat 3: BrilliantDawn84 ($98.09 in chips) 
Seat 4: SGodoyJr ($105 in chips) 
Seat 5: Dbackhouse1 ($56.37 in chips) 
Seat 6: reiyser ($100 in chips) 
StayFit4: posts small blind $0.50
BrilliantDawn84: posts big blind $1
*** HOLE CARDS ***
SGodoyJr: folds 
Dbackhouse1: folds 
reiyser: folds 
jeffy27dt1: folds 
StayFit4: raises $2 to $3
BrilliantDawn84: raises $6 to $9
StayFit4: folds 
Uncalled bet ($6) returned to BrilliantDawn84
BrilliantDawn84 collected $6 from pot
BrilliantDawn84: doesn't show hand 
*** SUMMARY ***
Total pot $6 | Rake $0 
Seat 1: jeffy27dt1 (button) folded before Flop (didn't bet)
Seat 2: StayFit4 (small blind) folded before Flop
Seat 3: BrilliantDawn84 (big blind) collected ($6)
Seat 4: SGodoyJr folded before Flop (didn't bet)
Seat 5: Dbackhouse1 folded before Flop (didn't bet)
Seat 6: reiyser folded before Flop (didn't bet)



PokerStars Hand #254516075621:  Hold'em No Limit ($0.50/$1.00 USD) - 2025/01/23 17:11:25 WET [2025/01/23 12:11:25 ET]
Table 'Helewalda IV' 6-max Seat #2 is the button
Seat 1: jeffy27dt1 ($110.75 in chips) 
Seat 2: StayFit4 ($106.27 in chips) 
Seat 3: BrilliantDawn84 ($101.09 in chips) 
Seat 4: SGodoyJr ($105 in chips) 
Seat 5: Dbackhouse1 ($56.37 in chips) 
Seat 6: reiyser ($100 in chips) 
BrilliantDawn84: posts small blind $0.50
SGodoyJr: posts big blind $1
*** HOLE CARDS ***
Dbackhouse1: folds 
reiyser: folds 
jeffy27dt1: folds 
StayFit4: folds 
BrilliantDawn84: folds 
Uncalled bet ($0.50) returned to SGodoyJr
SGodoyJr collected $1 from pot
SGodoyJr: doesn't show hand 
*** SUMMARY ***
Total pot $1 | Rake $0 
Seat 1: jeffy27dt1 folded before Flop (didn't bet)
Seat 2: StayFit4 (button) folded before Flop (didn't bet)
Seat 3: BrilliantDawn84 (small blind) folded before Flop
Seat 4: SGodoyJr (big blind) collected ($1)
Seat 5: Dbackhouse1 folded before Flop (didn't bet)
Seat 6: reiyser folded before Flop (didn't bet)



PokerStars Hand #254516078190:  Hold'em No Limit ($0.50/$1.00 USD) - 2025/01/23 17:11:37 WET [2025/01/23 12:11:37 ET]
Table 'Helewalda IV' 6-max Seat #3 is the button
Seat 1: jeffy27dt1 ($110.75 in chips) 
Seat 2: StayFit4 ($106.27 in chips) 
Seat 3: BrilliantDawn84 ($100.59 in chips) 
Seat 4: SGodoyJr ($105.50 in chips) 
Seat 5: Dbackhouse1 ($56.37 in chips) 
Seat 6: reiyser ($100 in chips) 
SGodoyJr: posts small blind $0.50
Dbackhouse1: posts big blind $1
*** HOLE CARDS ***
reiyser: folds 
jeffy27dt1: folds 
StayFit4: folds 
BrilliantDawn84: raises $1.50 to $2.50
SGodoyJr: folds 
Dbackhouse1: folds 
Uncalled bet ($1.50) returned to BrilliantDawn84
BrilliantDawn84 collected $2.50 from pot
BrilliantDawn84: doesn't show hand 
*** SUMMARY ***
Total pot $2.50 | Rake $0 
Seat 1: jeffy27dt1 folded before Flop (didn't bet)
Seat 2: StayFit4 folded before Flop (didn't bet)
Seat 3: BrilliantDawn84 (button) collected ($2.50)
Seat 4: SGodoyJr (small blind) folded before Flop
Seat 5: Dbackhouse1 (big blind) folded before Flop
Seat 6: reiyser folded before Flop (didn't bet)



PokerStars Hand #254516081327:  Hold'em No Limit ($0.50/$1.00 USD) - 2025/01/23 17:11:51 WET [2025/01/23 12:11:51 ET]
Table 'Helewalda IV' 6-max Seat #4 is the button
Seat 1: jeffy27dt1 ($110.75 in chips) 
Seat 2: StayFit4 ($106.27 in chips) 
Seat 3: BrilliantDawn84 ($102.09 in chips) 
Seat 4: SGodoyJr ($105 in chips) 
Seat 5: Dbackhouse1 ($55.37 in chips) 
Seat 6: reiyser ($100 in chips) 
Dbackhouse1: posts small blind $0.50
reiyser: posts big blind $1
*** HOLE CARDS ***
jeffy27dt1: folds 
StayFit4: raises $1 to $2
BrilliantDawn84: folds 
SGodoyJr: folds 
Dbackhouse1: calls $1.50
reiyser: folds 
*** FLOP *** [8s 4h 8c]
Dbackhouse1: checks 
StayFit4: bets $1.57
Dbackhouse1: calls $1.57
*** TURN *** [8s 4h 8c] [6c]
Dbackhouse1: checks 
StayFit4: bets $5.80
Dbackhouse1: folds 
Uncalled bet ($5.80) returned to StayFit4
StayFit4 collected $7.73 from pot
StayFit4: doesn't show hand 
*** SUMMARY ***
Total pot $8.14 | Rake $0.41 
Board [8s 4h 8c 6c]
Seat 1: jeffy27dt1 folded before Flop (didn't bet)
Seat 2: StayFit4 collected ($7.73)
Seat 3: BrilliantDawn84 folded before Flop (didn't bet)
Seat 4: SGodoyJr (button) folded before Flop (didn't bet)
Seat 5: Dbackhouse1 (small blind) folded on the Turn
Seat 6: reiyser (big blind) folded before Flop



PokerStars Hand #254516090916:  Hold'em No Limit ($0.50/$1.00 USD) - 2025/01/23 17:12:37 WET [2025/01/23 12:12:37 ET]
Table 'Helewalda IV' 6-max Seat #5 is the button
Seat 1: jeffy27dt1 ($110.75 in chips) 
Seat 2: StayFit4 ($110.43 in chips) 
Seat 3: BrilliantDawn84 ($102.09 in chips) 
Seat 4: SGodoyJr ($105 in chips) 
Seat 5: Dbackhouse1 ($51.80 in chips) 
Seat 6: reiyser ($100 in chips) 
reiyser: posts small blind $0.50
jeffy27dt1: posts big blind $1
*** HOLE CARDS ***
StayFit4: folds 
BrilliantDawn84: folds 
SGodoyJr: folds 
Dbackhouse1: raises $1.50 to $2.50
reiyser: folds 
jeffy27dt1: calls $1.50
*** FLOP *** [5s Qh Qs]
jeffy27dt1: checks 
Dbackhouse1: bets $2.61
jeffy27dt1: calls $2.61
*** TURN *** [5s Qh Qs] [3s]
jeffy27dt1: checks 
Dbackhouse1: bets $3.09
jeffy27dt1: calls $3.09
*** RIVER *** [5s Qh Qs 3s] [Td]
jeffy27dt1: checks 
Dbackhouse1: checks 
*** SHOW DOWN ***
jeffy27dt1: shows [Ah Ts] (two pair, Queens and Tens)
Dbackhouse1: mucks hand 
jeffy27dt1 collected $16.06 from pot
*** SUMMARY ***
Total pot $16.90 | Rake $0.84 
Board [5s Qh Qs 3s Td]
Seat 1: jeffy27dt1 (big blind) showed [Ah Ts] and won ($16.06) with two pair, Queens and Tens
Seat 2: StayFit4 folded before Flop (didn't bet)
Seat 3: BrilliantDawn84 folded before Flop (didn't bet)
Seat 4: SGodoyJr folded before Flop (didn't bet)
Seat 5: Dbackhouse1 (button) mucked
Seat 6: reiyser (small blind) folded before Flop



PokerStars Hand #254516104614:  Hold'em No Limit ($0.50/$1.00 USD) - 2025/01/23 17:13:41 WET [2025/01/23 12:13:41 ET]
Table 'Helewalda IV' 6-max Seat #6 is the button
Seat 1: jeffy27dt1 ($118.61 in chips) 
Seat 2: StayFit4 ($110.43 in chips) 
Seat 3: BrilliantDawn84 ($102.09 in chips) 
Seat 4: SGodoyJr ($105 in chips) 
Seat 5: Dbackhouse1 ($43.60 in chips) 
Seat 6: reiyser ($100 in chips) 
jeffy27dt1: posts small blind $0.50
StayFit4: posts big blind $1
*** HOLE CARDS ***
BrilliantDawn84: folds 
SGodoyJr: folds 
Dbackhouse1: folds 
reiyser: folds 
jeffy27dt1: raises $2 to $3
StayFit4: folds 
Uncalled bet ($2) returned to jeffy27dt1
jeffy27dt1 collected $2 from pot
jeffy27dt1: doesn't show hand 
*** SUMMARY ***
Total pot $2 | Rake $0 
Seat 1: jeffy27dt1 (small blind) collected ($2)
Seat 2: StayFit4 (big blind) folded before Flop
Seat 3: BrilliantDawn84 folded before Flop (didn't bet)
Seat 4: SGodoyJr folded before Flop (didn't bet)
Seat 5: Dbackhouse1 folded before Flop (didn't bet)
Seat 6: reiyser (button) folded before Flop (didn't bet)



PokerStars Hand #254516107991:  Hold'em No Limit ($0.50/$1.00 USD) - 2025/01/23 17:13:56 WET [2025/01/23 12:13:56 ET]
Table 'Helewalda IV' 6-max Seat #1 is the button
Seat 1: jeffy27dt1 ($119.61 in chips) 
Seat 2: StayFit4 ($109.43 in chips) 
Seat 3: BrilliantDawn84 ($102.09 in chips) 
Seat 4: SGodoyJr ($105 in chips) 
Seat 5: Dbackhouse1 ($43.60 in chips) 
Seat 6: reiyser ($100 in chips) 
StayFit4: posts small blind $0.50
BrilliantDawn84: posts big blind $1
*** HOLE CARDS ***
SGodoyJr: folds 
Dbackhouse1: folds 
reiyser: folds 
jeffy27dt1: folds 
StayFit4: folds 
Uncalled bet ($0.50) returned to BrilliantDawn84
BrilliantDawn84 collected $1 from pot
BrilliantDawn84: doesn't show hand 
*** SUMMARY ***
Total pot $1 | Rake $0 
Seat 1: jeffy27dt1 (button) folded before Flop (didn't bet)
Seat 2: StayFit4 (small blind) folded before Flop
Seat 3: BrilliantDawn84 (big blind) collected ($1)
Seat 4: SGodoyJr folded before Flop (didn't bet)
Seat 5: Dbackhouse1 folded before Flop (didn't bet)
Seat 6: reiyser folded before Flop (didn't bet)



PokerStars Hand #254516110460:  Hold'em No Limit ($0.50/$1.00 USD) - 2025/01/23 17:14:08 WET [2025/01/23 12:14:08 ET]
Table 'Helewalda IV' 6-max Seat #2 is the button
Seat 1: jeffy27dt1 ($119.61 in chips) 
Seat 2: StayFit4 ($108.93 in chips) 
Seat 3: BrilliantDawn84 ($102.59 in chips) 
Seat 4: SGodoyJr ($105 in chips) 
Seat 5: Dbackhouse1 ($43.60 in chips) 
Seat 6: reiyser ($100 in chips) 
BrilliantDawn84: posts small blind $0.50
SGodoyJr: posts big blind $1
*** HOLE CARDS ***
Dbackhouse1: folds 
reiyser: folds 
jeffy27dt1: folds 
StayFit4: folds 
BrilliantDawn84: raises $1.50 to $2.50
SGodoyJr: raises $5.50 to $8
BrilliantDawn84: calls $5.50
*** FLOP *** [6d 8d As]
BrilliantDawn84: checks 
SGodoyJr: bets $3.80
BrilliantDawn84: calls $3.80
*** TURN *** [6d 8d As] [3d]
BrilliantDawn84: checks 
SGodoyJr: checks 
*** RIVER *** [6d 8d As 3d] [Th]
BrilliantDawn84: bets $13.21
SGodoyJr: calls $13.21
*** SHOW DOWN ***
BrilliantDawn84: shows [Qd Ks] (high card Ace)
SGodoyJr: shows [Ac Kc] (a pair of Aces)
SGodoyJr collected $47.52 from pot
*** SUMMARY ***
Total pot $50.02 | Rake $2.50 
Board [6d 8d As 3d Th]
Seat 1: jeffy27dt1 folded before Flop (didn't bet)
Seat 2: StayFit4 (button) folded before Flop (didn't bet)
Seat 3: BrilliantDawn84 (small blind) showed [Qd Ks] and lost with high card Ace
Seat 4: SGodoyJr (big blind) showed [Ac Kc] and won ($47.52) with a pair of Aces
Seat 5: Dbackhouse1 folded before Flop (didn't bet)
Seat 6: reiyser folded before Flop (didn't bet)



PokerStars Hand #254516122491:  Hold'em No Limit ($0.50/$1.00 USD) - 2025/01/23 17:15:04 WET [2025/01/23 12:15:04 ET]
Table 'Helewalda IV' 6-max Seat #3 is the button
Seat 1: jeffy27dt1 ($119.61 in chips) 
Seat 2: StayFit4 ($108.93 in chips) 
Seat 3: BrilliantDawn84 ($77.58 in chips) 
Seat 4: SGodoyJr ($127.51 in chips) 
Seat 5: Dbackhouse1 ($43.60 in chips) 
Seat 6: reiyser ($100 in chips) 
SGodoyJr: posts small blind $0.50
Dbackhouse1: posts big blind $1
*** HOLE CARDS ***
reiyser: folds 
jeffy27dt1: folds 
StayFit4: raises $1.50 to $2.50
BrilliantDawn84: folds 
SGodoyJr: folds 
Dbackhouse1: folds 
Uncalled bet ($1.50) returned to StayFit4
StayFit4 collected $2.50 from pot
StayFit4: doesn't show hand 
*** SUMMARY ***
Total pot $2.50 | Rake $0 
Seat 1: jeffy27dt1 folded before Flop (didn't bet)
Seat 2: StayFit4 collected ($2.50)
Seat 3: BrilliantDawn84 (button) folded before Flop (didn't bet)
Seat 4: SGodoyJr (small blind) folded before Flop
Seat 5: Dbackhouse1 (big blind) folded before Flop
Seat 6: reiyser folded before Flop (didn't bet)



PokerStars Hand #254516124790:  Hold'em No Limit ($0.50/$1.00 USD) - 2025/01/23 17:15:14 WET [2025/01/23 12:15:14 ET]
Table 'Helewalda IV' 6-max Seat #4 is the button
Seat 1: jeffy27dt1 ($119.61 in chips) 
Seat 2: StayFit4 ($110.43 in chips) 
Seat 3: BrilliantDawn84 ($100 in chips) 
Seat 4: SGodoyJr ($127.01 in chips) 
Seat 5: Dbackhouse1 ($42.60 in chips) 
Seat 6: reiyser ($100 in chips) 
Dbackhouse1: posts small blind $0.50
reiyser: posts big blind $1
*** HOLE CARDS ***
jeffy27dt1: folds 
StayFit4: folds 
BrilliantDawn84: raises $1.50 to $2.50
SGodoyJr: folds 
Dbackhouse1: folds 
reiyser: calls $1.50
*** FLOP *** [Qd 2s 2h]
reiyser: checks 
BrilliantDawn84: checks 
*** TURN *** [Qd 2s 2h] [Qh]
reiyser: checks 
BrilliantDawn84: checks 
*** RIVER *** [Qd 2s 2h Qh] [5d]
reiyser: checks 
BrilliantDawn84: checks 
*** SHOW DOWN ***
reiyser: shows [7s Ks] (two pair, Queens and Deuces)
BrilliantDawn84: shows [Ts Kh] (two pair, Queens and Deuces)
reiyser collected $2.61 from pot
BrilliantDawn84 collected $2.61 from pot
*** SUMMARY ***
Total pot $5.50 | Rake $0.28 
Board [Qd 2s 2h Qh 5d]
Seat 1: jeffy27dt1 folded before Flop (didn't bet)
Seat 2: StayFit4 folded before Flop (didn't bet)
Seat 3: BrilliantDawn84 showed [Ts Kh] and won ($2.61) with two pair, Queens and Deuces
Seat 4: SGodoyJr (button) folded before Flop (didn't bet)
Seat 5: Dbackhouse1 (small blind) folded before Flop
Seat 6: reiyser (big blind) showed [7s Ks] and won ($2.61) with two pair, Queens and Deuces



PokerStars Hand #254516132441:  Hold'em No Limit ($0.50/$1.00 USD) - 2025/01/23 17:15:49 WET [2025/01/23 12:15:49 ET]
Table 'Helewalda IV' 6-max Seat #5 is the button
Seat 1: jeffy27dt1 ($119.61 in chips) 
Seat 2: StayFit4 ($110.43 in chips) 
Seat 3: BrilliantDawn84 ($100.11 in chips) 
Seat 4: SGodoyJr ($127.01 in chips) 
Seat 5: Dbackhouse1 ($42.10 in chips) 
Seat 6: reiyser ($100.11 in chips) 
reiyser: posts small blind $0.50
jeffy27dt1: posts big blind $1
*** HOLE CARDS ***
StayFit4: folds 
BrilliantDawn84: raises $1.50 to $2.50
SGodoyJr: folds 
Dbackhouse1: calls $2.50
reiyser: raises $11.50 to $14
jeffy27dt1: folds 
BrilliantDawn84: calls $11.50
Dbackhouse1: folds 
*** FLOP *** [7h 4s Jc]
reiyser: checks 
BrilliantDawn84: checks 
*** TURN *** [7h 4s Jc] [Kd]
reiyser: bets $8.68
BrilliantDawn84: raises $14.32 to $23
reiyser: folds 
Uncalled bet ($14.32) returned to BrilliantDawn84
BrilliantDawn84 collected $46.42 from pot
BrilliantDawn84: doesn't show hand 
*** SUMMARY ***
Total pot $48.86 | Rake $2.44 
Board [7h 4s Jc Kd]
Seat 1: jeffy27dt1 (big blind) folded before Flop
Seat 2: StayFit4 folded before Flop (didn't bet)
Seat 3: BrilliantDawn84 collected ($46.42)
Seat 4: SGodoyJr folded before Flop (didn't bet)
Seat 5: Dbackhouse1 (button) folded before Flop
Seat 6: reiyser (small blind) folded on the Turn



PokerStars Hand #254516144549:  Hold'em No Limit ($0.50/$1.00 USD) - 2025/01/23 17:16:44 WET [2025/01/23 12:16:44 ET]
Table 'Helewalda IV' 6-max Seat #6 is the button
Seat 1: jeffy27dt1 ($118.61 in chips) 
Seat 2: StayFit4 ($110.43 in chips) 
Seat 3: BrilliantDawn84 ($123.85 in chips) 
Seat 4: SGodoyJr ($127.01 in chips) 
Seat 5: Dbackhouse1 ($39.60 in chips) 
Seat 6: reiyser ($100 in chips) 
jeffy27dt1: posts small blind $0.50
StayFit4: posts big blind $1
*** HOLE CARDS ***
BrilliantDawn84: folds 
SGodoyJr: folds 
Dbackhouse1: raises $1 to $2
reiyser: folds 
jeffy27dt1: folds 
StayFit4: calls $1
*** FLOP *** [9d 6s Ah]
StayFit4: checks 
Dbackhouse1: bets $2.14
StayFit4: folds 
Uncalled bet ($2.14) returned to Dbackhouse1
Dbackhouse1 collected $4.28 from pot
*** SUMMARY ***
Total pot $4.50 | Rake $0.22 
Board [9d 6s Ah]
Seat 1: jeffy27dt1 (small blind) folded before Flop
Seat 2: StayFit4 (big blind) folded on the Flop
Seat 3: BrilliantDawn84 folded before Flop (didn't bet)
Seat 4: SGodoyJr folded before Flop (didn't bet)
Seat 5: Dbackhouse1 collected ($4.28)
Seat 6: reiyser (button) folded before Flop (didn't bet)



PokerStars Hand #254516150192:  Hold'em No Limit ($0.50/$1.00 USD) - 2025/01/23 17:17:10 WET [2025/01/23 12:17:10 ET]
Table 'Helewalda IV' 6-max Seat #1 is the button
Seat 1: jeffy27dt1 ($118.11 in chips) 
Seat 2: StayFit4 ($108.43 in chips) 
Seat 3: BrilliantDawn84 ($123.85 in chips) 
Seat 4: SGodoyJr ($127.01 in chips) 
Seat 5: Dbackhouse1 ($41.88 in chips) 
Seat 6: reiyser ($100 in chips) 
StayFit4: posts small blind $0.50
BrilliantDawn84: posts big blind $1
*** HOLE CARDS ***
SGodoyJr: folds 
Dbackhouse1: raises $1 to $2
reiyser: folds 
jeffy27dt1: folds 
StayFit4: folds 
BrilliantDawn84: folds 
Uncalled bet ($1) returned to Dbackhouse1
Dbackhouse1 collected $2.50 from pot
*** SUMMARY ***
Total pot $2.50 | Rake $0 
Seat 1: jeffy27dt1 (button) folded before Flop (didn't bet)
Seat 2: StayFit4 (small blind) folded before Flop
Seat 3: BrilliantDawn84 (big blind) folded before Flop
Seat 4: SGodoyJr folded before Flop (didn't bet)
Seat 5: Dbackhouse1 collected ($2.50)
Seat 6: reiyser folded before Flop (didn't bet)



PokerStars Hand #254516154154:  Hold'em No Limit ($0.50/$1.00 USD) - 2025/01/23 17:17:28 WET [2025/01/23 12:17:28 ET]
Table 'Helewalda IV' 6-max Seat #2 is the button
Seat 1: jeffy27dt1 ($118.11 in chips) 
Seat 2: StayFit4 ($107.93 in chips) 
Seat 3: BrilliantDawn84 ($122.85 in chips) 
Seat 4: SGodoyJr ($127.01 in chips) 
Seat 5: Dbackhouse1 ($43.38 in chips) 
Seat 6: reiyser ($100 in chips) 
BrilliantDawn84: posts small blind $0.50
SGodoyJr: posts big blind $1
*** HOLE CARDS ***
Dbackhouse1: raises $1 to $2
reiyser: folds 
jeffy27dt1: folds 
StayFit4: raises $4 to $6
BrilliantDawn84: folds 
SGodoyJr: folds 
Dbackhouse1: calls $4
*** FLOP *** [Qs Ad 4c]
Dbackhouse1: checks 
StayFit4: checks 
*** TURN *** [Qs Ad 4c] [8d]
Dbackhouse1: checks 
StayFit4: checks 
*** RIVER *** [Qs Ad 4c 8d] [6d]
Dbackhouse1: checks 
StayFit4: checks 
*** SHOW DOWN ***
Dbackhouse1: shows [Jh Jd] (a pair of Jacks)
StayFit4: mucks hand 
Dbackhouse1 collected $12.82 from pot
*** SUMMARY ***
Total pot $13.50 | Rake $0.68 
Board [Qs Ad 4c 8d 6d]
Seat 1: jeffy27dt1 folded before Flop (didn't bet)
Seat 2: StayFit4 (button) mucked
Seat 3: BrilliantDawn84 (small blind) folded before Flop
Seat 4: SGodoyJr (big blind) folded before Flop
Seat 5: Dbackhouse1 showed [Jh Jd] and won ($12.82) with a pair of Jacks
Seat 6: reiyser folded before Flop (didn't bet)



PokerStars Hand #254516168111:  Hold'em No Limit ($0.50/$1.00 USD) - 2025/01/23 17:18:32 WET [2025/01/23 12:18:32 ET]
Table 'Helewalda IV' 6-max Seat #3 is the button
Seat 1: jeffy27dt1 ($118.11 in chips) 
Seat 2: StayFit4 ($101.93 in chips) 
Seat 3: BrilliantDawn84 ($122.35 in chips) 
Seat 4: SGodoyJr ($126.01 in chips) 
Seat 5: Dbackhouse1 ($50.20 in chips) 
Seat 6: reiyser ($100 in chips) 
SGodoyJr: posts small blind $0.50
Dbackhouse1: posts big blind $1
*** HOLE CARDS ***
reiyser: raises $1.23 to $2.23
jeffy27dt1: folds 
StayFit4: folds 
BrilliantDawn84: raises $5.27 to $7.50
SGodoyJr: folds 
Dbackhouse1: folds 
reiyser: folds 
Uncalled bet ($5.27) returned to BrilliantDawn84
BrilliantDawn84 collected $5.96 from pot
BrilliantDawn84: doesn't show hand 
*** SUMMARY ***
Total pot $5.96 | Rake $0 
Seat 1: jeffy27dt1 folded before Flop (didn't bet)
Seat 2: StayFit4 folded before Flop (didn't bet)
Seat 3: BrilliantDawn84 (button) collected ($5.96)
Seat 4: SGodoyJr (small blind) folded before Flop
Seat 5: Dbackhouse1 (big blind) folded before Flop
Seat 6: reiyser folded before Flop



PokerStars Hand #254516173704:  Hold'em No Limit ($0.50/$1.00 USD) - 2025/01/23 17:18:58 WET [2025/01/23 12:18:58 ET]
Table 'Helewalda IV' 6-max Seat #4 is the button
Seat 1: jeffy27dt1 ($118.11 in chips) 
Seat 2: StayFit4 ($101.93 in chips) 
Seat 3: BrilliantDawn84 ($126.08 in chips) 
Seat 4: SGodoyJr ($125.51 in chips) 
Seat 5: Dbackhouse1 ($49.20 in chips) 
Seat 6: reiyser ($100 in chips) 
Dbackhouse1: posts small blind $0.50
reiyser: posts big blind $1
*** HOLE CARDS ***
jeffy27dt1: folds 
StayFit4: folds 
BrilliantDawn84: folds 
SGodoyJr: folds 
Dbackhouse1: folds 
Uncalled bet ($0.50) returned to reiyser
reiyser collected $1 from pot
reiyser: doesn't show hand 
*** SUMMARY ***
Total pot $1 | Rake $0 
Seat 1: jeffy27dt1 folded before Flop (didn't bet)
Seat 2: StayFit4 folded before Flop (didn't bet)
Seat 3: BrilliantDawn84 folded before Flop (didn't bet)
Seat 4: SGodoyJr (button) folded before Flop (didn't bet)
Seat 5: Dbackhouse1 (small blind) folded before Flop
Seat 6: reiyser (big blind) collected ($1)



PokerStars Hand #254516176617:  Hold'em No Limit ($0.50/$1.00 USD) - 2025/01/23 17:19:11 WET [2025/01/23 12:19:11 ET]
Table 'Helewalda IV' 6-max Seat #5 is the button
Seat 1: jeffy27dt1 ($118.11 in chips) 
Seat 2: StayFit4 ($101.93 in chips) 
Seat 3: BrilliantDawn84 ($126.08 in chips) 
Seat 4: SGodoyJr ($125.51 in chips) 
Seat 5: Dbackhouse1 ($48.70 in chips) 
Seat 6: reiyser ($100.50 in chips) 
reiyser: posts small blind $0.50
jeffy27dt1: posts big blind $1
*** HOLE CARDS ***
StayFit4: folds 
BrilliantDawn84: raises $1.50 to $2.50
SGodoyJr: folds 
Dbackhouse1: raises $3.50 to $6
reiyser: folds 
jeffy27dt1: folds 
BrilliantDawn84: calls $3.50
*** FLOP *** [Kh 7h 4h]
BrilliantDawn84: checks 
Dbackhouse1: bets $6.41
BrilliantDawn84: folds 
Uncalled bet ($6.41) returned to Dbackhouse1
Dbackhouse1 collected $12.82 from pot
*** SUMMARY ***
Total pot $13.50 | Rake $0.68 
Board [Kh 7h 4h]
Seat 1: jeffy27dt1 (big blind) folded before Flop
Seat 2: StayFit4 folded before Flop (didn't bet)
Seat 3: BrilliantDawn84 folded on the Flop
Seat 4: SGodoyJr folded before Flop (didn't bet)
Seat 5: Dbackhouse1 (button) collected ($12.82)
Seat 6: reiyser (small blind) folded before Flop



PokerStars Hand #254516182454:  Hold'em No Limit ($0.50/$1.00 USD) - 2025/01/23 17:19:38 WET [2025/01/23 12:19:38 ET]
Table 'Helewalda IV' 6-max Seat #6 is the button
Seat 1: jeffy27dt1 ($117.11 in chips) 
Seat 2: StayFit4 ($101.93 in chips) 
Seat 3: BrilliantDawn84 ($120.08 in chips) 
Seat 4: SGodoyJr ($125.51 in chips) 
Seat 5: Dbackhouse1 ($55.52 in chips) 
Seat 6: reiyser ($100 in chips) 
jeffy27dt1: posts small blind $0.50
StayFit4: posts big blind $1
*** HOLE CARDS ***
BrilliantDawn84: folds 
SGodoyJr: folds 
Dbackhouse1: raises $1 to $2
reiyser: folds 
jeffy27dt1: folds 
StayFit4: calls $1
*** FLOP *** [5h 2d 6h]
StayFit4: checks 
Dbackhouse1: checks 
*** TURN *** [5h 2d 6h] [9s]
StayFit4: bets $6.33
Dbackhouse1: folds 
Uncalled bet ($6.33) returned to StayFit4
StayFit4 collected $4.28 from pot
StayFit4: doesn't show hand 
*** SUMMARY ***
Total pot $4.50 | Rake $0.22 
Board [5h 2d 6h 9s]
Seat 1: jeffy27dt1 (small blind) folded before Flop
Seat 2: StayFit4 (big blind) collected ($4.28)
Seat 3: BrilliantDawn84 folded before Flop (didn't bet)
Seat 4: SGodoyJr folded before Flop (didn't bet)
Seat 5: Dbackhouse1 folded on the Turn
Seat 6: reiyser (button) folded before Flop (didn't bet)



PokerStars Hand #254516188122:  Hold'em No Limit ($0.50/$1.00 USD) - 2025/01/23 17:20:03 WET [2025/01/23 12:20:03 ET]
Table 'Helewalda IV' 6-max Seat #1 is the button
Seat 1: jeffy27dt1 ($116.61 in chips) 
Seat 2: StayFit4 ($104.21 in chips) 
Seat 3: BrilliantDawn84 ($120.08 in chips) 
Seat 4: SGodoyJr ($125.51 in chips) 
Seat 5: Dbackhouse1 ($53.52 in chips) 
Seat 6: reiyser ($100 in chips) 
StayFit4: posts small blind $0.50
BrilliantDawn84: posts big blind $1
*** HOLE CARDS ***
SGodoyJr: folds 
Dbackhouse1: folds 
reiyser: raises $1.23 to $2.23
jeffy27dt1: folds 
StayFit4: raises $8.77 to $11
BrilliantDawn84: folds 
reiyser: folds 
Uncalled bet ($8.77) returned to StayFit4
StayFit4 collected $5.46 from pot
StayFit4: doesn't show hand 
*** SUMMARY ***
Total pot $5.46 | Rake $0 
Seat 1: jeffy27dt1 (button) folded before Flop (didn't bet)
Seat 2: StayFit4 (small blind) collected ($5.46)
Seat 3: BrilliantDawn84 (big blind) folded before Flop
Seat 4: SGodoyJr folded before Flop (didn't bet)
Seat 5: Dbackhouse1 folded before Flop (didn't bet)
Seat 6: reiyser folded before Flop



PokerStars Hand #254516194683:  Hold'em No Limit ($0.50/$1.00 USD) - 2025/01/23 17:20:34 WET [2025/01/23 12:20:34 ET]
Table 'Helewalda IV' 6-max Seat #2 is the button
Seat 1: jeffy27dt1 ($116.61 in chips) 
Seat 2: StayFit4 ($107.44 in chips) 
Seat 3: BrilliantDawn84 ($119.08 in chips) 
Seat 4: SGodoyJr ($125.51 in chips) 
Seat 5: Dbackhouse1 ($53.52 in chips) 
Seat 6: reiyser ($100 in chips) 
BrilliantDawn84: posts small blind $0.50
SGodoyJr: posts big blind $1
*** HOLE CARDS ***
Dbackhouse1: folds 
reiyser: folds 
jeffy27dt1: folds 
StayFit4: raises $1.50 to $2.50
BrilliantDawn84: raises $5 to $7.50
SGodoyJr: folds 
StayFit4: calls $5
*** FLOP *** [5c 8s 4s]
BrilliantDawn84: bets $8.60
StayFit4: folds 
Uncalled bet ($8.60) returned to BrilliantDawn84
BrilliantDawn84 collected $15.20 from pot
BrilliantDawn84: doesn't show hand 
*** SUMMARY ***
Total pot $16 | Rake $0.80 
Board [5c 8s 4s]
Seat 1: jeffy27dt1 folded before Flop (didn't bet)
Seat 2: StayFit4 (button) folded on the Flop
Seat 3: BrilliantDawn84 (small blind) collected ($15.20)
Seat 4: SGodoyJr (big blind) folded before Flop
Seat 5: Dbackhouse1 folded before Flop (didn't bet)
Seat 6: reiyser folded before Flop (didn't bet)



PokerStars Hand #254516204545:  Hold'em No Limit ($0.50/$1.00 USD) - 2025/01/23 17:21:19 WET [2025/01/23 12:21:19 ET]
Table 'Helewalda IV' 6-max Seat #3 is the button
Seat 1: jeffy27dt1 ($116.61 in chips) 
Seat 2: StayFit4 ($100 in chips) 
Seat 3: BrilliantDawn84 ($126.78 in chips) 
Seat 4: SGodoyJr ($124.51 in chips) 
Seat 5: Dbackhouse1 ($53.52 in chips) 
Seat 6: reiyser ($100 in chips) 
SGodoyJr: posts small blind $0.50
Dbackhouse1: posts big blind $1
*** HOLE CARDS ***
reiyser: folds 
jeffy27dt1: raises $1.50 to $2.50
StayFit4: folds 
BrilliantDawn84: calls $2.50
SGodoyJr: folds 
Dbackhouse1: calls $1.50
*** FLOP *** [Kd 5h 9s]
Dbackhouse1: checks 
jeffy27dt1: checks 
BrilliantDawn84: checks 
*** TURN *** [Kd 5h 9s] [Jc]
Dbackhouse1: checks 
jeffy27dt1: checks 
BrilliantDawn84: bets $3.80
Dbackhouse1: folds 
jeffy27dt1: calls $3.80
*** RIVER *** [Kd 5h 9s Jc] [7s]
jeffy27dt1: checks 
BrilliantDawn84: checks 
*** SHOW DOWN ***
jeffy27dt1: shows [Ad Jh] (a pair of Jacks)
BrilliantDawn84: mucks hand 
jeffy27dt1 collected $14.82 from pot
*** SUMMARY ***
Total pot $15.60 | Rake $0.78 
Board [Kd 5h 9s Jc 7s]
Seat 1: jeffy27dt1 showed [Ad Jh] and won ($14.82) with a pair of Jacks
Seat 2: StayFit4 folded before Flop (didn't bet)
Seat 3: BrilliantDawn84 (button) mucked
Seat 4: SGodoyJr (small blind) folded before Flop
Seat 5: Dbackhouse1 (big blind) folded on the Turn
Seat 6: reiyser folded before Flop (didn't bet)



PokerStars Hand #254516220690:  Hold'em No Limit ($0.50/$1.00 USD) - 2025/01/23 17:22:32 WET [2025/01/23 12:22:32 ET]
Table 'Helewalda IV' 6-max Seat #4 is the button
Seat 1: jeffy27dt1 ($125.13 in chips) 
Seat 2: StayFit4 ($100 in chips) 
Seat 3: BrilliantDawn84 ($120.48 in chips) 
Seat 4: SGodoyJr ($124.01 in chips) 
Seat 5: Dbackhouse1 ($51.02 in chips) 
Seat 6: reiyser ($100 in chips) 
Dbackhouse1: posts small blind $0.50
reiyser: posts big blind $1
*** HOLE CARDS ***
jeffy27dt1: folds 
StayFit4: raises $1 to $2
BrilliantDawn84: folds 
SGodoyJr: folds 
Dbackhouse1: folds 
reiyser: calls $1
*** FLOP *** [6h Ac Jd]
reiyser: checks 
StayFit4: checks 
*** TURN *** [6h Ac Jd] [Qd]
reiyser: bets $3.25
StayFit4: calls $3.25
*** RIVER *** [6h Ac Jd Qd] [Th]
reiyser: checks 
StayFit4: checks 
*** SHOW DOWN ***
reiyser: shows [9d 8d] (a straight, Eight to Queen)
StayFit4: mucks hand 
reiyser collected $10.45 from pot
*** SUMMARY ***
Total pot $11 | Rake $0.55 
Board [6h Ac Jd Qd Th]
Seat 1: jeffy27dt1 folded before Flop (didn't bet)
Seat 2: StayFit4 mucked
Seat 3: BrilliantDawn84 folded before Flop (didn't bet)
Seat 4: SGodoyJr (button) folded before Flop (didn't bet)
Seat 5: Dbackhouse1 (small blind) folded before Flop
Seat 6: reiyser (big blind) showed [9d 8d] and won ($10.45) with a straight, Eight to Queen



PokerStars Hand #254516234925:  Hold'em No Limit ($0.50/$1.00 USD) - 2025/01/23 17:23:37 WET [2025/01/23 12:23:37 ET]
Table 'Helewalda IV' 6-max Seat #5 is the button
Seat 1: jeffy27dt1 ($125.13 in chips) 
Seat 2: StayFit4 ($100 in chips) 
Seat 3: BrilliantDawn84 ($120.48 in chips) 
Seat 4: SGodoyJr ($124.01 in chips) 
Seat 5: Dbackhouse1 ($50.52 in chips) 
Seat 6: reiyser ($105.20 in chips) 
reiyser: posts small blind $0.50
jeffy27dt1: posts big blind $1
*** HOLE CARDS ***
StayFit4: folds 
BrilliantDawn84: folds 
SGodoyJr: raises $1 to $2
Dbackhouse1: folds 
reiyser: folds 
jeffy27dt1: folds 
Uncalled bet ($1) returned to SGodoyJr
SGodoyJr collected $2.50 from pot
SGodoyJr: doesn't show hand 
*** SUMMARY ***
Total pot $2.50 | Rake $0 
Seat 1: jeffy27dt1 (big blind) folded before Flop
Seat 2: StayFit4 folded before Flop (didn't bet)
Seat 3: BrilliantDawn84 folded before Flop (didn't bet)
Seat 4: SGodoyJr collected ($2.50)
Seat 5: Dbackhouse1 (button) folded before Flop (didn't bet)
Seat 6: reiyser (small blind) folded before Flop



PokerStars Hand #254516238229:  Hold'em No Limit ($0.50/$1.00 USD) - 2025/01/23 17:23:52 WET [2025/01/23 12:23:52 ET]
Table 'Helewalda IV' 6-max Seat #6 is the button
Seat 1: jeffy27dt1 ($124.13 in chips) 
Seat 2: StayFit4 ($100 in chips) 
Seat 3: BrilliantDawn84 ($120.48 in chips) 
Seat 4: SGodoyJr ($125.51 in chips) 
Seat 5: Dbackhouse1 ($50.52 in chips) 
Seat 6: reiyser ($104.70 in chips) 
jeffy27dt1: posts small blind $0.50
StayFit4: posts big blind $1
*** HOLE CARDS ***
BrilliantDawn84: folds 
SGodoyJr: folds 
Dbackhouse1: folds 
reiyser: folds 
jeffy27dt1: raises $2 to $3
StayFit4: calls $2
*** FLOP *** [3h Jh Qc]
jeffy27dt1: checks 
StayFit4: bets $1.88
jeffy27dt1: folds 
Uncalled bet ($1.88) returned to StayFit4
StayFit4 collected $5.70 from pot
StayFit4: doesn't show hand 
*** SUMMARY ***
Total pot $6 | Rake $0.30 
Board [3h Jh Qc]
Seat 1: jeffy27dt1 (small blind) folded on the Flop
Seat 2: StayFit4 (big blind) collected ($5.70)
Seat 3: BrilliantDawn84 folded before Flop (didn't bet)
Seat 4: SGodoyJr folded before Flop (didn't bet)
Seat 5: Dbackhouse1 folded before Flop (didn't bet)
Seat 6: reiyser (button) folded before Flop (didn't bet)



PokerStars Hand #254516252802:  Hold'em No Limit ($0.50/$1.00 USD) - 2025/01/23 17:25:00 WET [2025/01/23 12:25:00 ET]
Table 'Helewalda IV' 6-max Seat #1 is the button
Seat 1: jeffy27dt1 ($121.13 in chips) 
Seat 2: StayFit4 ($102.70 in chips) 
Seat 3: BrilliantDawn84 ($120.48 in chips) 
Seat 4: SGodoyJr ($125.51 in chips) 
Seat 5: Dbackhouse1 ($50.52 in chips) 
Seat 6: reiyser ($104.70 in chips) 
StayFit4: posts small blind $0.50
BrilliantDawn84: posts big blind $1
*** HOLE CARDS ***
SGodoyJr: raises $1 to $2
Dbackhouse1: folds 
reiyser: folds 
jeffy27dt1: folds 
StayFit4: folds 
BrilliantDawn84: folds 
Uncalled bet ($1) returned to SGodoyJr
SGodoyJr collected $2.50 from pot
SGodoyJr: doesn't show hand 
*** SUMMARY ***
Total pot $2.50 | Rake $0 
Seat 1: jeffy27dt1 (button) folded before Flop (didn't bet)
Seat 2: StayFit4 (small blind) folded before Flop
Seat 3: BrilliantDawn84 (big blind) folded before Flop
Seat 4: SGodoyJr collected ($2.50)
Seat 5: Dbackhouse1 folded before Flop (didn't bet)
Seat 6: reiyser folded before Flop (didn't bet)



PokerStars Hand #254516256230:  Hold'em No Limit ($0.50/$1.00 USD) - 2025/01/23 17:25:15 WET [2025/01/23 12:25:15 ET]
Table 'Helewalda IV' 6-max Seat #2 is the button
Seat 1: jeffy27dt1 ($121.13 in chips) 
Seat 2: StayFit4 ($102.20 in chips) 
Seat 3: BrilliantDawn84 ($119.48 in chips) 
Seat 4: SGodoyJr ($127.01 in chips) 
Seat 5: Dbackhouse1 ($50.52 in chips) 
Seat 6: reiyser ($104.70 in chips) 
BrilliantDawn84: posts small blind $0.50
SGodoyJr: posts big blind $1
*** HOLE CARDS ***
Dbackhouse1: folds 
reiyser: folds 
jeffy27dt1: folds 
StayFit4: folds 
BrilliantDawn84: folds 
Uncalled bet ($0.50) returned to SGodoyJr
SGodoyJr collected $1 from pot
SGodoyJr: doesn't show hand 
*** SUMMARY ***
Total pot $1 | Rake $0 
Seat 1: jeffy27dt1 folded before Flop (didn't bet)
Seat 2: StayFit4 (button) folded before Flop (didn't bet)
Seat 3: BrilliantDawn84 (small blind) folded before Flop
Seat 4: SGodoyJr (big blind) collected ($1)
Seat 5: Dbackhouse1 folded before Flop (didn't bet)
Seat 6: reiyser folded before Flop (didn't bet)



PokerStars Hand #254516259619:  Hold'em No Limit ($0.50/$1.00 USD) - 2025/01/23 17:25:31 WET [2025/01/23 12:25:31 ET]
Table 'Helewalda IV' 6-max Seat #3 is the button
Seat 1: jeffy27dt1 ($121.13 in chips) 
Seat 2: StayFit4 ($102.20 in chips) 
Seat 3: BrilliantDawn84 ($118.98 in chips) 
Seat 4: SGodoyJr ($127.51 in chips) 
Seat 5: Dbackhouse1 ($50.52 in chips) 
Seat 6: reiyser ($104.70 in chips) 
SGodoyJr: posts small blind $0.50
Dbackhouse1: posts big blind $1
*** HOLE CARDS ***
reiyser: folds 
jeffy27dt1: folds 
StayFit4: folds 
BrilliantDawn84: folds 
SGodoyJr: folds 
Uncalled bet ($0.50) returned to Dbackhouse1
Dbackhouse1 collected $1 from pot
*** SUMMARY ***
Total pot $1 | Rake $0 
Seat 1: jeffy27dt1 folded before Flop (didn't bet)
Seat 2: StayFit4 folded before Flop (didn't bet)
Seat 3: BrilliantDawn84 (button) folded before Flop (didn't bet)
Seat 4: SGodoyJr (small blind) folded before Flop
Seat 5: Dbackhouse1 (big blind) collected ($1)
Seat 6: reiyser folded before Flop (didn't bet)



PokerStars Hand #254516261668:  Hold'em No Limit ($0.50/$1.00 USD) - 2025/01/23 17:25:40 WET [2025/01/23 12:25:40 ET]
Table 'Helewalda IV' 6-max Seat #4 is the button
Seat 1: jeffy27dt1 ($121.13 in chips) 
Seat 2: StayFit4 ($102.20 in chips) 
Seat 3: BrilliantDawn84 ($118.98 in chips) 
Seat 4: SGodoyJr ($127.01 in chips) 
Seat 5: Dbackhouse1 ($51.02 in chips) 
Seat 6: reiyser ($104.70 in chips) 
Dbackhouse1: posts small blind $0.50
reiyser: posts big blind $1
*** HOLE CARDS ***
jeffy27dt1: folds 
StayFit4: folds 
BrilliantDawn84: folds 
SGodoyJr: raises $1.50 to $2.50
Dbackhouse1: folds 
reiyser: folds 
Uncalled bet ($1.50) returned to SGodoyJr
SGodoyJr collected $2.50 from pot
SGodoyJr: doesn't show hand 
*** SUMMARY ***
Total pot $2.50 | Rake $0 
Seat 1: jeffy27dt1 folded before Flop (didn't bet)
Seat 2: StayFit4 folded before Flop (didn't bet)
Seat 3: BrilliantDawn84 folded before Flop (didn't bet)
Seat 4: SGodoyJr (button) collected ($2.50)
Seat 5: Dbackhouse1 (small blind) folded before Flop
Seat 6: reiyser (big blind) folded before Flop



PokerStars Hand #254516266277:  Hold'em No Limit ($0.50/$1.00 USD) - 2025/01/23 17:26:01 WET [2025/01/23 12:26:01 ET]
Table 'Helewalda IV' 6-max Seat #5 is the button
Seat 1: jeffy27dt1 ($121.13 in chips) 
Seat 2: StayFit4 ($102.20 in chips) 
Seat 3: BrilliantDawn84 ($118.98 in chips) 
Seat 4: SGodoyJr ($128.51 in chips) 
Seat 5: Dbackhouse1 ($50.52 in chips) 
Seat 6: reiyser ($103.70 in chips) 
reiyser: posts small blind $0.50
jeffy27dt1: posts big blind $1
*** HOLE CARDS ***
StayFit4: folds 
BrilliantDawn84: raises $1.50 to $2.50
SGodoyJr: folds 
Dbackhouse1: raises $7.50 to $10
reiyser: folds 
jeffy27dt1: folds 
BrilliantDawn84: raises $108.98 to $118.98 and is all-in
Dbackhouse1: calls $40.52 and is all-in
Uncalled bet ($68.46) returned to BrilliantDawn84
*** FLOP *** [2h 4c Ts]
*** TURN *** [2h 4c Ts] [Js]
*** RIVER *** [2h 4c Ts Js] [4h]
*** SHOW DOWN ***
BrilliantDawn84: shows [Ks Ad] (a pair of Fours)
Dbackhouse1: shows [Kh Kc] (two pair, Kings and Fours)
Dbackhouse1 collected $100.04 from pot
*** SUMMARY ***
Total pot $102.54 | Rake $2.50 
Board [2h 4c Ts Js 4h]
Seat 1: jeffy27dt1 (big blind) folded before Flop
Seat 2: StayFit4 folded before Flop (didn't bet)
Seat 3: BrilliantDawn84 showed [Ks Ad] and lost with a pair of Fours
Seat 4: SGodoyJr folded before Flop (didn't bet)
Seat 5: Dbackhouse1 (button) showed [Kh Kc] and won ($100.04) with two pair, Kings and Fours
Seat 6: reiyser (small blind) folded before Flop



PokerStars Hand #254516273357:  Hold'em No Limit ($0.50/$1.00 USD) - 2025/01/23 17:26:33 WET [2025/01/23 12:26:33 ET]
Table 'Helewalda IV' 6-max Seat #6 is the button
Seat 1: jeffy27dt1 ($120.13 in chips) 
Seat 2: StayFit4 ($102.20 in chips) 
Seat 3: BrilliantDawn84 ($68.46 in chips) 
Seat 4: SGodoyJr ($128.51 in chips) 
Seat 5: Dbackhouse1 ($100.04 in chips) 
Seat 6: reiyser ($103.20 in chips) 
jeffy27dt1: posts small blind $0.50
StayFit4: posts big blind $1
*** HOLE CARDS ***
BrilliantDawn84: folds 
BrilliantDawn84 leaves the table
SGodoyJr: folds 
Dbackhouse1: raises $1 to $2
reiyser: folds 
jeffy27dt1: folds 
StayFit4: folds 
Uncalled bet ($1) returned to Dbackhouse1
Dbackhouse1 collected $2.50 from pot
*** SUMMARY ***
Total pot $2.50 | Rake $0 
Seat 1: jeffy27dt1 (small blind) folded before Flop
Seat 2: StayFit4 (big blind) folded before Flop
Seat 3: BrilliantDawn84 folded before Flop (didn't bet)
Seat 4: SGodoyJr folded before Flop (didn't bet)
Seat 5: Dbackhouse1 collected ($2.50)
Seat 6: reiyser (button) folded before Flop (didn't bet)



PokerStars Hand #254516276727:  Hold'em No Limit ($0.50/$1.00 USD) - 2025/01/23 17:26:48 WET [2025/01/23 12:26:48 ET]
Table 'Helewalda IV' 6-max Seat #1 is the button
Seat 1: jeffy27dt1 ($119.63 in chips) 
Seat 2: StayFit4 ($101.20 in chips) 
Seat 4: SGodoyJr ($128.51 in chips) 
Seat 5: Dbackhouse1 ($101.54 in chips) 
Seat 6: reiyser ($103.20 in chips) 
StayFit4: posts small blind $0.50
SGodoyJr: posts big blind $1
*** HOLE CARDS ***
Dbackhouse1: raises $1 to $2
Pumuking joins the table at seat #3 
reiyser: raises $5 to $7
jeffy27dt1: folds 
StayFit4: folds 
SGodoyJr: folds 
Dbackhouse1: calls $5
*** FLOP *** [Ks 7d 6d]
Dbackhouse1: checks 
reiyser: bets $4.27
Dbackhouse1: folds 
Uncalled bet ($4.27) returned to reiyser
reiyser collected $14.72 from pot
reiyser: doesn't show hand 
*** SUMMARY ***
Total pot $15.50 | Rake $0.78 
Board [Ks 7d 6d]
Seat 1: jeffy27dt1 (button) folded before Flop (didn't bet)
Seat 2: StayFit4 (small blind) folded before Flop
Seat 4: SGodoyJr (big blind) folded before Flop
Seat 5: Dbackhouse1 folded on the Flop
Seat 6: reiyser collected ($14.72)



PokerStars Hand #254516283100:  Hold'em No Limit ($0.50/$1.00 USD) - 2025/01/23 17:27:16 WET [2025/01/23 12:27:16 ET]
Table 'Helewalda IV' 6-max Seat #2 is the button
Seat 3: Pumuking ($100 in chips) is sitting out
Seat 1: jeffy27dt1 ($119.63 in chips) 
Seat 2: StayFit4 ($100.70 in chips) 
Seat 4: SGodoyJr ($127.51 in chips) 
Seat 5: Dbackhouse1 ($94.54 in chips) 
Seat 6: reiyser ($110.92 in chips) 
SGodoyJr: posts small blind $0.50
Dbackhouse1: posts big blind $1
*** HOLE CARDS ***
reiyser: folds 
jeffy27dt1: folds 
StayFit4: folds 
SGodoyJr: raises $2 to $3
Dbackhouse1: folds 
Uncalled bet ($2) returned to SGodoyJr
SGodoyJr collected $2 from pot
SGodoyJr: doesn't show hand 
*** SUMMARY ***
Total pot $2 | Rake $0 
Seat 3: Pumuking
Seat 1: jeffy27dt1 folded before Flop (didn't bet)
Seat 2: StayFit4 (button) folded before Flop (didn't bet)
Seat 4: SGodoyJr (small blind) collected ($2)
Seat 5: Dbackhouse1 (big blind) folded before Flop
Seat 6: reiyser folded before Flop (didn't bet)



PokerStars Hand #254516286672:  Hold'em No Limit ($0.50/$1.00 USD) - 2025/01/23 17:27:33 WET [2025/01/23 12:27:33 ET]
Table 'Helewalda IV' 6-max Seat #4 is the button
Seat 3: Pumuking ($100 in chips) is sitting out
Seat 1: jeffy27dt1 ($119.63 in chips) 
Seat 2: StayFit4 ($100.70 in chips) 
Seat 4: SGodoyJr ($128.51 in chips) 
Seat 5: Dbackhouse1 ($93.54 in chips) 
Seat 6: reiyser ($110.92 in chips) 
Dbackhouse1: posts small blind $0.50
reiyser: posts big blind $1
Pumuking: sits out 
*** HOLE CARDS ***
jeffy27dt1: folds 
StayFit4: raises $1.50 to $2.50
SGodoyJr: folds 
Dbackhouse1: folds 
reiyser: folds 
Uncalled bet ($1.50) returned to StayFit4
StayFit4 collected $2.50 from pot
StayFit4: doesn't show hand 
*** SUMMARY ***
Total pot $2.50 | Rake $0 
Seat 3: Pumuking
Seat 1: jeffy27dt1 folded before Flop (didn't bet)
Seat 2: StayFit4 collected ($2.50)
Seat 4: SGodoyJr (button) folded before Flop (didn't bet)
Seat 5: Dbackhouse1 (small blind) folded before Flop
Seat 6: reiyser (big blind) folded before Flop



PokerStars Hand #254516289751:  Hold'em No Limit ($0.50/$1.00 USD) - 2025/01/23 17:27:46 WET [2025/01/23 12:27:46 ET]
Table 'Helewalda IV' 6-max Seat #5 is the button
Seat 1: jeffy27dt1 ($119.63 in chips) is sitting out
Seat 3: Pumuking ($100 in chips) is sitting out
Seat 2: StayFit4 ($102.20 in chips) 
Seat 4: SGodoyJr ($128.51 in chips) 
Seat 5: Dbackhouse1 ($93.04 in chips) 
Seat 6: reiyser ($109.92 in chips) 
reiyser: posts small blind $0.50
jeffy27dt1: is sitting out 
StayFit4: posts big blind $1
Pumuking: sits out 
*** HOLE CARDS ***
SGodoyJr: folds 
Dbackhouse1: raises $1 to $2
reiyser: folds 
StayFit4: folds 
Uncalled bet ($1) returned to Dbackhouse1
Dbackhouse1 collected $2.50 from pot
jeffy27dt1 leaves the table
*** SUMMARY ***
Total pot $2.50 | Rake $0 
Seat 1: jeffy27dt1
Seat 3: Pumuking
Seat 2: StayFit4 (big blind) folded before Flop
Seat 4: SGodoyJr folded before Flop (didn't bet)
Seat 5: Dbackhouse1 (button) collected ($2.50)
Seat 6: reiyser (small blind) folded before Flop



PokerStars Hand #254516292660:  Hold'em No Limit ($0.50/$1.00 USD) - 2025/01/23 17:28:00 WET [2025/01/23 12:28:00 ET]
Table 'Helewalda IV' 6-max Seat #6 is the button
Seat 2: StayFit4 ($101.20 in chips) 
Seat 3: Pumuking ($100 in chips) 
Seat 4: SGodoyJr ($128.51 in chips) 
Seat 5: Dbackhouse1 ($94.54 in chips) 
Seat 6: reiyser ($109.42 in chips) 
StayFit4: posts small blind $0.50
Pumuking: posts big blind $1
*** HOLE CARDS ***
SGodoyJr: raises $1 to $2
Dbackhouse1: folds 
reiyser: folds 
StayFit4: folds 
Pumuking: folds 
Uncalled bet ($1) returned to SGodoyJr
SGodoyJr collected $2.50 from pot
SGodoyJr: doesn't show hand 
*** SUMMARY ***
Total pot $2.50 | Rake $0 
Seat 2: StayFit4 (small blind) folded before Flop
Seat 3: Pumuking (big blind) folded before Flop
Seat 4: SGodoyJr collected ($2.50)
Seat 5: Dbackhouse1 folded before Flop (didn't bet)
Seat 6: reiyser (button) folded before Flop (didn't bet)



PokerStars Hand #254516295620:  Hold'em No Limit ($0.50/$1.00 USD) - 2025/01/23 17:28:13 WET [2025/01/23 12:28:13 ET]
Table 'Helewalda IV' 6-max Seat #2 is the button
Seat 2: StayFit4 ($100.70 in chips) 
Seat 3: Pumuking ($100 in chips) 
Seat 4: SGodoyJr ($130.01 in chips) 
Seat 5: Dbackhouse1 ($94.54 in chips) 
Seat 6: reiyser ($109.42 in chips) 
Pumuking: posts small blind $0.50
SGodoyJr: posts big blind $1
*** HOLE CARDS ***
Dbackhouse1: folds 
reiyser: folds 
Joe_Li7 joins the table at seat #1 
StayFit4: raises $1.50 to $2.50
Pumuking: folds 
SGodoyJr: calls $1.50
*** FLOP *** [Qd 6s 9d]
SGodoyJr: checks 
StayFit4: bets $3.92
SGodoyJr: calls $3.92
*** TURN *** [Qd 6s 9d] [2h]
SGodoyJr: checks 
StayFit4: checks 
*** RIVER *** [Qd 6s 9d 2h] [4h]
SGodoyJr: bets $9.50
StayFit4: calls $9.50
*** SHOW DOWN ***
SGodoyJr: shows [Th Qs] (a pair of Queens)
StayFit4: mucks hand 
SGodoyJr collected $30.72 from pot
*** SUMMARY ***
Total pot $32.34 | Rake $1.62 
Board [Qd 6s 9d 2h 4h]
Seat 2: StayFit4 (button) mucked
Seat 3: Pumuking (small blind) folded before Flop
Seat 4: SGodoyJr (big blind) showed [Th Qs] and won ($30.72) with a pair of Queens
Seat 5: Dbackhouse1 folded before Flop (didn't bet)
Seat 6: reiyser folded before Flop (didn't bet)



PokerStars Hand #254516315619:  Hold'em No Limit ($0.50/$1.00 USD) - 2025/01/23 17:29:45 WET [2025/01/23 12:29:45 ET]
Table 'Helewalda IV' 6-max Seat #3 is the button
Seat 1: Joe_Li7 ($111.75 in chips) is sitting out
Seat 2: StayFit4 ($100 in chips) 
Seat 3: Pumuking ($100 in chips) 
Seat 4: SGodoyJr ($144.81 in chips) 
Seat 5: Dbackhouse1 ($94.54 in chips) 
Seat 6: reiyser ($109.42 in chips) 
SGodoyJr: posts small blind $0.50
Dbackhouse1: posts big blind $1
Joe_Li7: sits out 
*** HOLE CARDS ***
reiyser: folds 
StayFit4: folds 
Pumuking: raises $1.50 to $2.50
SGodoyJr: folds 
Dbackhouse1: folds 
Uncalled bet ($1.50) returned to Pumuking
Pumuking collected $2.50 from pot
Pumuking: doesn't show hand 
*** SUMMARY ***
Total pot $2.50 | Rake $0 
Seat 1: Joe_Li7
Seat 2: StayFit4 folded before Flop (didn't bet)
Seat 3: Pumuking (button) collected ($2.50)
Seat 4: SGodoyJr (small blind) folded before Flop
Seat 5: Dbackhouse1 (big blind) folded before Flop
Seat 6: reiyser folded before Flop (didn't bet)



PokerStars Hand #254516360366:  Hold'em No Limit ($0.50/$1.00 USD) - 2025/01/23 17:33:02 WET [2025/01/23 12:33:02 ET]
Table 'Helewalda IV' 6-max Seat #5 is the button
Seat 1: Joe_Li7 ($111.75 in chips) 
Seat 2: StayFit4 ($100 in chips) 
Seat 3: Pumuking ($100 in chips) 
Seat 4: SGodoyJr ($147.30 in chips) 
Seat 5: Dbackhouse1 ($79.11 in chips) 
Seat 6: reiyser ($122.17 in chips) 
reiyser: posts small blind $0.50
Joe_Li7: posts big blind $1
*** HOLE CARDS ***
StayFit4: raises $1 to $2
Pumuking: calls $2
SGodoyJr: folds 
Dbackhouse1: folds 
reiyser: folds 
Joe_Li7: folds 
*** FLOP *** [4s 7d 5d]
StayFit4: checks 
Pumuking: checks 
*** TURN *** [4s 7d 5d] [3h]
StayFit4: bets $1.72
Pumuking: calls $1.72
*** RIVER *** [4s 7d 5d 3h] [8c]
StayFit4: checks 
Pumuking: checks 
*** SHOW DOWN ***
StayFit4: shows [Ad Kh] (high card Ace)
Pumuking: mucks hand 
StayFit4 collected $8.49 from pot
*** SUMMARY ***
Total pot $8.94 | Rake $0.45 
Board [4s 7d 5d 3h 8c]
Seat 1: Joe_Li7 (big blind) folded before Flop
Seat 2: StayFit4 showed [Ad Kh] and won ($8.49) with high card Ace
Seat 3: Pumuking mucked
Seat 4: SGodoyJr folded before Flop (didn't bet)
Seat 5: Dbackhouse1 (button) folded before Flop (didn't bet)
Seat 6: reiyser (small blind) folded before Flop



PokerStars Hand #254516375996:  Hold'em No Limit ($0.50/$1.00 USD) - 2025/01/23 17:34:12 WET [2025/01/23 12:34:12 ET]
Table 'Helewalda IV' 6-max Seat #6 is the button
Seat 1: Joe_Li7 ($110.75 in chips) 
Seat 2: StayFit4 ($104.77 in chips) 
Seat 3: Pumuking ($100 in chips) 
Seat 4: SGodoyJr ($147.30 in chips) 
Seat 5: Dbackhouse1 ($79.11 in chips) 
Seat 6: reiyser ($121.67 in chips) 
Joe_Li7: posts small blind $0.50
StayFit4: posts big blind $1
*** HOLE CARDS ***
Pumuking: folds 
SGodoyJr: folds 
Dbackhouse1: folds 
reiyser: folds 
Joe_Li7: folds 
Uncalled bet ($0.50) returned to StayFit4
StayFit4 collected $1 from pot
StayFit4: doesn't show hand 
*** SUMMARY ***
Total pot $1 | Rake $0 
Seat 1: Joe_Li7 (small blind) folded before Flop
Seat 2: StayFit4 (big blind) collected ($1)
Seat 3: Pumuking folded before Flop (didn't bet)
Seat 4: SGodoyJr folded before Flop (didn't bet)
Seat 5: Dbackhouse1 folded before Flop (didn't bet)
Seat 6: reiyser (button) folded before Flop (didn't bet)



PokerStars Hand #254516378301:  Hold'em No Limit ($0.50/$1.00 USD) - 2025/01/23 17:34:22 WET [2025/01/23 12:34:22 ET]
Table 'Helewalda IV' 6-max Seat #1 is the button
Seat 1: Joe_Li7 ($110.25 in chips) 
Seat 2: StayFit4 ($105.27 in chips) 
Seat 3: Pumuking ($100 in chips) 
Seat 4: SGodoyJr ($147.30 in chips) 
Seat 5: Dbackhouse1 ($79.11 in chips) 
Seat 6: reiyser ($121.67 in chips) 
StayFit4: posts small blind $0.50
Pumuking: posts big blind $1
*** HOLE CARDS ***
SGodoyJr: folds 
Dbackhouse1: raises $1.50 to $2.50
reiyser: folds 
Joe_Li7: folds 
StayFit4: folds 
Pumuking: folds 
Uncalled bet ($1.50) returned to Dbackhouse1
Dbackhouse1 collected $2.50 from pot
*** SUMMARY ***
Total pot $2.50 | Rake $0 
Seat 1: Joe_Li7 (button) folded before Flop (didn't bet)
Seat 2: StayFit4 (small blind) folded before Flop
Seat 3: Pumuking (big blind) folded before Flop
Seat 4: SGodoyJr folded before Flop (didn't bet)
Seat 5: Dbackhouse1 collected ($2.50)
Seat 6: reiyser folded before Flop (didn't bet)



PokerStars Hand #254516380810:  Hold'em No Limit ($0.50/$1.00 USD) - 2025/01/23 17:34:33 WET [2025/01/23 12:34:33 ET]
Table 'Helewalda IV' 6-max Seat #2 is the button
Seat 1: Joe_Li7 ($110.25 in chips) 
Seat 2: StayFit4 ($104.77 in chips) 
Seat 3: Pumuking ($100 in chips) 
Seat 4: SGodoyJr ($147.30 in chips) 
Seat 5: Dbackhouse1 ($80.61 in chips) 
Seat 6: reiyser ($121.67 in chips) 
Pumuking: posts small blind $0.50
SGodoyJr: posts big blind $1
*** HOLE CARDS ***
Dbackhouse1: folds 
reiyser: folds 
Joe_Li7: folds 
StayFit4: folds 
Pumuking: folds 
Uncalled bet ($0.50) returned to SGodoyJr
SGodoyJr collected $1 from pot
SGodoyJr: doesn't show hand 
*** SUMMARY ***
Total pot $1 | Rake $0 
Seat 1: Joe_Li7 folded before Flop (didn't bet)
Seat 2: StayFit4 (button) folded before Flop (didn't bet)
Seat 3: Pumuking (small blind) folded before Flop
Seat 4: SGodoyJr (big blind) collected ($1)
Seat 5: Dbackhouse1 folded before Flop (didn't bet)
Seat 6: reiyser folded before Flop (didn't bet)



PokerStars Hand #254516383697:  Hold'em No Limit ($0.50/$1.00 USD) - 2025/01/23 17:34:46 WET [2025/01/23 12:34:46 ET]
Table 'Helewalda IV' 6-max Seat #3 is the button
Seat 1: Joe_Li7 ($110.25 in chips) 
Seat 2: StayFit4 ($104.77 in chips) 
Seat 3: Pumuking ($100 in chips) 
Seat 4: SGodoyJr ($147.80 in chips) 
Seat 5: Dbackhouse1 ($80.61 in chips) 
Seat 6: reiyser ($121.67 in chips) 
SGodoyJr: posts small blind $0.50
Dbackhouse1: posts big blind $1
*** HOLE CARDS ***
reiyser: folds 
Joe_Li7: folds 
StayFit4: raises $1.50 to $2.50
Pumuking: folds 
SGodoyJr: folds 
Dbackhouse1: calls $1.50
*** FLOP *** [Kh Kd 2s]
Dbackhouse1: checks 
StayFit4: bets $1.36
Dbackhouse1: calls $1.36
*** TURN *** [Kh Kd 2s] [2c]
Dbackhouse1: checks 
StayFit4: checks 
*** RIVER *** [Kh Kd 2s 2c] [3s]
Dbackhouse1: checks 
StayFit4: checks 
*** SHOW DOWN ***
Dbackhouse1: shows [As 6d] (two pair, Kings and Deuces)
StayFit4: shows [9s Ad] (two pair, Kings and Deuces)
Dbackhouse1 collected $3.91 from pot
StayFit4 collected $3.90 from pot
*** SUMMARY ***
Total pot $8.22 | Rake $0.41 
Board [Kh Kd 2s 2c 3s]
Seat 1: Joe_Li7 folded before Flop (didn't bet)
Seat 2: StayFit4 showed [9s Ad] and won ($3.90) with two pair, Kings and Deuces
Seat 3: Pumuking (button) folded before Flop (didn't bet)
Seat 4: SGodoyJr (small blind) folded before Flop
Seat 5: Dbackhouse1 (big blind) showed [As 6d] and won ($3.91) with two pair, Kings and Deuces
Seat 6: reiyser folded before Flop (didn't bet)



PokerStars Hand #254516391594:  Hold'em No Limit ($0.50/$1.00 USD) - 2025/01/23 17:35:22 WET [2025/01/23 12:35:22 ET]
Table 'Helewalda IV' 6-max Seat #4 is the button
Seat 1: Joe_Li7 ($110.25 in chips) 
Seat 2: StayFit4 ($104.81 in chips) 
Seat 3: Pumuking ($100 in chips) 
Seat 4: SGodoyJr ($147.30 in chips) 
Seat 5: Dbackhouse1 ($80.66 in chips) 
Seat 6: reiyser ($121.67 in chips) 
Dbackhouse1: posts small blind $0.50
reiyser: posts big blind $1
*** HOLE CARDS ***
Joe_Li7: folds 
StayFit4: folds 
Pumuking: folds 
SGodoyJr: raises $1.50 to $2.50
Dbackhouse1: folds 
reiyser: folds 
Uncalled bet ($1.50) returned to SGodoyJr
SGodoyJr collected $2.50 from pot
SGodoyJr: doesn't show hand 
*** SUMMARY ***
Total pot $2.50 | Rake $0 
Seat 1: Joe_Li7 folded before Flop (didn't bet)
Seat 2: StayFit4 folded before Flop (didn't bet)
Seat 3: Pumuking folded before Flop (didn't bet)
Seat 4: SGodoyJr (button) collected ($2.50)
Seat 5: Dbackhouse1 (small blind) folded before Flop
Seat 6: reiyser (big blind) folded before Flop



PokerStars Hand #254516394700:  Hold'em No Limit ($0.50/$1.00 USD) - 2025/01/23 17:35:35 WET [2025/01/23 12:35:35 ET]
Table 'Helewalda IV' 6-max Seat #5 is the button
Seat 1: Joe_Li7 ($110.25 in chips) 
Seat 2: StayFit4 ($104.81 in chips) 
Seat 3: Pumuking ($100 in chips) 
Seat 4: SGodoyJr ($148.80 in chips) 
Seat 5: Dbackhouse1 ($80.16 in chips) 
Seat 6: reiyser ($120.67 in chips) 
reiyser: posts small blind $0.50
Joe_Li7: posts big blind $1
*** HOLE CARDS ***
StayFit4: folds 
Pumuking: folds 
SGodoyJr: raises $1 to $2
Dbackhouse1: calls $2
reiyser: folds 
Joe_Li7: raises $11 to $13
SGodoyJr: folds 
Dbackhouse1: folds 
Uncalled bet ($11) returned to Joe_Li7
Joe_Li7 collected $6.50 from pot
*** SUMMARY ***
Total pot $6.50 | Rake $0 
Seat 1: Joe_Li7 (big blind) collected ($6.50)
Seat 2: StayFit4 folded before Flop (didn't bet)
Seat 3: Pumuking folded before Flop (didn't bet)
Seat 4: SGodoyJr folded before Flop
Seat 5: Dbackhouse1 (button) folded before Flop
Seat 6: reiyser (small blind) folded before Flop



PokerStars Hand #254516400741:  Hold'em No Limit ($0.50/$1.00 USD) - 2025/01/23 17:36:02 WET [2025/01/23 12:36:02 ET]
Table 'Helewalda IV' 6-max Seat #6 is the button
Seat 1: Joe_Li7 ($114.75 in chips) 
Seat 2: StayFit4 ($104.81 in chips) 
Seat 3: Pumuking ($100 in chips) 
Seat 4: SGodoyJr ($146.80 in chips) 
Seat 5: Dbackhouse1 ($78.16 in chips) 
Seat 6: reiyser ($120.17 in chips) 
Joe_Li7: posts small blind $0.50
StayFit4: posts big blind $1
*** HOLE CARDS ***
Pumuking: folds 
SGodoyJr: folds 
Dbackhouse1: folds 
reiyser: raises $1.23 to $2.23
Joe_Li7: folds 
StayFit4: raises $9.77 to $12
reiyser: raises $108.17 to $120.17 and is all-in
StayFit4: folds 
Uncalled bet ($108.17) returned to reiyser
reiyser collected $24.50 from pot
reiyser: doesn't show hand 
*** SUMMARY ***
Total pot $24.50 | Rake $0 
Seat 1: Joe_Li7 (small blind) folded before Flop
Seat 2: StayFit4 (big blind) folded before Flop
Seat 3: Pumuking folded before Flop (didn't bet)
Seat 4: SGodoyJr folded before Flop (didn't bet)
Seat 5: Dbackhouse1 folded before Flop (didn't bet)
Seat 6: reiyser (button) collected ($24.50)



PokerStars Hand #254516407536:  Hold'em No Limit ($0.50/$1.00 USD) - 2025/01/23 17:36:32 WET [2025/01/23 12:36:32 ET]
Table 'Helewalda IV' 6-max Seat #1 is the button
Seat 1: Joe_Li7 ($114.25 in chips) 
Seat 2: StayFit4 ($100 in chips) 
Seat 3: Pumuking ($100 in chips) 
Seat 4: SGodoyJr ($146.80 in chips) 
Seat 5: Dbackhouse1 ($78.16 in chips) 
Seat 6: reiyser ($132.67 in chips) 
StayFit4: posts small blind $0.50
Pumuking: posts big blind $1
*** HOLE CARDS ***
SGodoyJr: raises $1 to $2
Dbackhouse1: folds 
reiyser: folds 
Joe_Li7: raises $5 to $7
StayFit4: folds 
Pumuking: folds 
SGodoyJr: calls $5
*** FLOP *** [5s Th Js]
SGodoyJr: checks 
Joe_Li7: bets $7.35
SGodoyJr: folds 
Uncalled bet ($7.35) returned to Joe_Li7
Joe_Li7 collected $14.72 from pot
*** SUMMARY ***
Total pot $15.50 | Rake $0.78 
Board [5s Th Js]
Seat 1: Joe_Li7 (button) collected ($14.72)
Seat 2: StayFit4 (small blind) folded before Flop
Seat 3: Pumuking (big blind) folded before Flop
Seat 4: SGodoyJr folded on the Flop
Seat 5: Dbackhouse1 folded before Flop (didn't bet)
Seat 6: reiyser folded before Flop (didn't bet)



PokerStars Hand #254516420979:  Hold'em No Limit ($0.50/$1.00 USD) - 2025/01/23 17:37:31 WET [2025/01/23 12:37:31 ET]
Table 'Helewalda IV' 6-max Seat #2 is the button
Seat 4: SGodoyJr ($139.80 in chips) is sitting out
Seat 1: Joe_Li7 ($121.97 in chips) 
Seat 2: StayFit4 ($100 in chips) 
Seat 3: Pumuking ($100 in chips) 
Seat 5: Dbackhouse1 ($78.16 in chips) 
Seat 6: reiyser ($132.67 in chips) 
Pumuking: posts small blind $0.50
SGodoyJr: is sitting out 
Dbackhouse1: posts big blind $1
*** HOLE CARDS ***
reiyser: folds 
SGodoyJr leaves the table
Iseedora joins the table at seat #4 
Joe_Li7: folds 
StayFit4: raises $1.50 to $2.50
Pumuking: folds 
Dbackhouse1: folds 
Uncalled bet ($1.50) returned to StayFit4
StayFit4 collected $2.50 from pot
StayFit4: doesn't show hand 
*** SUMMARY ***
Total pot $2.50 | Rake $0 
Seat 4: SGodoyJr
Seat 1: Joe_Li7 folded before Flop (didn't bet)
Seat 2: StayFit4 (button) collected ($2.50)
Seat 3: Pumuking (small blind) folded before Flop
Seat 5: Dbackhouse1 (big blind) folded before Flop
Seat 6: reiyser folded before Flop (didn't bet)



PokerStars Hand #254516424603:  Hold'em No Limit ($0.50/$1.00 USD) - 2025/01/23 17:37:47 WET [2025/01/23 12:37:47 ET]
Table 'Helewalda IV' 6-max Seat #3 is the button
Seat 4: Iseedora ($100 in chips) is sitting out
Seat 1: Joe_Li7 ($121.97 in chips) 
Seat 2: StayFit4 ($101.50 in chips) 
Seat 3: Pumuking ($100 in chips) 
Seat 5: Dbackhouse1 ($77.16 in chips) 
Seat 6: reiyser ($132.67 in chips) 
Dbackhouse1: posts small blind $0.50
reiyser: posts big blind $1
*** HOLE CARDS ***
Joe_Li7: raises $1.20 to $2.20
StayFit4: folds 
Pumuking: folds 
Dbackhouse1: calls $1.70
reiyser: folds 
*** FLOP *** [8d Js 7s]
Dbackhouse1: checks 
Joe_Li7: checks 
*** TURN *** [8d Js 7s] [4c]
Dbackhouse1: bets $2.57
Joe_Li7: folds 
Uncalled bet ($2.57) returned to Dbackhouse1
Dbackhouse1 collected $5.13 from pot
*** SUMMARY ***
Total pot $5.40 | Rake $0.27 
Board [8d Js 7s 4c]
Seat 4: Iseedora
Seat 1: Joe_Li7 folded on the Turn
Seat 2: StayFit4 folded before Flop (didn't bet)
Seat 3: Pumuking (button) folded before Flop (didn't bet)
Seat 5: Dbackhouse1 (small blind) collected ($5.13)
Seat 6: reiyser (big blind) folded before Flop



PokerStars Hand #254516432591:  Hold'em No Limit ($0.50/$1.00 USD) - 2025/01/23 17:38:22 WET [2025/01/23 12:38:22 ET]
Table 'Helewalda IV' 6-max Seat #5 is the button
Seat 4: Iseedora ($100 in chips) is sitting out
Seat 1: Joe_Li7 ($119.77 in chips) 
Seat 2: StayFit4 ($101.50 in chips) 
Seat 3: Pumuking ($100 in chips) 
Seat 5: Dbackhouse1 ($80.09 in chips) 
Seat 6: reiyser ($131.67 in chips) 
reiyser: posts small blind $0.50
Joe_Li7: posts big blind $1
Iseedora: sits out 
*** HOLE CARDS ***
StayFit4: raises $1 to $2
Pumuking: folds 
Dbackhouse1: calls $2
reiyser: folds 
Joe_Li7: folds 
*** FLOP *** [6d Ah 9h]
StayFit4: checks 
Dbackhouse1: checks 
*** TURN *** [6d Ah 9h] [9d]
StayFit4: bets $1.72
Dbackhouse1: calls $1.72
*** RIVER *** [6d Ah 9h 9d] [9s]
StayFit4: bets $2.80
Dbackhouse1: calls $2.80
*** SHOW DOWN ***
StayFit4: shows [Jh Jc] (a full house, Nines full of Jacks)
Dbackhouse1: mucks hand 
StayFit4 collected $13.81 from pot
*** SUMMARY ***
Total pot $14.54 | Rake $0.73 
Board [6d Ah 9h 9d 9s]
Seat 4: Iseedora
Seat 1: Joe_Li7 (big blind) folded before Flop
Seat 2: StayFit4 showed [Jh Jc] and won ($13.81) with a full house, Nines full of Jacks
Seat 3: Pumuking folded before Flop (didn't bet)
Seat 5: Dbackhouse1 (button) mucked
Seat 6: reiyser (small blind) folded before Flop



PokerStars Hand #254516443995:  Hold'em No Limit ($0.50/$1.00 USD) - 2025/01/23 17:39:13 WET [2025/01/23 12:39:13 ET]
Table 'Helewalda IV' 6-max Seat #6 is the button
Seat 4: Iseedora ($100 in chips) is sitting out
Seat 1: Joe_Li7 ($118.77 in chips) 
Seat 2: StayFit4 ($108.79 in chips) 
Seat 3: Pumuking ($100 in chips) 
Seat 5: Dbackhouse1 ($73.57 in chips) 
Seat 6: reiyser ($131.17 in chips) 
Joe_Li7: posts small blind $0.50
StayFit4: posts big blind $1
Iseedora: sits out 
*** HOLE CARDS ***
Pumuking: folds 
Dbackhouse1: raises $1.50 to $2.50
reiyser: folds 
Joe_Li7: raises $10.50 to $13
StayFit4: folds 
Dbackhouse1: folds 
Uncalled bet ($10.50) returned to Joe_Li7
Joe_Li7 collected $6 from pot
*** SUMMARY ***
Total pot $6 | Rake $0 
Seat 4: Iseedora
Seat 1: Joe_Li7 (small blind) collected ($6)
Seat 2: StayFit4 (big blind) folded before Flop
Seat 3: Pumuking folded before Flop (didn't bet)
Seat 5: Dbackhouse1 folded before Flop
Seat 6: reiyser (button) folded before Flop (didn't bet)



PokerStars Hand #254516448531:  Hold'em No Limit ($0.50/$1.00 USD) - 2025/01/23 17:39:33 WET [2025/01/23 12:39:33 ET]
Table 'Helewalda IV' 6-max Seat #1 is the button
Seat 4: Iseedora ($100 in chips) is sitting out
Seat 1: Joe_Li7 ($122.27 in chips) 
Seat 2: StayFit4 ($107.79 in chips) 
Seat 3: Pumuking ($100 in chips) 
Seat 5: Dbackhouse1 ($71.07 in chips) 
Seat 6: reiyser ($131.17 in chips) 
StayFit4: posts small blind $0.50
Pumuking: posts big blind $1
Iseedora: sits out 
*** HOLE CARDS ***
Dbackhouse1: folds 
reiyser: raises $1.23 to $2.23
Joe_Li7: folds 
StayFit4: folds 
Pumuking: calls $1.23
*** FLOP *** [Ks Jc 9c]
Pumuking: checks 
reiyser: bets $2.45
Pumuking: folds 
Uncalled bet ($2.45) returned to reiyser
reiyser collected $4.71 from pot
reiyser: doesn't show hand 
*** SUMMARY ***
Total pot $4.96 | Rake $0.25 
Board [Ks Jc 9c]
Seat 4: Iseedora
Seat 1: Joe_Li7 (button) folded before Flop (didn't bet)
Seat 2: StayFit4 (small blind) folded before Flop
Seat 3: Pumuking (big blind) folded on the Flop
Seat 5: Dbackhouse1 folded before Flop (didn't bet)
Seat 6: reiyser collected ($4.71)



PokerStars Hand #254516456173:  Hold'em No Limit ($0.50/$1.00 USD) - 2025/01/23 17:40:07 WET [2025/01/23 12:40:07 ET]
Table 'Helewalda IV' 6-max Seat #2 is the button
Seat 1: Joe_Li7 ($122.27 in chips) 
Seat 2: StayFit4 ($107.29 in chips) 
Seat 3: Pumuking ($100 in chips) 
Seat 4: Iseedora ($100 in chips) 
Seat 5: Dbackhouse1 ($71.07 in chips) 
Seat 6: reiyser ($133.65 in chips) 
Pumuking: posts small blind $0.50
Iseedora: posts big blind $1
*** HOLE CARDS ***
Dbackhouse1: raises $1 to $2
reiyser: folds 
Joe_Li7: folds 
StayFit4: folds 
Pumuking: folds 
Iseedora: folds 
Uncalled bet ($1) returned to Dbackhouse1
Dbackhouse1 collected $2.50 from pot
*** SUMMARY ***
Total pot $2.50 | Rake $0 
Seat 1: Joe_Li7 folded before Flop (didn't bet)
Seat 2: StayFit4 (button) folded before Flop (didn't bet)
Seat 3: Pumuking (small blind) folded before Flop
Seat 4: Iseedora (big blind) folded before Flop
Seat 5: Dbackhouse1 collected ($2.50)
Seat 6: reiyser folded before Flop (didn't bet)



PokerStars Hand #254516460444:  Hold'em No Limit ($0.50/$1.00 USD) - 2025/01/23 17:40:26 WET [2025/01/23 12:40:26 ET]
Table 'Helewalda IV' 6-max Seat #3 is the button
Seat 1: Joe_Li7 ($122.27 in chips) 
Seat 2: StayFit4 ($107.29 in chips) 
Seat 3: Pumuking ($100 in chips) 
Seat 4: Iseedora ($100 in chips) 
Seat 5: Dbackhouse1 ($72.57 in chips) 
Seat 6: reiyser ($133.65 in chips) 
Iseedora: posts small blind $0.50
Dbackhouse1: posts big blind $1
*** HOLE CARDS ***
reiyser: folds 
Joe_Li7: folds 
StayFit4: folds 
Pumuking: folds 
Iseedora: folds 
Uncalled bet ($0.50) returned to Dbackhouse1
Dbackhouse1 collected $1 from pot
*** SUMMARY ***
Total pot $1 | Rake $0 
Seat 1: Joe_Li7 folded before Flop (didn't bet)
Seat 2: StayFit4 folded before Flop (didn't bet)
Seat 3: Pumuking (button) folded before Flop (didn't bet)
Seat 4: Iseedora (small blind) folded before Flop
Seat 5: Dbackhouse1 (big blind) collected ($1)
Seat 6: reiyser folded before Flop (didn't bet)



PokerStars Hand #254516463188:  Hold'em No Limit ($0.50/$1.00 USD) - 2025/01/23 17:40:39 WET [2025/01/23 12:40:39 ET]
Table 'Helewalda IV' 6-max Seat #4 is the button
Seat 1: Joe_Li7 ($122.27 in chips) 
Seat 2: StayFit4 ($107.29 in chips) 
Seat 3: Pumuking ($100 in chips) 
Seat 4: Iseedora ($100 in chips) 
Seat 5: Dbackhouse1 ($73.07 in chips) 
Seat 6: reiyser ($133.65 in chips) 
Dbackhouse1: posts small blind $0.50
reiyser: posts big blind $1
*** HOLE CARDS ***
Joe_Li7: folds 
StayFit4: raises $1 to $2
Pumuking: folds 
Iseedora: raises $4.50 to $6.50
Dbackhouse1: folds 
reiyser: folds 
StayFit4: raises $12.50 to $19
Iseedora: raises $81 to $100 and is all-in
StayFit4: calls $81
*** FLOP *** [6c 8s 4h]
*** TURN *** [6c 8s 4h] [Tc]
*** RIVER *** [6c 8s 4h Tc] [7d]
*** SHOW DOWN ***
StayFit4: shows [Jc Jh] (a pair of Jacks)
Iseedora: shows [Ks Kd] (a pair of Kings)
Iseedora collected $199 from pot
*** SUMMARY ***
Total pot $201.50 | Rake $2.50 
Board [6c 8s 4h Tc 7d]
Seat 1: Joe_Li7 folded before Flop (didn't bet)
Seat 2: StayFit4 showed [Jc Jh] and lost with a pair of Jacks
Seat 3: Pumuking folded before Flop (didn't bet)
Seat 4: Iseedora (button) showed [Ks Kd] and won ($199) with a pair of Kings
Seat 5: Dbackhouse1 (small blind) folded before Flop
Seat 6: reiyser (big blind) folded before Flop



PokerStars Hand #254516477781:  Hold'em No Limit ($0.50/$1.00 USD) - 2025/01/23 17:41:44 WET [2025/01/23 12:41:44 ET]
Table 'Helewalda IV' 6-max Seat #5 is the button
Seat 1: Joe_Li7 ($122.27 in chips) 
Seat 2: StayFit4 ($100 in chips) 
Seat 3: Pumuking ($100 in chips) 
Seat 4: Iseedora ($199 in chips) 
Seat 5: Dbackhouse1 ($72.57 in chips) 
Seat 6: reiyser ($132.65 in chips) 
reiyser: posts small blind $0.50
Joe_Li7: posts big blind $1
*** HOLE CARDS ***
StayFit4: raises $1 to $2
Pumuking: folds 
Iseedora: folds 
Dbackhouse1: folds 
reiyser: folds 
Joe_Li7: calls $1
*** FLOP *** [Th Kc 6s]
Joe_Li7: checks 
StayFit4: bets $1.41
Joe_Li7: calls $1.41
*** TURN *** [Th Kc 6s] [Ad]
Joe_Li7: checks 
StayFit4: bets $5.21
Joe_Li7: folds 
Uncalled bet ($5.21) returned to StayFit4
StayFit4 collected $6.95 from pot
StayFit4: doesn't show hand 
*** SUMMARY ***
Total pot $7.32 | Rake $0.37 
Board [Th Kc 6s Ad]
Seat 1: Joe_Li7 (big blind) folded on the Turn
Seat 2: StayFit4 collected ($6.95)
Seat 3: Pumuking folded before Flop (didn't bet)
Seat 4: Iseedora folded before Flop (didn't bet)
Seat 5: Dbackhouse1 (button) folded before Flop (didn't bet)
Seat 6: reiyser (small blind) folded before Flop



PokerStars Hand #254516491980:  Hold'em No Limit ($0.50/$1.00 USD) - 2025/01/23 17:42:48 WET [2025/01/23 12:42:48 ET]
Table 'Helewalda IV' 6-max Seat #6 is the button
Seat 1: Joe_Li7 ($118.86 in chips) 
Seat 2: StayFit4 ($103.54 in chips) 
Seat 3: Pumuking ($100 in chips) 
Seat 4: Iseedora ($199 in chips) 
Seat 5: Dbackhouse1 ($72.57 in chips) 
Seat 6: reiyser ($132.15 in chips) 
Joe_Li7: posts small blind $0.50
StayFit4: posts big blind $1
*** HOLE CARDS ***
Pumuking: raises $1.25 to $2.25
Iseedora: folds 
Dbackhouse1: calls $2.25
reiyser: folds 
Joe_Li7: folds 
StayFit4: calls $1.25
*** FLOP *** [3s 8c Ts]
StayFit4: checks 
Pumuking: checks 
Dbackhouse1: bets $5.89
StayFit4: folds 
Pumuking: folds 
Uncalled bet ($5.89) returned to Dbackhouse1
Dbackhouse1 collected $6.89 from pot
*** SUMMARY ***
Total pot $7.25 | Rake $0.36 
Board [3s 8c Ts]
Seat 1: Joe_Li7 (small blind) folded before Flop
Seat 2: StayFit4 (big blind) folded on the Flop
Seat 3: Pumuking folded on the Flop
Seat 4: Iseedora folded before Flop (didn't bet)
Seat 5: Dbackhouse1 collected ($6.89)
Seat 6: reiyser (button) folded before Flop (didn't bet)



PokerStars Hand #254516500463:  Hold'em No Limit ($0.50/$1.00 USD) - 2025/01/23 17:43:26 WET [2025/01/23 12:43:26 ET]
Table 'Helewalda IV' 6-max Seat #1 is the button
Seat 1: Joe_Li7 ($118.36 in chips) 
Seat 2: StayFit4 ($101.29 in chips) 
Seat 3: Pumuking ($100 in chips) 
Seat 4: Iseedora ($199 in chips) 
Seat 5: Dbackhouse1 ($77.21 in chips) 
Seat 6: reiyser ($132.15 in chips) 
StayFit4: posts small blind $0.50
Pumuking: posts big blind $1
*** HOLE CARDS ***
Iseedora: folds 
Dbackhouse1: folds 
reiyser: folds 
Joe_Li7: folds 
StayFit4: folds 
Uncalled bet ($0.50) returned to Pumuking
Pumuking collected $1 from pot
Pumuking: doesn't show hand 
*** SUMMARY ***
Total pot $1 | Rake $0 
Seat 1: Joe_Li7 (button) folded before Flop (didn't bet)
Seat 2: StayFit4 (small blind) folded before Flop
Seat 3: Pumuking (big blind) collected ($1)
Seat 4: Iseedora folded before Flop (didn't bet)
Seat 5: Dbackhouse1 folded before Flop (didn't bet)
Seat 6: reiyser folded before Flop (didn't bet)



PokerStars Hand #254516504145:  Hold'em No Limit ($0.50/$1.00 USD) - 2025/01/23 17:43:42 WET [2025/01/23 12:43:42 ET]
Table 'Helewalda IV' 6-max Seat #2 is the button
Seat 1: Joe_Li7 ($118.36 in chips) 
Seat 2: StayFit4 ($100.79 in chips) 
Seat 3: Pumuking ($100.50 in chips) 
Seat 4: Iseedora ($199 in chips) 
Seat 5: Dbackhouse1 ($77.21 in chips) 
Seat 6: reiyser ($132.15 in chips) 
Pumuking: posts small blind $0.50
Iseedora: posts big blind $1
*** HOLE CARDS ***
Dbackhouse1: raises $1 to $2
reiyser: folds 
Joe_Li7: folds 
StayFit4: raises $5 to $7
Pumuking: folds 
Iseedora: folds 
Dbackhouse1: folds 
Uncalled bet ($5) returned to StayFit4
StayFit4 collected $5.50 from pot
StayFit4: doesn't show hand 
*** SUMMARY ***
Total pot $5.50 | Rake $0 
Seat 1: Joe_Li7 folded before Flop (didn't bet)
Seat 2: StayFit4 (button) collected ($5.50)
Seat 3: Pumuking (small blind) folded before Flop
Seat 4: Iseedora (big blind) folded before Flop
Seat 5: Dbackhouse1 folded before Flop
Seat 6: reiyser folded before Flop (didn't bet)



PokerStars Hand #254516507646:  Hold'em No Limit ($0.50/$1.00 USD) - 2025/01/23 17:43:58 WET [2025/01/23 12:43:58 ET]
Table 'Helewalda IV' 6-max Seat #3 is the button
Seat 1: Joe_Li7 ($118.36 in chips) 
Seat 2: StayFit4 ($104.29 in chips) 
Seat 3: Pumuking ($100 in chips) 
Seat 4: Iseedora ($198 in chips) 
Seat 5: Dbackhouse1 ($75.21 in chips) 
Seat 6: reiyser ($132.15 in chips) 
Iseedora: posts small blind $0.50
Dbackhouse1: posts big blind $1
*** HOLE CARDS ***
reiyser: folds 
Joe_Li7: folds 
StayFit4: raises $1.50 to $2.50
Pumuking: folds 
Iseedora: folds 
Dbackhouse1: raises $4.50 to $7
StayFit4: calls $4.50
*** FLOP *** [9h 4d 9d]
Dbackhouse1: bets $4.89
StayFit4: calls $4.89
*** TURN *** [9h 4d 9d] [Kh]
Dbackhouse1: bets $9.54
StayFit4: raises $21.08 to $30.62
Dbackhouse1: folds 
Uncalled bet ($21.08) returned to StayFit4
StayFit4 collected $41.19 from pot
StayFit4: doesn't show hand 
*** SUMMARY ***
Total pot $43.36 | Rake $2.17 
Board [9h 4d 9d Kh]
Seat 1: Joe_Li7 folded before Flop (didn't bet)
Seat 2: StayFit4 collected ($41.19)
Seat 3: Pumuking (button) folded before Flop (didn't bet)
Seat 4: Iseedora (small blind) folded before Flop
Seat 5: Dbackhouse1 (big blind) folded on the Turn
Seat 6: reiyser folded before Flop (didn't bet)



PokerStars Hand #254516524221:  Hold'em No Limit ($0.50/$1.00 USD) - 2025/01/23 17:45:12 WET [2025/01/23 12:45:12 ET]
Table 'Helewalda IV' 6-max Seat #4 is the button
Seat 1: Joe_Li7 ($118.36 in chips) 
Seat 2: StayFit4 ($124.05 in chips) 
Seat 3: Pumuking ($100 in chips) 
Seat 4: Iseedora ($197.50 in chips) 
Seat 5: Dbackhouse1 ($53.78 in chips) 
Seat 6: reiyser ($132.15 in chips) 
Dbackhouse1: posts small blind $0.50
reiyser: posts big blind $1
*** HOLE CARDS ***
Joe_Li7: folds 
StayFit4: raises $1 to $2
Pumuking: folds 
Iseedora: folds 
Dbackhouse1: folds 
reiyser: folds 
Uncalled bet ($1) returned to StayFit4
StayFit4 collected $2.50 from pot
StayFit4: doesn't show hand 
*** SUMMARY ***
Total pot $2.50 | Rake $0 
Seat 1: Joe_Li7 folded before Flop (didn't bet)
Seat 2: StayFit4 collected ($2.50)
Seat 3: Pumuking folded before Flop (didn't bet)
Seat 4: Iseedora (button) folded before Flop (didn't bet)
Seat 5: Dbackhouse1 (small blind) folded before Flop
Seat 6: reiyser (big blind) folded before Flop



PokerStars Hand #254516527388:  Hold'em No Limit ($0.50/$1.00 USD) - 2025/01/23 17:45:26 WET [2025/01/23 12:45:26 ET]
Table 'Helewalda IV' 6-max Seat #5 is the button
Seat 1: Joe_Li7 ($118.36 in chips) 
Seat 2: StayFit4 ($125.55 in chips) 
Seat 3: Pumuking ($100 in chips) 
Seat 4: Iseedora ($197.50 in chips) 
Seat 5: Dbackhouse1 ($53.28 in chips) 
Seat 6: reiyser ($131.15 in chips) 
reiyser: posts small blind $0.50
Joe_Li7: posts big blind $1
*** HOLE CARDS ***
StayFit4: raises $1 to $2
Pumuking: folds 
Iseedora: folds 
Dbackhouse1: calls $2
reiyser: folds 
Joe_Li7: folds 
*** FLOP *** [2s Qc 2c]
StayFit4: bets $1.72
Dbackhouse1: calls $1.72
*** TURN *** [2s Qc 2c] [Td]
StayFit4: bets $12.57
Dbackhouse1: calls $12.57
*** RIVER *** [2s Qc 2c Td] [7d]
StayFit4: bets $10.69
Dbackhouse1: calls $10.69
*** SHOW DOWN ***
StayFit4: shows [Jh Ks] (a pair of Deuces)
Dbackhouse1: shows [7s Ts] (two pair, Tens and Sevens)
Dbackhouse1 collected $52.96 from pot
*** SUMMARY ***
Total pot $55.46 | Rake $2.50 
Board [2s Qc 2c Td 7d]
Seat 1: Joe_Li7 (big blind) folded before Flop
Seat 2: StayFit4 showed [Jh Ks] and lost with a pair of Deuces
Seat 3: Pumuking folded before Flop (didn't bet)
Seat 4: Iseedora folded before Flop (didn't bet)
Seat 5: Dbackhouse1 (button) showed [7s Ts] and won ($52.96) with two pair, Tens and Sevens
Seat 6: reiyser (small blind) folded before Flop



PokerStars Hand #254516542235:  Hold'em No Limit ($0.50/$1.00 USD) - 2025/01/23 17:46:32 WET [2025/01/23 12:46:32 ET]
Table 'Helewalda IV' 6-max Seat #6 is the button
Seat 2: StayFit4 ($100 in chips) is sitting out
Seat 1: Joe_Li7 ($117.36 in chips) 
Seat 3: Pumuking ($100 in chips) 
Seat 4: Iseedora ($197.50 in chips) 
Seat 5: Dbackhouse1 ($79.26 in chips) 
Seat 6: reiyser ($130.65 in chips) 
Joe_Li7: posts small blind $0.50
StayFit4: is sitting out 
Pumuking: posts big blind $1
*** HOLE CARDS ***
StayFit4 leaves the table
Iseedora: folds 
Dbackhouse1: folds 
reiyser: folds 
Joe_Li7: raises $2 to $3
Pumuking: folds 
Uncalled bet ($2) returned to Joe_Li7
Joe_Li7 collected $2 from pot
xcinaz joins the table at seat #2 
*** SUMMARY ***
Total pot $2 | Rake $0 
Seat 2: StayFit4
Seat 1: Joe_Li7 (small blind) collected ($2)
Seat 3: Pumuking (big blind) folded before Flop
Seat 4: Iseedora folded before Flop (didn't bet)
Seat 5: Dbackhouse1 folded before Flop (didn't bet)
Seat 6: reiyser (button) folded before Flop (didn't bet)



PokerStars Hand #254516545396:  Hold'em No Limit ($0.50/$1.00 USD) - 2025/01/23 17:46:46 WET [2025/01/23 12:46:46 ET]
Table 'Helewalda IV' 6-max Seat #1 is the button
Seat 2: xcinaz ($100 in chips) is sitting out
Seat 1: Joe_Li7 ($118.36 in chips) 
Seat 3: Pumuking ($100 in chips) 
Seat 4: Iseedora ($197.50 in chips) 
Seat 5: Dbackhouse1 ($79.26 in chips) 
Seat 6: reiyser ($130.65 in chips) 
Pumuking: posts small blind $0.50
Iseedora: posts big blind $1
*** HOLE CARDS ***
Dbackhouse1: raises $1 to $2
reiyser: folds 
Joe_Li7: calls $2
Pumuking: folds 
Iseedora: folds 
*** FLOP *** [5s 9h 3h]
Dbackhouse1: checks 
Joe_Li7: bets $2.09
Dbackhouse1: calls $2.09
*** TURN *** [5s 9h 3h] [Th]
Dbackhouse1: checks 
Joe_Li7: bets $6.44
Dbackhouse1: calls $6.44
*** RIVER *** [5s 9h 3h Th] [As]
Dbackhouse1: checks 
Joe_Li7: bets $26.32
Dbackhouse1: folds 
Uncalled bet ($26.32) returned to Joe_Li7
Joe_Li7 collected $21.43 from pot
*** SUMMARY ***
Total pot $22.56 | Rake $1.13 
Board [5s 9h 3h Th As]
Seat 2: xcinaz
Seat 1: Joe_Li7 (button) collected ($21.43)
Seat 3: Pumuking (small blind) folded before Flop
Seat 4: Iseedora (big blind) folded before Flop
Seat 5: Dbackhouse1 folded on the River
Seat 6: reiyser folded before Flop (didn't bet)



PokerStars Hand #254516562917:  Hold'em No Limit ($0.50/$1.00 USD) - 2025/01/23 17:48:04 WET [2025/01/23 12:48:04 ET]
Table 'Helewalda IV' 6-max Seat #3 is the button
Seat 2: xcinaz ($100 in chips) is sitting out
Seat 1: Joe_Li7 ($129.26 in chips) 
Seat 3: Pumuking ($100 in chips) 
Seat 4: Iseedora ($196.50 in chips) 
Seat 5: Dbackhouse1 ($68.73 in chips) 
Seat 6: reiyser ($130.65 in chips) 
Iseedora: posts small blind $0.50
Dbackhouse1: posts big blind $1
xcinaz: sits out 
*** HOLE CARDS ***
reiyser: folds 
Joe_Li7: folds 
Pumuking: raises $1.50 to $2.50
Iseedora: folds 
Dbackhouse1: calls $1.50
*** FLOP *** [7s 4c As]
Dbackhouse1: checks 
Pumuking: bets $1.72
Dbackhouse1: raises $6.66 to $8.38
Pumuking: calls $6.66
*** TURN *** [7s 4c As] [Js]
Dbackhouse1: bets $7.58
Pumuking: calls $7.58
*** RIVER *** [7s 4c As Js] [8d]
Dbackhouse1: bets $14.78
Pumuking: calls $14.78
*** SHOW DOWN ***
Dbackhouse1: shows [4s 7h] (two pair, Sevens and Fours)
Pumuking: mucks hand 
Dbackhouse1 collected $64.48 from pot
*** SUMMARY ***
Total pot $66.98 | Rake $2.50 
Board [7s 4c As Js 8d]
Seat 2: xcinaz
Seat 1: Joe_Li7 folded before Flop (didn't bet)
Seat 3: Pumuking (button) mucked
Seat 4: Iseedora (small blind) folded before Flop
Seat 5: Dbackhouse1 (big blind) showed [4s 7h] and won ($64.48) with two pair, Sevens and Fours
Seat 6: reiyser folded before Flop (didn't bet)



PokerStars Hand #254516576657:  Hold'em No Limit ($0.50/$1.00 USD) - 2025/01/23 17:49:06 WET [2025/01/23 12:49:06 ET]
Table 'Helewalda IV' 6-max Seat #4 is the button
Seat 2: xcinaz ($100 in chips) is sitting out
Seat 1: Joe_Li7 ($129.26 in chips) 
Seat 3: Pumuking ($100 in chips) 
Seat 4: Iseedora ($196 in chips) 
Seat 5: Dbackhouse1 ($99.97 in chips) 
Seat 6: reiyser ($130.65 in chips) 
Dbackhouse1: posts small blind $0.50
reiyser: posts big blind $1
xcinaz: sits out 
*** HOLE CARDS ***
Joe_Li7: raises $1.20 to $2.20
Pumuking: folds 
Iseedora: folds 
Dbackhouse1: folds 
reiyser: raises $9.30 to $11.50
Joe_Li7: folds 
Uncalled bet ($9.30) returned to reiyser
reiyser collected $4.90 from pot
reiyser: doesn't show hand 
*** SUMMARY ***
Total pot $4.90 | Rake $0 
Seat 2: xcinaz
Seat 1: Joe_Li7 folded before Flop
Seat 3: Pumuking folded before Flop (didn't bet)
Seat 4: Iseedora (button) folded before Flop (didn't bet)
Seat 5: Dbackhouse1 (small blind) folded before Flop
Seat 6: reiyser (big blind) collected ($4.90)



PokerStars Hand #254516584004:  Hold'em No Limit ($0.50/$1.00 USD) - 2025/01/23 17:49:39 WET [2025/01/23 12:49:39 ET]
Table 'Helewalda IV' 6-max Seat #5 is the button
Seat 2: xcinaz ($100 in chips) is sitting out
Seat 1: Joe_Li7 ($127.06 in chips) 
Seat 3: Pumuking ($100 in chips) 
Seat 4: Iseedora ($196 in chips) 
Seat 5: Dbackhouse1 ($99.47 in chips) 
Seat 6: reiyser ($133.35 in chips) 
reiyser: posts small blind $0.50
Joe_Li7: posts big blind $1
xcinaz: sits out 
*** HOLE CARDS ***
Pumuking: raises $1.25 to $2.25
Iseedora: folds 
Dbackhouse1: folds 
reiyser: raises $9.25 to $11.50
Joe_Li7: folds 
Pumuking: folds 
Uncalled bet ($9.25) returned to reiyser
reiyser collected $5.50 from pot
reiyser: doesn't show hand 
*** SUMMARY ***
Total pot $5.50 | Rake $0 
Seat 2: xcinaz
Seat 1: Joe_Li7 (big blind) folded before Flop
Seat 3: Pumuking folded before Flop
Seat 4: Iseedora folded before Flop (didn't bet)
Seat 5: Dbackhouse1 (button) folded before Flop (didn't bet)
Seat 6: reiyser (small blind) collected ($5.50)



PokerStars Hand #254516590319:  Hold'em No Limit ($0.50/$1.00 USD) - 2025/01/23 17:50:07 WET [2025/01/23 12:50:07 ET]
Table 'Helewalda IV' 6-max Seat #6 is the button
Seat 1: Joe_Li7 ($126.06 in chips) 
Seat 2: xcinaz ($100 in chips) 
Seat 3: Pumuking ($100 in chips) 
Seat 4: Iseedora ($196 in chips) 
Seat 5: Dbackhouse1 ($99.47 in chips) 
Seat 6: reiyser ($136.60 in chips) 
Joe_Li7: posts small blind $0.50
xcinaz: posts big blind $1
*** HOLE CARDS ***
Pumuking: folds 
Iseedora: folds 
Dbackhouse1: folds 
reiyser: folds 
Joe_Li7: folds 
Uncalled bet ($0.50) returned to xcinaz
xcinaz collected $1 from pot
xcinaz: doesn't show hand 
*** SUMMARY ***
Total pot $1 | Rake $0 
Seat 1: Joe_Li7 (small blind) folded before Flop
Seat 2: xcinaz (big blind) collected ($1)
Seat 3: Pumuking folded before Flop (didn't bet)
Seat 4: Iseedora folded before Flop (didn't bet)
Seat 5: Dbackhouse1 folded before Flop (didn't bet)
Seat 6: reiyser (button) folded before Flop (didn't bet)



PokerStars Hand #254516592920:  Hold'em No Limit ($0.50/$1.00 USD) - 2025/01/23 17:50:19 WET [2025/01/23 12:50:19 ET]
Table 'Helewalda IV' 6-max Seat #1 is the button
Seat 1: Joe_Li7 ($125.56 in chips) 
Seat 2: xcinaz ($100.50 in chips) 
Seat 3: Pumuking ($100 in chips) 
Seat 4: Iseedora ($196 in chips) 
Seat 5: Dbackhouse1 ($99.47 in chips) 
Seat 6: reiyser ($136.60 in chips) 
xcinaz: posts small blind $0.50
Pumuking: posts big blind $1
*** HOLE CARDS ***
Iseedora: folds 
Dbackhouse1: folds 
reiyser: folds 
Joe_Li7: folds 
xcinaz: folds 
Uncalled bet ($0.50) returned to Pumuking
Pumuking collected $1 from pot
Pumuking: doesn't show hand 
*** SUMMARY ***
Total pot $1 | Rake $0 
Seat 1: Joe_Li7 (button) folded before Flop (didn't bet)
Seat 2: xcinaz (small blind) folded before Flop
Seat 3: Pumuking (big blind) collected ($1)
Seat 4: Iseedora folded before Flop (didn't bet)
Seat 5: Dbackhouse1 folded before Flop (didn't bet)
Seat 6: reiyser folded before Flop (didn't bet)



PokerStars Hand #254516597107:  Hold'em No Limit ($0.50/$1.00 USD) - 2025/01/23 17:50:38 WET [2025/01/23 12:50:38 ET]
Table 'Helewalda IV' 6-max Seat #2 is the button
Seat 1: Joe_Li7 ($125.56 in chips) 
Seat 2: xcinaz ($100 in chips) 
Seat 3: Pumuking ($100.50 in chips) 
Seat 4: Iseedora ($196 in chips) 
Seat 5: Dbackhouse1 ($99.47 in chips) 
Seat 6: reiyser ($136.60 in chips) 
Pumuking: posts small blind $0.50
Iseedora: posts big blind $1
*** HOLE CARDS ***
Dbackhouse1: raises $1 to $2
reiyser: folds 
Joe_Li7: folds 
xcinaz: raises $6 to $8
Pumuking: folds 
Iseedora: folds 
Dbackhouse1: folds 
Uncalled bet ($6) returned to xcinaz
xcinaz collected $5.50 from pot
xcinaz: doesn't show hand 
*** SUMMARY ***
Total pot $5.50 | Rake $0 
Seat 1: Joe_Li7 folded before Flop (didn't bet)
Seat 2: xcinaz (button) collected ($5.50)
Seat 3: Pumuking (small blind) folded before Flop
Seat 4: Iseedora (big blind) folded before Flop
Seat 5: Dbackhouse1 folded before Flop
Seat 6: reiyser folded before Flop (didn't bet)



PokerStars Hand #254516602164:  Hold'em No Limit ($0.50/$1.00 USD) - 2025/01/23 17:51:01 WET [2025/01/23 12:51:01 ET]
Table 'Helewalda IV' 6-max Seat #3 is the button
Seat 1: Joe_Li7 ($125.56 in chips) 
Seat 2: xcinaz ($103.50 in chips) 
Seat 3: Pumuking ($100 in chips) 
Seat 4: Iseedora ($195 in chips) 
Seat 5: Dbackhouse1 ($97.47 in chips) 
Seat 6: reiyser ($136.60 in chips) 
Iseedora: posts small blind $0.50
Dbackhouse1: posts big blind $1
*** HOLE CARDS ***
reiyser: folds 
Joe_Li7: raises $1.20 to $2.20
xcinaz: raises $5.80 to $8
Pumuking: folds 
Iseedora: folds 
Dbackhouse1: folds 
Joe_Li7: folds 
Uncalled bet ($5.80) returned to xcinaz
xcinaz collected $5.90 from pot
xcinaz: doesn't show hand 
*** SUMMARY ***
Total pot $5.90 | Rake $0 
Seat 1: Joe_Li7 folded before Flop
Seat 2: xcinaz collected ($5.90)
Seat 3: Pumuking (button) folded before Flop (didn't bet)
Seat 4: Iseedora (small blind) folded before Flop
Seat 5: Dbackhouse1 (big blind) folded before Flop
Seat 6: reiyser folded before Flop (didn't bet)



PokerStars Hand #254516605240:  Hold'em No Limit ($0.50/$1.00 USD) - 2025/01/23 17:51:15 WET [2025/01/23 12:51:15 ET]
Table 'Helewalda IV' 6-max Seat #4 is the button
Seat 1: Joe_Li7 ($123.36 in chips) 
Seat 2: xcinaz ($107.20 in chips) 
Seat 3: Pumuking ($100 in chips) 
Seat 4: Iseedora ($194.50 in chips) 
Seat 5: Dbackhouse1 ($96.47 in chips) 
Seat 6: reiyser ($136.60 in chips) 
Dbackhouse1: posts small blind $0.50
reiyser: posts big blind $1
*** HOLE CARDS ***
Joe_Li7: folds 
xcinaz: folds 
Pumuking: folds 
Iseedora: folds 
Dbackhouse1: raises $1 to $2
reiyser: calls $1
*** FLOP *** [7d As 5h]
Dbackhouse1: bets $1
reiyser: calls $1
*** TURN *** [7d As 5h] [5d]
Dbackhouse1: checks 
reiyser: checks 
*** RIVER *** [7d As 5h 5d] [Ts]
Dbackhouse1: bets $1
reiyser: raises $4 to $5
Dbackhouse1: calls $4
*** SHOW DOWN ***
reiyser: shows [Ac 3d] (two pair, Aces and Fives)
Dbackhouse1: mucks hand 
reiyser collected $15.20 from pot
*** SUMMARY ***
Total pot $16 | Rake $0.80 
Board [7d As 5h 5d Ts]
Seat 1: Joe_Li7 folded before Flop (didn't bet)
Seat 2: xcinaz folded before Flop (didn't bet)
Seat 3: Pumuking folded before Flop (didn't bet)
Seat 4: Iseedora (button) folded before Flop (didn't bet)
Seat 5: Dbackhouse1 (small blind) mucked
Seat 6: reiyser (big blind) showed [Ac 3d] and won ($15.20) with two pair, Aces and Fives



PokerStars Hand #254516618901:  Hold'em No Limit ($0.50/$1.00 USD) - 2025/01/23 17:52:17 WET [2025/01/23 12:52:17 ET]
Table 'Helewalda IV' 6-max Seat #5 is the button
Seat 1: Joe_Li7 ($123.36 in chips) 
Seat 2: xcinaz ($107.20 in chips) 
Seat 3: Pumuking ($100 in chips) 
Seat 4: Iseedora ($194.50 in chips) 
Seat 5: Dbackhouse1 ($88.47 in chips) 
Seat 6: reiyser ($143.80 in chips) 
reiyser: posts small blind $0.50
Joe_Li7: posts big blind $1
*** HOLE CARDS ***
xcinaz: folds 
Pumuking: raises $1.25 to $2.25
Iseedora: raises $5.25 to $7.50
Dbackhouse1: folds 
reiyser: folds 
Joe_Li7: folds 
Pumuking: folds 
Uncalled bet ($5.25) returned to Iseedora
Iseedora collected $6 from pot
Iseedora: doesn't show hand 
*** SUMMARY ***
Total pot $6 | Rake $0 
Seat 1: Joe_Li7 (big blind) folded before Flop
Seat 2: xcinaz folded before Flop (didn't bet)
Seat 3: Pumuking folded before Flop
Seat 4: Iseedora collected ($6)
Seat 5: Dbackhouse1 (button) folded before Flop (didn't bet)
Seat 6: reiyser (small blind) folded before Flop



PokerStars Hand #254516622405:  Hold'em No Limit ($0.50/$1.00 USD) - 2025/01/23 17:52:33 WET [2025/01/23 12:52:33 ET]
Table 'Helewalda IV' 6-max Seat #6 is the button
Seat 1: Joe_Li7 ($122.36 in chips) 
Seat 2: xcinaz ($107.20 in chips) 
Seat 3: Pumuking ($100 in chips) 
Seat 4: Iseedora ($198.25 in chips) 
Seat 5: Dbackhouse1 ($88.47 in chips) 
Seat 6: reiyser ($143.30 in chips) 
Joe_Li7: posts small blind $0.50
xcinaz: posts big blind $1
*** HOLE CARDS ***
Pumuking: raises $1.25 to $2.25
Iseedora: folds 
Dbackhouse1: folds 
reiyser: folds 
Joe_Li7: folds 
xcinaz: calls $1.25
*** FLOP *** [Kh 9h 7c]
xcinaz: checks 
Pumuking: bets $1.57
xcinaz: folds 
Uncalled bet ($1.57) returned to Pumuking
Pumuking collected $4.75 from pot
Pumuking: doesn't show hand 
*** SUMMARY ***
Total pot $5 | Rake $0.25 
Board [Kh 9h 7c]
Seat 1: Joe_Li7 (small blind) folded before Flop
Seat 2: xcinaz (big blind) folded on the Flop
Seat 3: Pumuking collected ($4.75)
Seat 4: Iseedora folded before Flop (didn't bet)
Seat 5: Dbackhouse1 folded before Flop (didn't bet)
Seat 6: reiyser (button) folded before Flop (didn't bet)



PokerStars Hand #254516627940:  Hold'em No Limit ($0.50/$1.00 USD) - 2025/01/23 17:52:58 WET [2025/01/23 12:52:58 ET]
Table 'Helewalda IV' 6-max Seat #1 is the button
Seat 1: Joe_Li7 ($121.86 in chips) 
Seat 2: xcinaz ($104.95 in chips) 
Seat 3: Pumuking ($102.50 in chips) 
Seat 4: Iseedora ($198.25 in chips) 
Seat 5: Dbackhouse1 ($88.47 in chips) 
Seat 6: reiyser ($143.30 in chips) 
xcinaz: posts small blind $0.50
Pumuking: posts big blind $1
*** HOLE CARDS ***
Iseedora: folds 
Dbackhouse1: raises $1 to $2
reiyser: folds 
Joe_Li7: folds 
xcinaz: raises $8 to $10
Pumuking: folds 
Dbackhouse1: folds 
Uncalled bet ($8) returned to xcinaz
xcinaz collected $5 from pot
xcinaz: doesn't show hand 
*** SUMMARY ***
Total pot $5 | Rake $0 
Seat 1: Joe_Li7 (button) folded before Flop (didn't bet)
Seat 2: xcinaz (small blind) collected ($5)
Seat 3: Pumuking (big blind) folded before Flop
Seat 4: Iseedora folded before Flop (didn't bet)
Seat 5: Dbackhouse1 folded before Flop
Seat 6: reiyser folded before Flop (didn't bet)



PokerStars Hand #254516631151:  Hold'em No Limit ($0.50/$1.00 USD) - 2025/01/23 17:53:13 WET [2025/01/23 12:53:13 ET]
Table 'Helewalda IV' 6-max Seat #2 is the button
Seat 1: Joe_Li7 ($121.86 in chips) 
Seat 2: xcinaz ($107.95 in chips) 
Seat 3: Pumuking ($101.50 in chips) 
Seat 4: Iseedora ($198.25 in chips) 
Seat 5: Dbackhouse1 ($86.47 in chips) 
Seat 6: reiyser ($143.30 in chips) 
Pumuking: posts small blind $0.50
Iseedora: posts big blind $1
*** HOLE CARDS ***
Dbackhouse1: folds 
reiyser: raises $1.23 to $2.23
Joe_Li7: folds 
xcinaz: folds 
Pumuking: folds 
Iseedora: folds 
Uncalled bet ($1.23) returned to reiyser
reiyser collected $2.50 from pot
reiyser: doesn't show hand 
*** SUMMARY ***
Total pot $2.50 | Rake $0 
Seat 1: Joe_Li7 folded before Flop (didn't bet)
Seat 2: xcinaz (button) folded before Flop (didn't bet)
Seat 3: Pumuking (small blind) folded before Flop
Seat 4: Iseedora (big blind) folded before Flop
Seat 5: Dbackhouse1 folded before Flop (didn't bet)
Seat 6: reiyser collected ($2.50)



PokerStars Hand #254516634792:  Hold'em No Limit ($0.50/$1.00 USD) - 2025/01/23 17:53:30 WET [2025/01/23 12:53:30 ET]
Table 'Helewalda IV' 6-max Seat #3 is the button
Seat 1: Joe_Li7 ($121.86 in chips) 
Seat 2: xcinaz ($107.95 in chips) 
Seat 3: Pumuking ($101 in chips) 
Seat 4: Iseedora ($197.25 in chips) 
Seat 5: Dbackhouse1 ($86.47 in chips) 
Seat 6: reiyser ($144.80 in chips) 
Iseedora: posts small blind $0.50
Dbackhouse1: posts big blind $1
*** HOLE CARDS ***
reiyser: folds 
Joe_Li7: raises $1.20 to $2.20
xcinaz: folds 
Pumuking: raises $5.30 to $7.50
Iseedora: folds 
Dbackhouse1: folds 
Joe_Li7: folds 
Uncalled bet ($5.30) returned to Pumuking
Pumuking collected $5.90 from pot
Pumuking: doesn't show hand 
*** SUMMARY ***
Total pot $5.90 | Rake $0 
Seat 1: Joe_Li7 folded before Flop
Seat 2: xcinaz folded before Flop (didn't bet)
Seat 3: Pumuking (button) collected ($5.90)
Seat 4: Iseedora (small blind) folded before Flop
Seat 5: Dbackhouse1 (big blind) folded before Flop
Seat 6: reiyser folded before Flop (didn't bet)



PokerStars Hand #254516641326:  Hold'em No Limit ($0.50/$1.00 USD) - 2025/01/23 17:54:00 WET [2025/01/23 12:54:00 ET]
Table 'Helewalda IV' 6-max Seat #4 is the button
Seat 1: Joe_Li7 ($119.66 in chips) 
Seat 2: xcinaz ($107.95 in chips) 
Seat 3: Pumuking ($104.70 in chips) 
Seat 4: Iseedora ($196.75 in chips) 
Seat 5: Dbackhouse1 ($85.47 in chips) 
Seat 6: reiyser ($144.80 in chips) 
Dbackhouse1: posts small blind $0.50
reiyser: posts big blind $1
*** HOLE CARDS ***
Joe_Li7: folds 
xcinaz: folds 
Pumuking: raises $1.25 to $2.25
Iseedora: folds 
Dbackhouse1: calls $1.75
reiyser: folds 
*** FLOP *** [2h 3h 5h]
Dbackhouse1: checks 
Pumuking: checks 
*** TURN *** [2h 3h 5h] [Jd]
Dbackhouse1: bets $2.61
Pumuking: calls $2.61
*** RIVER *** [2h 3h 5h Jd] [Js]
Dbackhouse1: bets $10.18
Pumuking: folds 
Uncalled bet ($10.18) returned to Dbackhouse1
Dbackhouse1 collected $10.18 from pot
*** SUMMARY ***
Total pot $10.72 | Rake $0.54 
Board [2h 3h 5h Jd Js]
Seat 1: Joe_Li7 folded before Flop (didn't bet)
Seat 2: xcinaz folded before Flop (didn't bet)
Seat 3: Pumuking folded on the River
Seat 4: Iseedora (button) folded before Flop (didn't bet)
Seat 5: Dbackhouse1 (small blind) collected ($10.18)
Seat 6: reiyser (big blind) folded before Flop



PokerStars Hand #254516654881:  Hold'em No Limit ($0.50/$1.00 USD) - 2025/01/23 17:55:02 WET [2025/01/23 12:55:02 ET]
Table 'Helewalda IV' 6-max Seat #5 is the button
Seat 1: Joe_Li7 ($119.66 in chips) 
Seat 2: xcinaz ($107.95 in chips) 
Seat 3: Pumuking ($100 in chips) 
Seat 4: Iseedora ($196.75 in chips) 
Seat 5: Dbackhouse1 ($90.79 in chips) 
Seat 6: reiyser ($143.80 in chips) 
reiyser: posts small blind $0.50
Joe_Li7: posts big blind $1
*** HOLE CARDS ***
xcinaz: raises $1 to $2
Pumuking: folds 
Iseedora: folds 
Dbackhouse1: calls $2
reiyser: folds 
Joe_Li7: calls $1
*** FLOP *** [6h 8d As]
Joe_Li7: checks 
xcinaz: checks 
Dbackhouse1: checks 
*** TURN *** [6h 8d As] [9c]
Joe_Li7: bets $4.64
xcinaz: folds 
Dbackhouse1: folds 
Uncalled bet ($4.64) returned to Joe_Li7
Joe_Li7 collected $6.18 from pot
*** SUMMARY ***
Total pot $6.50 | Rake $0.32 
Board [6h 8d As 9c]
Seat 1: Joe_Li7 (big blind) collected ($6.18)
Seat 2: xcinaz folded on the Turn
Seat 3: Pumuking folded before Flop (didn't bet)
Seat 4: Iseedora folded before Flop (didn't bet)
Seat 5: Dbackhouse1 (button) folded on the Turn
Seat 6: reiyser (small blind) folded before Flop



PokerStars Hand #254516663174:  Hold'em No Limit ($0.50/$1.00 USD) - 2025/01/23 17:55:49 WET [2025/01/23 12:55:49 ET]
Table 'Helewalda IV' 6-max Seat #6 is the button
Seat 1: Joe_Li7 ($123.84 in chips) 
Seat 2: xcinaz ($105.95 in chips) 
Seat 3: Pumuking ($100 in chips) 
Seat 4: Iseedora ($196.75 in chips) 
Seat 5: Dbackhouse1 ($88.79 in chips) 
Seat 6: reiyser ($143.30 in chips) 
Joe_Li7: posts small blind $0.50
xcinaz: posts big blind $1
*** HOLE CARDS ***
Pumuking: raises $1.25 to $2.25
Iseedora: raises $5.25 to $7.50
Dbackhouse1: folds 
reiyser: raises $12.50 to $20
Joe_Li7: folds 
xcinaz: folds 
Pumuking: folds 
Iseedora: calls $12.50
*** FLOP *** [7c 2s Qc]
Iseedora: checks 
reiyser: bets $12.05
Iseedora: calls $12.05
*** TURN *** [7c 2s Qc] [5c]
Iseedora: bets $18.50
reiyser: calls $18.50
*** RIVER *** [7c 2s Qc 5c] [3s]
Iseedora: bets $146.20 and is all-in
reiyser: folds 
Uncalled bet ($146.20) returned to Iseedora
Iseedora collected $102.35 from pot
Iseedora: doesn't show hand 
*** SUMMARY ***
Total pot $104.85 | Rake $2.50 
Board [7c 2s Qc 5c 3s]
Seat 1: Joe_Li7 (small blind) folded before Flop
Seat 2: xcinaz (big blind) folded before Flop
Seat 3: Pumuking folded before Flop
Seat 4: Iseedora collected ($102.35)
Seat 5: Dbackhouse1 folded before Flop (didn't bet)
Seat 6: reiyser (button) folded on the River



PokerStars Hand #254516684933:  Hold'em No Limit ($0.50/$1.00 USD) - 2025/01/23 17:58:00 WET [2025/01/23 12:58:00 ET]
Table 'Helewalda IV' 6-max Seat #1 is the button
Seat 1: Joe_Li7 ($123.34 in chips) 
Seat 2: xcinaz ($104.95 in chips) 
Seat 3: Pumuking ($100 in chips) 
Seat 4: Iseedora ($248.55 in chips) 
Seat 5: Dbackhouse1 ($88.79 in chips) 
Seat 6: reiyser ($100 in chips) 
xcinaz: posts small blind $0.50
Pumuking: posts big blind $1
*** HOLE CARDS ***
Iseedora: folds 
Dbackhouse1: raises $1 to $2
reiyser: folds 
Joe_Li7: folds 
xcinaz: raises $8 to $10
Pumuking: folds 
Dbackhouse1: folds 
Uncalled bet ($8) returned to xcinaz
xcinaz collected $5 from pot
xcinaz: doesn't show hand 
*** SUMMARY ***
Total pot $5 | Rake $0 
Seat 1: Joe_Li7 (button) folded before Flop (didn't bet)
Seat 2: xcinaz (small blind) collected ($5)
Seat 3: Pumuking (big blind) folded before Flop
Seat 4: Iseedora folded before Flop (didn't bet)
Seat 5: Dbackhouse1 folded before Flop
Seat 6: reiyser folded before Flop (didn't bet)



PokerStars Hand #254516687420:  Hold'em No Limit ($0.50/$1.00 USD) - 2025/01/23 17:58:15 WET [2025/01/23 12:58:15 ET]
Table 'Helewalda IV' 6-max Seat #2 is the button
Seat 1: Joe_Li7 ($123.34 in chips) 
Seat 2: xcinaz ($107.95 in chips) 
Seat 3: Pumuking ($100 in chips) 
Seat 4: Iseedora ($248.55 in chips) 
Seat 5: Dbackhouse1 ($86.79 in chips) 
Seat 6: reiyser ($100 in chips) 
Pumuking: posts small blind $0.50
Iseedora: posts big blind $1
*** HOLE CARDS ***
Dbackhouse1: raises $1 to $2
reiyser: raises $5 to $7
Joe_Li7: folds 
xcinaz: folds 
Pumuking: folds 
Iseedora: folds 
Dbackhouse1: calls $5
*** FLOP *** [Jd Kc Qs]
Dbackhouse1: checks 
reiyser: bets $4.27
Dbackhouse1: calls $4.27
*** TURN *** [Jd Kc Qs] [9d]
Dbackhouse1: checks 
reiyser: checks 
*** RIVER *** [Jd Kc Qs 9d] [Js]
Dbackhouse1: bets $11.42
reiyser: raises $34.72 to $46.14
Dbackhouse1: folds 
Uncalled bet ($34.72) returned to reiyser
reiyser collected $44.54 from pot
reiyser: doesn't show hand 
*** SUMMARY ***
Total pot $46.88 | Rake $2.34 
Board [Jd Kc Qs 9d Js]
Seat 1: Joe_Li7 folded before Flop (didn't bet)
Seat 2: xcinaz (button) folded before Flop (didn't bet)
Seat 3: Pumuking (small blind) folded before Flop
Seat 4: Iseedora (big blind) folded before Flop
Seat 5: Dbackhouse1 folded on the River
Seat 6: reiyser collected ($44.54)



PokerStars Hand #254516699384:  Hold'em No Limit ($0.50/$1.00 USD) - 2025/01/23 17:59:28 WET [2025/01/23 12:59:28 ET]
Table 'Helewalda IV' 6-max Seat #3 is the button
Seat 1: Joe_Li7 ($123.34 in chips) 
Seat 2: xcinaz ($107.95 in chips) 
Seat 3: Pumuking ($100 in chips) 
Seat 4: Iseedora ($247.55 in chips) 
Seat 5: Dbackhouse1 ($64.10 in chips) 
Seat 6: reiyser ($121.85 in chips) 
Iseedora: posts small blind $0.50
Dbackhouse1: posts big blind $1
*** HOLE CARDS ***
reiyser: raises $1.23 to $2.23
Joe_Li7: folds 
xcinaz: folds 
Pumuking: calls $2.23
Iseedora: folds 
Dbackhouse1: calls $1.23
*** FLOP *** [8c Qh Ac]
Dbackhouse1: checks 
reiyser: checks 
Pumuking: checks 
*** TURN *** [8c Qh Ac] [9c]
Dbackhouse1: bets $3.42
reiyser: calls $3.42
Pumuking: folds 
*** RIVER *** [8c Qh Ac 9c] [7d]
Dbackhouse1: checks 
reiyser: bets $10.13
Dbackhouse1: calls $10.13
*** SHOW DOWN ***
reiyser: shows [Jh Th] (a straight, Eight to Queen)
Dbackhouse1: mucks hand 
reiyser collected $32.58 from pot
*** SUMMARY ***
Total pot $34.29 | Rake $1.71 
Board [8c Qh Ac 9c 7d]
Seat 1: Joe_Li7 folded before Flop (didn't bet)
Seat 2: xcinaz folded before Flop (didn't bet)
Seat 3: Pumuking (button) folded on the Turn
Seat 4: Iseedora (small blind) folded before Flop
Seat 5: Dbackhouse1 (big blind) mucked
Seat 6: reiyser showed [Jh Th] and won ($32.58) with a straight, Eight to Queen



PokerStars Hand #254516710174:  Hold'em No Limit ($0.50/$1.00 USD) - 2025/01/23 18:00:31 WET [2025/01/23 13:00:31 ET]
Table 'Helewalda IV' 6-max Seat #4 is the button
Seat 1: Joe_Li7 ($123.34 in chips) 
Seat 2: xcinaz ($107.95 in chips) 
Seat 3: Pumuking ($100 in chips) 
Seat 4: Iseedora ($247.05 in chips) 
Seat 5: Dbackhouse1 ($48.32 in chips) 
Seat 6: reiyser ($138.65 in chips) 
Dbackhouse1: posts small blind $0.50
reiyser: posts big blind $1
*** HOLE CARDS ***
Joe_Li7: folds 
xcinaz: raises $1 to $2
Pumuking: folds 
Iseedora: folds 
Dbackhouse1: folds 
reiyser: calls $1
*** FLOP *** [Kd 4c Qc]
reiyser: checks 
xcinaz: bets $1.41
reiyser: calls $1.41
*** TURN *** [Kd 4c Qc] [9c]
reiyser: checks 
xcinaz: checks 
*** RIVER *** [Kd 4c Qc 9c] [3h]
reiyser: bets $9.17
xcinaz: folds 
Uncalled bet ($9.17) returned to reiyser
reiyser collected $6.95 from pot
reiyser: doesn't show hand 
*** SUMMARY ***
Total pot $7.32 | Rake $0.37 
Board [Kd 4c Qc 9c 3h]
Seat 1: Joe_Li7 folded before Flop (didn't bet)
Seat 2: xcinaz folded on the River
Seat 3: Pumuking folded before Flop (didn't bet)
Seat 4: Iseedora (button) folded before Flop (didn't bet)
Seat 5: Dbackhouse1 (small blind) folded before Flop
Seat 6: reiyser (big blind) collected ($6.95)



PokerStars Hand #254516721085:  Hold'em No Limit ($0.50/$1.00 USD) - 2025/01/23 18:01:29 WET [2025/01/23 13:01:29 ET]
Table 'Helewalda IV' 6-max Seat #5 is the button
Seat 1: Joe_Li7 ($123.34 in chips) 
Seat 2: xcinaz ($104.54 in chips) 
Seat 3: Pumuking ($100 in chips) 
Seat 4: Iseedora ($247.05 in chips) 
Seat 5: Dbackhouse1 ($47.82 in chips) 
Seat 6: reiyser ($142.19 in chips) 
reiyser: posts small blind $0.50
Joe_Li7: posts big blind $1
*** HOLE CARDS ***
xcinaz: raises $1 to $2
Pumuking: folds 
Iseedora: folds 
Dbackhouse1: folds 
reiyser: folds 
Joe_Li7: folds 
Uncalled bet ($1) returned to xcinaz
xcinaz collected $2.50 from pot
xcinaz: doesn't show hand 
*** SUMMARY ***
Total pot $2.50 | Rake $0 
Seat 1: Joe_Li7 (big blind) folded before Flop
Seat 2: xcinaz collected ($2.50)
Seat 3: Pumuking folded before Flop (didn't bet)
Seat 4: Iseedora folded before Flop (didn't bet)
Seat 5: Dbackhouse1 (button) folded before Flop (didn't bet)
Seat 6: reiyser (small blind) folded before Flop



PokerStars Hand #254516725498:  Hold'em No Limit ($0.50/$1.00 USD) - 2025/01/23 18:01:51 WET [2025/01/23 13:01:51 ET]
Table 'Helewalda IV' 6-max Seat #6 is the button
Seat 1: Joe_Li7 ($122.34 in chips) 
Seat 2: xcinaz ($106.04 in chips) 
Seat 3: Pumuking ($100 in chips) 
Seat 4: Iseedora ($247.05 in chips) 
Seat 5: Dbackhouse1 ($47.82 in chips) 
Seat 6: reiyser ($141.69 in chips) 
Joe_Li7: posts small blind $0.50
xcinaz: posts big blind $1
*** HOLE CARDS ***
Pumuking: folds 
Iseedora: folds 
Dbackhouse1: raises $1.50 to $2.50
reiyser: folds 
Joe_Li7: folds 
xcinaz: folds 
Uncalled bet ($1.50) returned to Dbackhouse1
Dbackhouse1 collected $2.50 from pot
*** SUMMARY ***
Total pot $2.50 | Rake $0 
Seat 1: Joe_Li7 (small blind) folded before Flop
Seat 2: xcinaz (big blind) folded before Flop
Seat 3: Pumuking folded before Flop (didn't bet)
Seat 4: Iseedora folded before Flop (didn't bet)
Seat 5: Dbackhouse1 collected ($2.50)
Seat 6: reiyser (button) folded before Flop (didn't bet)



PokerStars Hand #254516728546:  Hold'em No Limit ($0.50/$1.00 USD) - 2025/01/23 18:02:06 WET [2025/01/23 13:02:06 ET]
Table 'Helewalda IV' 6-max Seat #1 is the button
Seat 1: Joe_Li7 ($121.84 in chips) 
Seat 2: xcinaz ($105.04 in chips) 
Seat 3: Pumuking ($100 in chips) 
Seat 4: Iseedora ($247.05 in chips) 
Seat 5: Dbackhouse1 ($49.32 in chips) 
Seat 6: reiyser ($141.69 in chips) 
xcinaz: posts small blind $0.50
Pumuking: posts big blind $1
*** HOLE CARDS ***
Iseedora: raises $1 to $2
Dbackhouse1: folds 
reiyser: folds 
Joe_Li7: folds 
xcinaz: folds 
Pumuking: folds 
Uncalled bet ($1) returned to Iseedora
Iseedora collected $2.50 from pot
Iseedora: doesn't show hand 
*** SUMMARY ***
Total pot $2.50 | Rake $0 
Seat 1: Joe_Li7 (button) folded before Flop (didn't bet)
Seat 2: xcinaz (small blind) folded before Flop
Seat 3: Pumuking (big blind) folded before Flop
Seat 4: Iseedora collected ($2.50)
Seat 5: Dbackhouse1 folded before Flop (didn't bet)
Seat 6: reiyser folded before Flop (didn't bet)



PokerStars Hand #254516732859:  Hold'em No Limit ($0.50/$1.00 USD) - 2025/01/23 18:02:26 WET [2025/01/23 13:02:26 ET]
Table 'Helewalda IV' 6-max Seat #2 is the button
Seat 4: Iseedora ($248.55 in chips) is sitting out
Seat 1: Joe_Li7 ($121.84 in chips) 
Seat 2: xcinaz ($104.54 in chips) 
Seat 3: Pumuking ($100 in chips) 
Seat 5: Dbackhouse1 ($49.32 in chips) 
Seat 6: reiyser ($141.69 in chips) 
Pumuking: posts small blind $0.50
Iseedora: is sitting out 
Dbackhouse1: posts big blind $1
*** HOLE CARDS ***
reiyser: folds 
Joe_Li7: folds 
xcinaz: raises $1.50 to $2.50
Pumuking: calls $2
Dbackhouse1: raises $8.50 to $11
xcinaz: folds 
Iseedora leaves the table
Pumuking: folds 
Uncalled bet ($8.50) returned to Dbackhouse1
Dbackhouse1 collected $7.50 from pot
BGS013 joins the table at seat #4 
*** SUMMARY ***
Total pot $7.50 | Rake $0 
Seat 4: Iseedora
Seat 1: Joe_Li7 folded before Flop (didn't bet)
Seat 2: xcinaz (button) folded before Flop
Seat 3: Pumuking (small blind) folded before Flop
Seat 5: Dbackhouse1 (big blind) collected ($7.50)
Seat 6: reiyser folded before Flop (didn't bet)



PokerStars Hand #254516742762:  Hold'em No Limit ($0.50/$1.00 USD) - 2025/01/23 18:03:11 WET [2025/01/23 13:03:11 ET]
Table 'Helewalda IV' 6-max Seat #3 is the button
Seat 4: BGS013 ($100 in chips) is sitting out
Seat 1: Joe_Li7 ($121.84 in chips) 
Seat 2: xcinaz ($102.04 in chips) 
Seat 3: Pumuking ($100 in chips) 
Seat 5: Dbackhouse1 ($54.32 in chips) 
Seat 6: reiyser ($141.69 in chips) 
Dbackhouse1: posts small blind $0.50
reiyser: posts big blind $1
*** HOLE CARDS ***
Joe_Li7: folds 
xcinaz: folds 
Pumuking: raises $1.50 to $2.50
Dbackhouse1: folds 
reiyser: folds 
Uncalled bet ($1.50) returned to Pumuking
Pumuking collected $2.50 from pot
Pumuking: doesn't show hand 
*** SUMMARY ***
Total pot $2.50 | Rake $0 
Seat 4: BGS013
Seat 1: Joe_Li7 folded before Flop (didn't bet)
Seat 2: xcinaz folded before Flop (didn't bet)
Seat 3: Pumuking (button) collected ($2.50)
Seat 5: Dbackhouse1 (small blind) folded before Flop
Seat 6: reiyser (big blind) folded before Flop



PokerStars Hand #254516745708:  Hold'em No Limit ($0.50/$1.00 USD) - 2025/01/23 18:03:24 WET [2025/01/23 13:03:24 ET]
Table 'Helewalda IV' 6-max Seat #5 is the button
Seat 4: BGS013 ($100 in chips) is sitting out
Seat 1: Joe_Li7 ($121.84 in chips) 
Seat 2: xcinaz ($102.04 in chips) 
Seat 3: Pumuking ($101.50 in chips) 
Seat 5: Dbackhouse1 ($53.82 in chips) 
Seat 6: reiyser ($140.69 in chips) 
reiyser: posts small blind $0.50
Joe_Li7: posts big blind $1
BGS013: sits out 
*** HOLE CARDS ***
xcinaz: folds 
Pumuking: folds 
Dbackhouse1: raises $1.50 to $2.50
reiyser: folds 
Joe_Li7: calls $1.50
*** FLOP *** [3h Ts 3d]
Joe_Li7: checks 
Dbackhouse1: bets $2.61
Joe_Li7: calls $2.61
*** TURN *** [3h Ts 3d] [9s]
Joe_Li7: checks 
Dbackhouse1: checks 
*** RIVER *** [3h Ts 3d 9s] [2c]
Joe_Li7: checks 
Dbackhouse1: checks 
*** SHOW DOWN ***
Joe_Li7: shows [8h As] (a pair of Threes)
Dbackhouse1: mucks hand 
Joe_Li7 collected $10.18 from pot
*** SUMMARY ***
Total pot $10.72 | Rake $0.54 
Board [3h Ts 3d 9s 2c]
Seat 4: BGS013
Seat 1: Joe_Li7 (big blind) showed [8h As] and won ($10.18) with a pair of Threes
Seat 2: xcinaz folded before Flop (didn't bet)
Seat 3: Pumuking folded before Flop (didn't bet)
Seat 5: Dbackhouse1 (button) mucked
Seat 6: reiyser (small blind) folded before Flop



PokerStars Hand #254516757712:  Hold'em No Limit ($0.50/$1.00 USD) - 2025/01/23 18:04:19 WET [2025/01/23 13:04:19 ET]
Table 'Helewalda IV' 6-max Seat #6 is the button
Seat 4: BGS013 ($100 in chips) is sitting out
Seat 1: Joe_Li7 ($126.91 in chips) 
Seat 2: xcinaz ($102.04 in chips) 
Seat 3: Pumuking ($101.50 in chips) 
Seat 5: Dbackhouse1 ($48.71 in chips) 
Seat 6: reiyser ($140.19 in chips) 
Joe_Li7: posts small blind $0.50
xcinaz: posts big blind $1
BGS013: sits out 
*** HOLE CARDS ***
Pumuking: folds 
Dbackhouse1: folds 
reiyser: raises $1.23 to $2.23
Joe_Li7: folds 
xcinaz: folds 
Uncalled bet ($1.23) returned to reiyser
reiyser collected $2.50 from pot
reiyser: doesn't show hand 
*** SUMMARY ***
Total pot $2.50 | Rake $0 
Seat 4: BGS013
Seat 1: Joe_Li7 (small blind) folded before Flop
Seat 2: xcinaz (big blind) folded before Flop
Seat 3: Pumuking folded before Flop (didn't bet)
Seat 5: Dbackhouse1 folded before Flop (didn't bet)
Seat 6: reiyser (button) collected ($2.50)



PokerStars Hand #254516761430:  Hold'em No Limit ($0.50/$1.00 USD) - 2025/01/23 18:04:36 WET [2025/01/23 13:04:36 ET]
Table 'Helewalda IV' 6-max Seat #1 is the button
Seat 4: BGS013 ($100 in chips) is sitting out
Seat 1: Joe_Li7 ($126.41 in chips) 
Seat 2: xcinaz ($101.04 in chips) 
Seat 3: Pumuking ($101.50 in chips) 
Seat 5: Dbackhouse1 ($48.71 in chips) 
Seat 6: reiyser ($141.69 in chips) 
xcinaz: posts small blind $0.50
Pumuking: posts big blind $1
BGS013: sits out 
*** HOLE CARDS ***
Dbackhouse1: folds 
reiyser: folds 
Joe_Li7: raises $1.50 to $2.50
xcinaz: folds 
Pumuking: folds 
Uncalled bet ($1.50) returned to Joe_Li7
Joe_Li7 collected $2.50 from pot
*** SUMMARY ***
Total pot $2.50 | Rake $0 
Seat 4: BGS013
Seat 1: Joe_Li7 (button) collected ($2.50)
Seat 2: xcinaz (small blind) folded before Flop
Seat 3: Pumuking (big blind) folded before Flop
Seat 5: Dbackhouse1 folded before Flop (didn't bet)
Seat 6: reiyser folded before Flop (didn't bet)



PokerStars Hand #254516765903:  Hold'em No Limit ($0.50/$1.00 USD) - 2025/01/23 18:04:56 WET [2025/01/23 13:04:56 ET]
Table 'Helewalda IV' 6-max Seat #2 is the button
Seat 1: Joe_Li7 ($127.91 in chips) 
Seat 2: xcinaz ($100.54 in chips) 
Seat 3: Pumuking ($100.50 in chips) 
Seat 4: BGS013 ($100 in chips) 
Seat 5: Dbackhouse1 ($48.71 in chips) 
Seat 6: reiyser ($141.69 in chips) 
Pumuking: posts small blind $0.50
BGS013: posts big blind $1
*** HOLE CARDS ***
Dbackhouse1: raises $1 to $2
reiyser: folds 
Joe_Li7: folds 
xcinaz: folds 
Pumuking: folds 
BGS013: calls $1
*** FLOP *** [Kh 7d 8s]
BGS013: checks 
Dbackhouse1: bets $2.14
BGS013: calls $2.14
*** TURN *** [Kh 7d 8s] [4c]
BGS013: checks 
Dbackhouse1: checks 
*** RIVER *** [Kh 7d 8s 4c] [Ah]
BGS013: checks 
Dbackhouse1: bets $5.17
BGS013: folds 
Uncalled bet ($5.17) returned to Dbackhouse1
Dbackhouse1 collected $8.34 from pot
*** SUMMARY ***
Total pot $8.78 | Rake $0.44 
Board [Kh 7d 8s 4c Ah]
Seat 1: Joe_Li7 folded before Flop (didn't bet)
Seat 2: xcinaz (button) folded before Flop (didn't bet)
Seat 3: Pumuking (small blind) folded before Flop
Seat 4: BGS013 (big blind) folded on the River
Seat 5: Dbackhouse1 collected ($8.34)
Seat 6: reiyser folded before Flop (didn't bet)



PokerStars Hand #254516778207:  Hold'em No Limit ($0.50/$1.00 USD) - 2025/01/23 18:05:50 WET [2025/01/23 13:05:50 ET]
Table 'Helewalda IV' 6-max Seat #3 is the button
Seat 1: Joe_Li7 ($127.91 in chips) 
Seat 2: xcinaz ($100.54 in chips) 
Seat 3: Pumuking ($100 in chips) 
Seat 4: BGS013 ($100 in chips) 
Seat 5: Dbackhouse1 ($52.91 in chips) 
Seat 6: reiyser ($141.69 in chips) 
BGS013: posts small blind $0.50
Dbackhouse1: posts big blind $1
*** HOLE CARDS ***
reiyser: folds 
Joe_Li7: folds 
xcinaz: folds 
Pumuking: raises $1.50 to $2.50
BGS013: folds 
Dbackhouse1: folds 
Uncalled bet ($1.50) returned to Pumuking
Pumuking collected $2.50 from pot
Pumuking: doesn't show hand 
*** SUMMARY ***
Total pot $2.50 | Rake $0 
Seat 1: Joe_Li7 folded before Flop (didn't bet)
Seat 2: xcinaz folded before Flop (didn't bet)
Seat 3: Pumuking (button) collected ($2.50)
Seat 4: BGS013 (small blind) folded before Flop
Seat 5: Dbackhouse1 (big blind) folded before Flop
Seat 6: reiyser folded before Flop (didn't bet)



PokerStars Hand #254516781779:  Hold'em No Limit ($0.50/$1.00 USD) - 2025/01/23 18:06:06 WET [2025/01/23 13:06:06 ET]
Table 'Helewalda IV' 6-max Seat #4 is the button
Seat 1: Joe_Li7 ($127.91 in chips) 
Seat 2: xcinaz ($100.54 in chips) 
Seat 3: Pumuking ($101.50 in chips) 
Seat 4: BGS013 ($100 in chips) 
Seat 5: Dbackhouse1 ($51.91 in chips) 
Seat 6: reiyser ($141.69 in chips) 
Dbackhouse1: posts small blind $0.50
reiyser: posts big blind $1
*** HOLE CARDS ***
Joe_Li7: folds 
xcinaz: folds 
Pumuking: folds 
BGS013: folds 
Dbackhouse1: folds 
Uncalled bet ($0.50) returned to reiyser
reiyser collected $1 from pot
reiyser: doesn't show hand 
*** SUMMARY ***
Total pot $1 | Rake $0 
Seat 1: Joe_Li7 folded before Flop (didn't bet)
Seat 2: xcinaz folded before Flop (didn't bet)
Seat 3: Pumuking folded before Flop (didn't bet)
Seat 4: BGS013 (button) folded before Flop (didn't bet)
Seat 5: Dbackhouse1 (small blind) folded before Flop
Seat 6: reiyser (big blind) collected ($1)



PokerStars Hand #254516784654:  Hold'em No Limit ($0.50/$1.00 USD) - 2025/01/23 18:06:19 WET [2025/01/23 13:06:19 ET]
Table 'Helewalda IV' 6-max Seat #5 is the button
Seat 1: Joe_Li7 ($127.91 in chips) 
Seat 2: xcinaz ($100.54 in chips) 
Seat 3: Pumuking ($101.50 in chips) 
Seat 4: BGS013 ($100 in chips) 
Seat 5: Dbackhouse1 ($51.41 in chips) 
Seat 6: reiyser ($142.19 in chips) 
reiyser: posts small blind $0.50
Joe_Li7: posts big blind $1
*** HOLE CARDS ***
xcinaz: folds 
Pumuking: raises $1.25 to $2.25
BGS013: folds 
Dbackhouse1: folds 
reiyser: folds 
Joe_Li7: folds 
Uncalled bet ($1.25) returned to Pumuking
Pumuking collected $2.50 from pot
Pumuking: doesn't show hand 
*** SUMMARY ***
Total pot $2.50 | Rake $0 
Seat 1: Joe_Li7 (big blind) folded before Flop
Seat 2: xcinaz folded before Flop (didn't bet)
Seat 3: Pumuking collected ($2.50)
Seat 4: BGS013 folded before Flop (didn't bet)
Seat 5: Dbackhouse1 (button) folded before Flop (didn't bet)
Seat 6: reiyser (small blind) folded before Flop



PokerStars Hand #254516787512:  Hold'em No Limit ($0.50/$1.00 USD) - 2025/01/23 18:06:32 WET [2025/01/23 13:06:32 ET]
Table 'Helewalda IV' 6-max Seat #6 is the button
Seat 1: Joe_Li7 ($126.91 in chips) 
Seat 2: xcinaz ($100.54 in chips) 
Seat 3: Pumuking ($103 in chips) 
Seat 4: BGS013 ($100 in chips) 
Seat 5: Dbackhouse1 ($51.41 in chips) 
Seat 6: reiyser ($141.69 in chips) 
Joe_Li7: posts small blind $0.50
xcinaz: posts big blind $1
*** HOLE CARDS ***
Pumuking: folds 
BGS013: folds 
Dbackhouse1: raises $1 to $2
reiyser: folds 
Joe_Li7: raises $7 to $9
xcinaz: folds 
Dbackhouse1: calls $7
*** FLOP *** [4s Kh 6s]
Joe_Li7: bets $4.53
Dbackhouse1: calls $4.53
*** TURN *** [4s Kh 6s] [3d]
Joe_Li7: bets $8.81
Dbackhouse1: folds 
Uncalled bet ($8.81) returned to Joe_Li7
Joe_Li7 collected $26.66 from pot
*** SUMMARY ***
Total pot $28.06 | Rake $1.40 
Board [4s Kh 6s 3d]
Seat 1: Joe_Li7 (small blind) collected ($26.66)
Seat 2: xcinaz (big blind) folded before Flop
Seat 3: Pumuking folded before Flop (didn't bet)
Seat 4: BGS013 folded before Flop (didn't bet)
Seat 5: Dbackhouse1 folded on the Turn
Seat 6: reiyser (button) folded before Flop (didn't bet)



PokerStars Hand #254516801902:  Hold'em No Limit ($0.50/$1.00 USD) - 2025/01/23 18:07:37 WET [2025/01/23 13:07:37 ET]
Table 'Helewalda IV' 6-max Seat #1 is the button
Seat 1: Joe_Li7 ($140.04 in chips) 
Seat 2: xcinaz ($100 in chips) 
Seat 3: Pumuking ($103 in chips) 
Seat 4: BGS013 ($100 in chips) 
Seat 5: Dbackhouse1 ($37.88 in chips) 
Seat 6: reiyser ($141.69 in chips) 
xcinaz: posts small blind $0.50
Pumuking: posts big blind $1
*** HOLE CARDS ***
BGS013: folds 
Dbackhouse1: folds 
reiyser: folds 
Joe_Li7: folds 
xcinaz: folds 
Uncalled bet ($0.50) returned to Pumuking
Pumuking collected $1 from pot
Pumuking: doesn't show hand 
*** SUMMARY ***
Total pot $1 | Rake $0 
Seat 1: Joe_Li7 (button) folded before Flop (didn't bet)
Seat 2: xcinaz (small blind) folded before Flop
Seat 3: Pumuking (big blind) collected ($1)
Seat 4: BGS013 folded before Flop (didn't bet)
Seat 5: Dbackhouse1 folded before Flop (didn't bet)
Seat 6: reiyser folded before Flop (didn't bet)



PokerStars Hand #254516804842:  Hold'em No Limit ($0.50/$1.00 USD) - 2025/01/23 18:07:51 WET [2025/01/23 13:07:51 ET]
Table 'Helewalda IV' 6-max Seat #2 is the button
Seat 1: Joe_Li7 ($140.04 in chips) 
Seat 2: xcinaz ($100 in chips) 
Seat 3: Pumuking ($103.50 in chips) 
Seat 4: BGS013 ($100 in chips) 
Seat 5: Dbackhouse1 ($37.88 in chips) 
Seat 6: reiyser ($141.69 in chips) 
Pumuking: posts small blind $0.50
BGS013: posts big blind $1
*** HOLE CARDS ***
Dbackhouse1: folds 
reiyser: raises $1.23 to $2.23
Joe_Li7: raises $5.27 to $7.50
xcinaz: folds 
Pumuking: folds 
BGS013: folds 
reiyser: calls $5.27
*** FLOP *** [Kc Td 6c]
reiyser: checks 
Joe_Li7: bets $5.18
reiyser: folds 
Uncalled bet ($5.18) returned to Joe_Li7
Joe_Li7 collected $15.68 from pot
*** SUMMARY ***
Total pot $16.50 | Rake $0.82 
Board [Kc Td 6c]
Seat 1: Joe_Li7 collected ($15.68)
Seat 2: xcinaz (button) folded before Flop (didn't bet)
Seat 3: Pumuking (small blind) folded before Flop
Seat 4: BGS013 (big blind) folded before Flop
Seat 5: Dbackhouse1 folded before Flop (didn't bet)
Seat 6: reiyser folded on the Flop



PokerStars Hand #254516815323:  Hold'em No Limit ($0.50/$1.00 USD) - 2025/01/23 18:08:38 WET [2025/01/23 13:08:38 ET]
Table 'Helewalda IV' 6-max Seat #3 is the button
Seat 1: Joe_Li7 ($148.22 in chips) 
Seat 2: xcinaz ($100 in chips) 
Seat 3: Pumuking ($103 in chips) 
Seat 4: BGS013 ($100 in chips) 
Seat 5: Dbackhouse1 ($37.88 in chips) 
Seat 6: reiyser ($134.19 in chips) 
BGS013: posts small blind $0.50
Dbackhouse1: posts big blind $1
*** HOLE CARDS ***
reiyser: folds 
Joe_Li7: folds 
xcinaz: raises $1.20 to $2.20
Pumuking: folds 
BGS013: folds 
Dbackhouse1: calls $1.20
*** FLOP *** [Qc 2s 3c]
Dbackhouse1: checks 
xcinaz: bets $1.17
Dbackhouse1: raises $3.50 to $4.67
xcinaz: raises $7 to $11.67
Dbackhouse1: folds 
Uncalled bet ($7) returned to xcinaz
xcinaz collected $13.53 from pot
xcinaz: doesn't show hand 
*** SUMMARY ***
Total pot $14.24 | Rake $0.71 
Board [Qc 2s 3c]
Seat 1: Joe_Li7 folded before Flop (didn't bet)
Seat 2: xcinaz collected ($13.53)
Seat 3: Pumuking (button) folded before Flop (didn't bet)
Seat 4: BGS013 (small blind) folded before Flop
Seat 5: Dbackhouse1 (big blind) folded on the Flop
Seat 6: reiyser folded before Flop (didn't bet)



PokerStars Hand #254516826086:  Hold'em No Limit ($0.50/$1.00 USD) - 2025/01/23 18:09:27 WET [2025/01/23 13:09:27 ET]
Table 'Helewalda IV' 6-max Seat #4 is the button
Seat 1: Joe_Li7 ($148.22 in chips) 
Seat 2: xcinaz ($106.66 in chips) 
Seat 3: Pumuking ($103 in chips) 
Seat 4: BGS013 ($100 in chips) 
Seat 5: Dbackhouse1 ($31.01 in chips) 
Seat 6: reiyser ($134.19 in chips) 
Dbackhouse1: posts small blind $0.50
reiyser: posts big blind $1
*** HOLE CARDS ***
Joe_Li7: raises $1.20 to $2.20
xcinaz: folds 
Pumuking: folds 
BGS013: folds 
Dbackhouse1: calls $1.70
reiyser: folds 
*** FLOP *** [Qh Qd 9d]
Dbackhouse1: checks 
Joe_Li7: checks 
*** TURN *** [Qh Qd 9d] [3c]
Dbackhouse1: checks 
Joe_Li7: checks 
*** RIVER *** [Qh Qd 9d 3c] [9h]
Dbackhouse1: checks 
Joe_Li7: checks 
*** SHOW DOWN ***
Dbackhouse1: shows [Js 8s] (two pair, Queens and Nines)
Joe_Li7: shows [Ah 7h] (two pair, Queens and Nines - Ace kicker)
Joe_Li7 collected $5.13 from pot
*** SUMMARY ***
Total pot $5.40 | Rake $0.27 
Board [Qh Qd 9d 3c 9h]
Seat 1: Joe_Li7 showed [Ah 7h] and won ($5.13) with two pair, Queens and Nines
Seat 2: xcinaz folded before Flop (didn't bet)
Seat 3: Pumuking folded before Flop (didn't bet)
Seat 4: BGS013 (button) folded before Flop (didn't bet)
Seat 5: Dbackhouse1 (small blind) showed [Js 8s] and lost with two pair, Queens and Nines
Seat 6: reiyser (big blind) folded before Flop



PokerStars Hand #254516834686:  Hold'em No Limit ($0.50/$1.00 USD) - 2025/01/23 18:10:05 WET [2025/01/23 13:10:05 ET]
Table 'Helewalda IV' 6-max Seat #5 is the button
Seat 1: Joe_Li7 ($151.15 in chips) 
Seat 2: xcinaz ($106.66 in chips) 
Seat 3: Pumuking ($103 in chips) 
Seat 4: BGS013 ($100 in chips) 
Seat 5: Dbackhouse1 ($28.81 in chips) 
Seat 6: reiyser ($133.19 in chips) 
reiyser: posts small blind $0.50
Joe_Li7: posts big blind $1
*** HOLE CARDS ***
xcinaz: raises $1 to $2
Pumuking: folds 
BGS013: folds 
Dbackhouse1: raises $26.81 to $28.81 and is all-in
reiyser: folds 
Joe_Li7: folds 
xcinaz: folds 
Uncalled bet ($26.81) returned to Dbackhouse1
Dbackhouse1 collected $5.50 from pot
*** SUMMARY ***
Total pot $5.50 | Rake $0 
Seat 1: Joe_Li7 (big blind) folded before Flop
Seat 2: xcinaz folded before Flop
Seat 3: Pumuking folded before Flop (didn't bet)
Seat 4: BGS013 folded before Flop (didn't bet)
Seat 5: Dbackhouse1 (button) collected ($5.50)
Seat 6: reiyser (small blind) folded before Flop



PokerStars Hand #254516838241:  Hold'em No Limit ($0.50/$1.00 USD) - 2025/01/23 18:10:21 WET [2025/01/23 13:10:21 ET]
Table 'Helewalda IV' 6-max Seat #6 is the button
Seat 1: Joe_Li7 ($150.15 in chips) 
Seat 2: xcinaz ($104.66 in chips) 
Seat 3: Pumuking ($103 in chips) 
Seat 4: BGS013 ($100 in chips) 
Seat 5: Dbackhouse1 ($32.31 in chips) 
Seat 6: reiyser ($132.69 in chips) 
Joe_Li7: posts small blind $0.50
xcinaz: posts big blind $1
*** HOLE CARDS ***
Pumuking: folds 
BGS013: raises $1 to $2
Dbackhouse1: raises $30.31 to $32.31 and is all-in
reiyser: folds 
Joe_Li7: raises $117.84 to $150.15 and is all-in
xcinaz: folds 
BGS013: folds 
Uncalled bet ($117.84) returned to Joe_Li7
*** FLOP *** [8d 6h Td]
*** TURN *** [8d 6h Td] [6s]
*** RIVER *** [8d 6h Td 6s] [Kd]
*** SHOW DOWN ***
Joe_Li7: shows [Ac Ad] (two pair, Aces and Sixes)
Dbackhouse1: shows [Ah Qc] (a pair of Sixes)
Joe_Li7 collected $65.12 from pot
*** SUMMARY ***
Total pot $67.62 | Rake $2.50 
Board [8d 6h Td 6s Kd]
Seat 1: Joe_Li7 (small blind) showed [Ac Ad] and won ($65.12) with two pair, Aces and Sixes
Seat 2: xcinaz (big blind) folded before Flop
Seat 3: Pumuking folded before Flop (didn't bet)
Seat 4: BGS013 folded before Flop
Seat 5: Dbackhouse1 showed [Ah Qc] and lost with a pair of Sixes
Seat 6: reiyser (button) folded before Flop (didn't bet)



PokerStars Hand #254516848279:  Hold'em No Limit ($0.50/$1.00 USD) - 2025/01/23 18:11:05 WET [2025/01/23 13:11:05 ET]
Table 'Helewalda IV' 6-max Seat #1 is the button
Seat 5: Dbackhouse1 ($0 in chips) is sitting out
Seat 1: Joe_Li7 ($182.96 in chips) 
Seat 2: xcinaz ($103.66 in chips) 
Seat 3: Pumuking ($103 in chips) 
Seat 4: BGS013 ($100 in chips) 
Seat 6: reiyser ($132.69 in chips) 
xcinaz: posts small blind $0.50
Pumuking: posts big blind $1
*** HOLE CARDS ***
BGS013: folds 
reiyser: raises $1.23 to $2.23
Joe_Li7: folds 
xcinaz: folds 
Pumuking: folds 
Uncalled bet ($1.23) returned to reiyser
reiyser collected $2.50 from pot
reiyser: doesn't show hand 
*** SUMMARY ***
Total pot $2.50 | Rake $0 
Seat 5: Dbackhouse1
Seat 1: Joe_Li7 (button) folded before Flop (didn't bet)
Seat 2: xcinaz (small blind) folded before Flop
Seat 3: Pumuking (big blind) folded before Flop
Seat 4: BGS013 folded before Flop (didn't bet)
Seat 6: reiyser collected ($2.50)



PokerStars Hand #254516850812:  Hold'em No Limit ($0.50/$1.00 USD) - 2025/01/23 18:11:16 WET [2025/01/23 13:11:16 ET]
Table 'Helewalda IV' 6-max Seat #2 is the button
Seat 5: Dbackhouse1 ($0 in chips) is sitting out
Seat 1: Joe_Li7 ($182.96 in chips) 
Seat 2: xcinaz ($103.16 in chips) 
Seat 3: Pumuking ($102 in chips) 
Seat 4: BGS013 ($100 in chips) 
Seat 6: reiyser ($134.19 in chips) 
Pumuking: posts small blind $0.50
BGS013: posts big blind $1
*** HOLE CARDS ***
reiyser: folds 
Joe_Li7: folds 
xcinaz: raises $1.50 to $2.50
Pumuking: raises $8.50 to $11
BGS013: folds 
xcinaz: raises $13 to $24
Pumuking: folds 
Uncalled bet ($13) returned to xcinaz
xcinaz collected $23 from pot
xcinaz: doesn't show hand 
*** SUMMARY ***
Total pot $23 | Rake $0 
Seat 5: Dbackhouse1
Seat 1: Joe_Li7 folded before Flop (didn't bet)
Seat 2: xcinaz (button) collected ($23)
Seat 3: Pumuking (small blind) folded before Flop
Seat 4: BGS013 (big blind) folded before Flop
Seat 6: reiyser folded before Flop (didn't bet)



PokerStars Hand #254516858196:  Hold'em No Limit ($0.50/$1.00 USD) - 2025/01/23 18:11:48 WET [2025/01/23 13:11:48 ET]
Table 'Helewalda IV' 6-max Seat #3 is the button
Seat 5: Dbackhouse1 ($0 in chips) is sitting out
Seat 1: Joe_Li7 ($182.96 in chips) 
Seat 2: xcinaz ($115.16 in chips) 
Seat 3: Pumuking ($100 in chips) 
Seat 4: BGS013 ($100 in chips) 
Seat 6: reiyser ($134.19 in chips) 
BGS013: posts small blind $0.50
reiyser: posts big blind $1
*** HOLE CARDS ***
Joe_Li7: folds 
xcinaz: folds 
Pumuking: folds 
BGS013: folds 
Uncalled bet ($0.50) returned to reiyser
reiyser collected $1 from pot
reiyser: doesn't show hand 
*** SUMMARY ***
Total pot $1 | Rake $0 
Seat 5: Dbackhouse1
Seat 1: Joe_Li7 folded before Flop (didn't bet)
Seat 2: xcinaz folded before Flop (didn't bet)
Seat 3: Pumuking (button) folded before Flop (didn't bet)
Seat 4: BGS013 (small blind) folded before Flop
Seat 6: reiyser (big blind) collected ($1)



PokerStars Hand #254516860767:  Hold'em No Limit ($0.50/$1.00 USD) - 2025/01/23 18:12:00 WET [2025/01/23 13:12:00 ET]
Table 'Helewalda IV' 6-max Seat #4 is the button
Seat 5: Dbackhouse1 ($0 in chips) is sitting out
Seat 1: Joe_Li7 ($182.96 in chips) 
Seat 2: xcinaz ($115.16 in chips) 
Seat 3: Pumuking ($100 in chips) 
Seat 4: BGS013 ($100 in chips) 
Seat 6: reiyser ($134.69 in chips) 
reiyser: posts small blind $0.50
Joe_Li7: posts big blind $1
*** HOLE CARDS ***
xcinaz: folds 
Pumuking: folds 
BGS013: raises $1.50 to $2.50
reiyser: folds 
Joe_Li7: folds 
Uncalled bet ($1.50) returned to BGS013
BGS013 collected $2.50 from pot
BGS013: doesn't show hand 
*** SUMMARY ***
Total pot $2.50 | Rake $0 
Seat 5: Dbackhouse1
Seat 1: Joe_Li7 (big blind) folded before Flop
Seat 2: xcinaz folded before Flop (didn't bet)
Seat 3: Pumuking folded before Flop (didn't bet)
Seat 4: BGS013 (button) collected ($2.50)
Seat 6: reiyser (small blind) folded before Flop



PokerStars Hand #254516864625:  Hold'em No Limit ($0.50/$1.00 USD) - 2025/01/23 18:12:16 WET [2025/01/23 13:12:16 ET]
Table 'Helewalda IV' 6-max Seat #6 is the button
Seat 5: Dbackhouse1 ($0 in chips) is sitting out
Seat 1: Joe_Li7 ($181.96 in chips) 
Seat 2: xcinaz ($115.16 in chips) 
Seat 3: Pumuking ($100 in chips) 
Seat 4: BGS013 ($101.50 in chips) 
Seat 6: reiyser ($134.19 in chips) 
Joe_Li7: posts small blind $0.50
xcinaz: posts big blind $1
*** HOLE CARDS ***
Dbackhouse1 is disconnected 
Pumuking: raises $1.25 to $2.25
BGS013: folds 
reiyser: folds 
Dbackhouse1 leaves the table
Joe_Li7: folds 
xcinaz: folds 
Uncalled bet ($1.25) returned to Pumuking
Pumuking collected $2.50 from pot
Pumuking: doesn't show hand 
*** SUMMARY ***
Total pot $2.50 | Rake $0 
Seat 5: Dbackhouse1
Seat 1: Joe_Li7 (small blind) folded before Flop
Seat 2: xcinaz (big blind) folded before Flop
Seat 3: Pumuking collected ($2.50)
Seat 4: BGS013 folded before Flop (didn't bet)
Seat 6: reiyser (button) folded before Flop (didn't bet)



PokerStars Hand #254516870540:  Hold'em No Limit ($0.50/$1.00 USD) - 2025/01/23 18:12:42 WET [2025/01/23 13:12:42 ET]
Table 'Helewalda IV' 6-max Seat #1 is the button
Seat 1: Joe_Li7 ($181.46 in chips) 
Seat 2: xcinaz ($114.16 in chips) 
Seat 3: Pumuking ($101.50 in chips) 
Seat 4: BGS013 ($101.50 in chips) 
Seat 6: reiyser ($134.19 in chips) 
xcinaz: posts small blind $0.50
Pumuking: posts big blind $1
*** HOLE CARDS ***
BGS013: folds 
reiyser: folds 
Joe_Li7: raises $1.50 to $2.50
xcinaz: folds 
Pumuking: raises $9.50 to $12
Joe_Li7: folds 
Uncalled bet ($9.50) returned to Pumuking
Pumuking collected $5.50 from pot
Pumuking: doesn't show hand 
*** SUMMARY ***
Total pot $5.50 | Rake $0 
Seat 1: Joe_Li7 (button) folded before Flop
Seat 2: xcinaz (small blind) folded before Flop
Seat 3: Pumuking (big blind) collected ($5.50)
Seat 4: BGS013 folded before Flop (didn't bet)
Seat 6: reiyser folded before Flop (didn't bet)



PokerStars Hand #254516875553:  Hold'em No Limit ($0.50/$1.00 USD) - 2025/01/23 18:13:04 WET [2025/01/23 13:13:04 ET]
Table 'Helewalda IV' 6-max Seat #2 is the button
Seat 1: Joe_Li7 ($178.96 in chips) 
Seat 2: xcinaz ($113.66 in chips) 
Seat 3: Pumuking ($104.50 in chips) 
Seat 4: BGS013 ($101.50 in chips) 
Seat 6: reiyser ($134.19 in chips) 
Pumuking: posts small blind $0.50
BGS013: posts big blind $1
*** HOLE CARDS ***
reiyser: folds 
Joe_Li7: folds 
xcinaz: raises $1.50 to $2.50
Pumuking: raises $8.50 to $11
BGS013: folds 
xcinaz: folds 
Uncalled bet ($8.50) returned to Pumuking
Pumuking collected $6 from pot
Pumuking: doesn't show hand 
*** SUMMARY ***
Total pot $6 | Rake $0 
Seat 1: Joe_Li7 folded before Flop (didn't bet)
Seat 2: xcinaz (button) folded before Flop
Seat 3: Pumuking (small blind) collected ($6)
Seat 4: BGS013 (big blind) folded before Flop
Seat 6: reiyser folded before Flop (didn't bet)



PokerStars Hand #254516880970:  Hold'em No Limit ($0.50/$1.00 USD) - 2025/01/23 18:13:27 WET [2025/01/23 13:13:27 ET]
Table 'Helewalda IV' 6-max Seat #3 is the button
Seat 1: Joe_Li7 ($178.96 in chips) 
Seat 2: xcinaz ($111.16 in chips) 
Seat 3: Pumuking ($108 in chips) 
Seat 4: BGS013 ($100.50 in chips) 
Seat 6: reiyser ($134.19 in chips) 
BGS013: posts small blind $0.50
reiyser: posts big blind $1
*** HOLE CARDS ***
XXoB joins the table at seat #5 
Joe_Li7: folds 
xcinaz: folds 
Pumuking: raises $1.50 to $2.50
BGS013: raises $8.50 to $11
reiyser: folds 
Pumuking: calls $8.50
*** FLOP *** [Ks 2s Td]
BGS013: bets $5.68
Pumuking: calls $5.68
*** TURN *** [Ks 2s Td] [Ac]
BGS013: bets $12.50
Pumuking: folds 
Uncalled bet ($12.50) returned to BGS013
BGS013 collected $32.64 from pot
*** SUMMARY ***
Total pot $34.36 | Rake $1.72 
Board [Ks 2s Td Ac]
Seat 1: Joe_Li7 folded before Flop (didn't bet)
Seat 2: xcinaz folded before Flop (didn't bet)
Seat 3: Pumuking (button) folded on the Turn
Seat 4: BGS013 (small blind) collected ($32.64)
Seat 6: reiyser (big blind) folded before Flop



PokerStars Hand #254516893530:  Hold'em No Limit ($0.50/$1.00 USD) - 2025/01/23 18:14:21 WET [2025/01/23 13:14:21 ET]
Table 'Helewalda IV' 6-max Seat #4 is the button
Seat 1: Joe_Li7 ($178.96 in chips) is sitting out
Seat 2: xcinaz ($111.16 in chips) is sitting out
Seat 5: XXoB ($100 in chips) is sitting out
Seat 3: Pumuking ($100 in chips) 
Seat 4: BGS013 ($116.46 in chips) 
Seat 6: reiyser ($133.19 in chips) 
reiyser: posts small blind $0.50
Joe_Li7: is sitting out 
xcinaz: is sitting out 
Pumuking: posts big blind $1
*** HOLE CARDS ***
BGS013: folds 
reiyser: folds 
Uncalled bet ($0.50) returned to Pumuking
Pumuking collected $1 from pot
Pumuking: doesn't show hand 
*** SUMMARY ***
Total pot $1 | Rake $0 
Seat 1: Joe_Li7
Seat 2: xcinaz
Seat 5: XXoB
Seat 3: Pumuking (big blind) collected ($1)
Seat 4: BGS013 (button) folded before Flop (didn't bet)
Seat 6: reiyser (small blind) folded before Flop



PokerStars Hand #254516895379:  Hold'em No Limit ($0.50/$1.00 USD) - 2025/01/23 18:14:29 WET [2025/01/23 13:14:29 ET]
Table 'Helewalda IV' 6-max Seat #6 is the button
Seat 1: Joe_Li7 ($178.96 in chips) is sitting out
Seat 2: xcinaz ($111.16 in chips) is sitting out
Seat 5: XXoB ($100 in chips) is sitting out
Seat 3: Pumuking ($100.50 in chips) 
Seat 4: BGS013 ($116.46 in chips) 
Seat 6: reiyser ($132.69 in chips) 
Pumuking: posts small blind $0.50
BGS013: posts big blind $1
XXoB: sits out 
*** HOLE CARDS ***
XXoB leaves the table
reiyser: raises $1.23 to $2.23
Pumuking: folds 
BGS013: folds 
Uncalled bet ($1.23) returned to reiyser
reiyser collected $2.50 from pot
reiyser: doesn't show hand 
*** SUMMARY ***
Total pot $2.50 | Rake $0 
Seat 1: Joe_Li7
Seat 2: xcinaz
Seat 5: XXoB
Seat 3: Pumuking (small blind) folded before Flop
Seat 4: BGS013 (big blind) folded before Flop
Seat 6: reiyser (button) collected ($2.50)



PokerStars Hand #254516898172:  Hold'em No Limit ($0.50/$1.00 USD) - 2025/01/23 18:14:41 WET [2025/01/23 13:14:41 ET]
Table 'Helewalda IV' 6-max Seat #4 is the button
Seat 1: Joe_Li7 ($178.96 in chips) is sitting out
Seat 2: xcinaz ($111.16 in chips) is sitting out
Seat 6: reiyser ($134.19 in chips) is sitting out
Seat 3: Pumuking ($100 in chips) 
Seat 4: BGS013 ($115.46 in chips) 
BGS013: posts small blind $0.50
reiyser: is sitting out 
Pumuking: posts big blind $1
*** HOLE CARDS ***
BGS013: raises $1.50 to $2.50
reiyser leaves the table
xcinaz leaves the table
Pumuking: calls $1.50
*** FLOP *** [2c Kd Ks]
Pumuking: checks 
BGS013: bets $1.24
Pumuking: calls $1.24
*** TURN *** [2c Kd Ks] [7d]
Pumuking: checks 
BGS013: checks 
*** RIVER *** [2c Kd Ks 7d] [Qh]
Pumuking: bets $2.35
BGS013: calls $2.35
*** SHOW DOWN ***
Pumuking: shows [3d Qd] (two pair, Kings and Queens)
BGS013: mucks hand 
Pumuking collected $11.57 from pot
*** SUMMARY ***
Total pot $12.18 | Rake $0.61 
Board [2c Kd Ks 7d Qh]
Seat 1: Joe_Li7
Seat 2: xcinaz
Seat 6: reiyser
Seat 3: Pumuking (big blind) showed [3d Qd] and won ($11.57) with two pair, Kings and Queens
Seat 4: BGS013 (button) (small blind) mucked



PokerStars Hand #254516906598:  Hold'em No Limit ($0.50/$1.00 USD) - 2025/01/23 18:15:17 WET [2025/01/23 13:15:17 ET]
Table 'Helewalda IV' 6-max Seat #3 is the button
Seat 1: Joe_Li7 ($178.96 in chips) is sitting out
Seat 3: Pumuking ($105.48 in chips) 
Seat 4: BGS013 ($109.37 in chips) 
Pumuking: posts small blind $0.50
BGS013: posts big blind $1
*** HOLE CARDS ***
Pumuking: raises $1.50 to $2.50
BGS013: folds 
Uncalled bet ($1.50) returned to Pumuking
Pumuking collected $2 from pot
Pumuking: doesn't show hand 
*** SUMMARY ***
Total pot $2 | Rake $0 
Seat 1: Joe_Li7
Seat 3: Pumuking (button) (small blind) collected ($2)
Seat 4: BGS013 (big blind) folded before Flop



