PokerStars Hand #254587138323:  Hold'em No Limit ($0.50/$1.00 USD) - 2025/01/27 23:14:52 WET [2025/01/27 18:14:52 ET]
Table 'Medusa IV' 6-max Seat #4 is the button
Seat 1: m0nTTu ($10 in chips) 
Seat 2: nastja336 ($100 in chips) 
Seat 4: M1k_DP ($100 in chips) 
Seat 6: Unipoker11 ($100 in chips) 
Unipoker11: posts small blind $0.50
m0nTTu: posts big blind $1
*** HOLE CARDS ***
nastja336: folds 
M1k_DP: folds 
Unipoker11: folds 
Uncalled bet ($0.50) returned to m0nTTu
m0nTTu collected $1 from pot
m0nTTu: doesn't show hand 
*** SUMMARY ***
Total pot $1 | Rake $0 
Seat 1: m0nTTu (big blind) collected ($1)
Seat 2: nastja336 folded before Flop (didn't bet)
Seat 4: M1k_DP (button) folded before Flop (didn't bet)
Seat 6: Unipoker11 (small blind) folded before Flop



PokerStars Hand #254587141686:  Hold'em No Limit ($0.50/$1.00 USD) - 2025/01/27 23:15:05 WET [2025/01/27 18:15:05 ET]
Table 'Medusa IV' 6-max Seat #6 is the button
Seat 1: m0nTTu ($10.50 in chips) 
Seat 2: nastja336 ($100 in chips) 
Seat 4: M1k_DP ($100 in chips) 
Seat 6: Unipoker11 ($100 in chips) 
m0nTTu: posts small blind $0.50
nastja336: posts big blind $1
*** HOLE CARDS ***
M1k_DP: folds 
Unipoker11: folds 
m0nTTu: raises $9.50 to $10.50 and is all-in
nastja336: folds 
Uncalled bet ($9.50) returned to m0nTTu
m0nTTu collected $2 from pot
m0nTTu: doesn't show hand 
*** SUMMARY ***
Total pot $2 | Rake $0 
Seat 1: m0nTTu (small blind) collected ($2)
Seat 2: nastja336 (big blind) folded before Flop
Seat 4: M1k_DP folded before Flop (didn't bet)
Seat 6: Unipoker11 (button) folded before Flop (didn't bet)



PokerStars Hand #254587144809:  Hold'em No Limit ($0.50/$1.00 USD) - 2025/01/27 23:15:17 WET [2025/01/27 18:15:17 ET]
Table 'Medusa IV' 6-max Seat #1 is the button
Seat 1: m0nTTu ($11.50 in chips) 
Seat 2: nastja336 ($100 in chips) 
Seat 4: M1k_DP ($100 in chips) 
Seat 6: Unipoker11 ($100 in chips) 
nastja336: posts small blind $0.50
M1k_DP: posts big blind $1
*** HOLE CARDS ***
Unipoker11: raises $1.30 to $2.30
m0nTTu: folds 
nastja336: folds 
M1k_DP: calls $1.30
*** FLOP *** [9s 7d 8c]
M1k_DP: checks 
Unipoker11: checks 
*** TURN *** [9s 7d 8c] [5d]
M1k_DP: bets $1.60
Unipoker11: calls $1.60
*** RIVER *** [9s 7d 8c 5d] [Jc]
M1k_DP: checks 
Unipoker11: bets $5.91
M1k_DP: folds 
Uncalled bet ($5.91) returned to Unipoker11
Unipoker11 collected $7.88 from pot
Unipoker11: doesn't show hand 
*** SUMMARY ***
Total pot $8.30 | Rake $0.42 
Board [9s 7d 8c 5d Jc]
Seat 1: m0nTTu (button) folded before Flop (didn't bet)
Seat 2: nastja336 (small blind) folded before Flop
Seat 4: M1k_DP (big blind) folded on the River
Seat 6: Unipoker11 collected ($7.88)



PokerStars Hand #254587170058:  Hold'em No Limit ($0.50/$1.00 USD) - 2025/01/27 23:16:55 WET [2025/01/27 18:16:55 ET]
Table 'Medusa IV' 6-max Seat #2 is the button
Seat 1: m0nTTu ($11.50 in chips) 
Seat 2: nastja336 ($100 in chips) 
Seat 4: M1k_DP ($100 in chips) 
Seat 6: Unipoker11 ($103.98 in chips) 
M1k_DP: posts small blind $0.50
Unipoker11: posts big blind $1
*** HOLE CARDS ***
m0nTTu: folds 
nastja336: folds 
M1k_DP: raises $2 to $3
Unipoker11: folds 
Uncalled bet ($2) returned to M1k_DP
M1k_DP collected $2 from pot
M1k_DP: doesn't show hand 
*** SUMMARY ***
Total pot $2 | Rake $0 
Seat 1: m0nTTu folded before Flop (didn't bet)
Seat 2: nastja336 (button) folded before Flop (didn't bet)
Seat 4: M1k_DP (small blind) collected ($2)
Seat 6: Unipoker11 (big blind) folded before Flop



PokerStars Hand #254587174474:  Hold'em No Limit ($0.50/$1.00 USD) - 2025/01/27 23:17:12 WET [2025/01/27 18:17:12 ET]
Table 'Medusa IV' 6-max Seat #4 is the button
Seat 1: m0nTTu ($11.50 in chips) 
Seat 2: nastja336 ($100 in chips) 
Seat 4: M1k_DP ($101 in chips) 
Seat 6: Unipoker11 ($102.98 in chips) 
Unipoker11: posts small blind $0.50
m0nTTu: posts big blind $1
*** HOLE CARDS ***
nastja336: folds 
nastja336 leaves the table
M1k_DP: folds 
Unipoker11: folds 
Uncalled bet ($0.50) returned to m0nTTu
m0nTTu collected $1 from pot
m0nTTu: doesn't show hand 
*** SUMMARY ***
Total pot $1 | Rake $0 
Seat 1: m0nTTu (big blind) collected ($1)
Seat 2: nastja336 folded before Flop (didn't bet)
Seat 4: M1k_DP (button) folded before Flop (didn't bet)
Seat 6: Unipoker11 (small blind) folded before Flop



PokerStars Hand #254587178033:  Hold'em No Limit ($0.50/$1.00 USD) - 2025/01/27 23:17:26 WET [2025/01/27 18:17:26 ET]
Table 'Medusa IV' 6-max Seat #1 is the button
Seat 4: M1k_DP ($101 in chips) is sitting out
Seat 1: m0nTTu ($12 in chips) 
Seat 6: Unipoker11 ($102.48 in chips) 
m0nTTu: posts small blind $0.50
M1k_DP: is sitting out 
Unipoker11: posts big blind $1
*** HOLE CARDS ***
M1k_DP leaves the table
m0nTTu: folds 
Uncalled bet ($0.50) returned to Unipoker11
Unipoker11 collected $1 from pot
Unipoker11: doesn't show hand 
*** SUMMARY ***
Total pot $1 | Rake $0 
Seat 4: M1k_DP
Seat 1: m0nTTu (button) (small blind) folded before Flop
Seat 6: Unipoker11 (big blind) collected ($1)



PokerStars Hand #254587197758:  Hold'em No Limit ($0.50/$1.00 USD) - 2025/01/27 23:18:42 WET [2025/01/27 18:18:42 ET]
Table 'Medusa IV' 6-max Seat #2 is the button
Seat 1: z00mba ($100 in chips) 
Seat 2: Osmontaneiro17 ($100 in chips) 
Seat 3: VahTang_89 ($100 in chips) 
Seat 4: andutu34 ($100 in chips) 
Seat 5: Supermegopro ($100 in chips) 
Seat 6: Unipoker11 ($102.98 in chips) 
VahTang_89: posts small blind $0.50
andutu34: posts big blind $1
*** HOLE CARDS ***
Supermegopro: raises $1.50 to $2.50
Unipoker11: raises $5 to $7.50
z00mba: folds 
Osmontaneiro17: folds 
VahTang_89: folds 
andutu34: folds 
Supermegopro: folds 
Uncalled bet ($5) returned to Unipoker11
Unipoker11 collected $6.50 from pot
Unipoker11: doesn't show hand 
*** SUMMARY ***
Total pot $6.50 | Rake $0 
Seat 1: z00mba folded before Flop (didn't bet)
Seat 2: Osmontaneiro17 (button) folded before Flop (didn't bet)
Seat 3: VahTang_89 (small blind) folded before Flop
Seat 4: andutu34 (big blind) folded before Flop
Seat 5: Supermegopro folded before Flop
Seat 6: Unipoker11 collected ($6.50)



PokerStars Hand #254587203799:  Hold'em No Limit ($0.50/$1.00 USD) - 2025/01/27 23:19:05 WET [2025/01/27 18:19:05 ET]
Table 'Medusa IV' 6-max Seat #3 is the button
Seat 1: z00mba ($100 in chips) 
Seat 2: Osmontaneiro17 ($100 in chips) 
Seat 3: VahTang_89 ($100 in chips) 
Seat 4: andutu34 ($100 in chips) 
Seat 5: Supermegopro ($100 in chips) 
Seat 6: Unipoker11 ($106.98 in chips) 
andutu34: posts small blind $0.50
Supermegopro: posts big blind $1
*** HOLE CARDS ***
Unipoker11: folds 
z00mba: folds 
Osmontaneiro17: folds 
VahTang_89: folds 
andutu34: folds 
Uncalled bet ($0.50) returned to Supermegopro
Supermegopro collected $1 from pot
Supermegopro: doesn't show hand 
*** SUMMARY ***
Total pot $1 | Rake $0 
Seat 1: z00mba folded before Flop (didn't bet)
Seat 2: Osmontaneiro17 folded before Flop (didn't bet)
Seat 3: VahTang_89 (button) folded before Flop (didn't bet)
Seat 4: andutu34 (small blind) folded before Flop
Seat 5: Supermegopro (big blind) collected ($1)
Seat 6: Unipoker11 folded before Flop (didn't bet)



PokerStars Hand #254587208052:  Hold'em No Limit ($0.50/$1.00 USD) - 2025/01/27 23:19:22 WET [2025/01/27 18:19:22 ET]
Table 'Medusa IV' 6-max Seat #4 is the button
Seat 1: z00mba ($100 in chips) 
Seat 2: Osmontaneiro17 ($100 in chips) 
Seat 3: VahTang_89 ($100 in chips) 
Seat 4: andutu34 ($100 in chips) 
Seat 5: Supermegopro ($100.50 in chips) 
Seat 6: Unipoker11 ($106.98 in chips) 
Supermegopro: posts small blind $0.50
Unipoker11: posts big blind $1
*** HOLE CARDS ***
z00mba: folds 
Osmontaneiro17: folds 
VahTang_89: raises $1.20 to $2.20
andutu34: folds 
Supermegopro: folds 
Unipoker11: calls $1.20
*** FLOP *** [3c 2h As]
Unipoker11: checks 
VahTang_89: checks 
*** TURN *** [3c 2h As] [Qd]
Unipoker11: checks 
VahTang_89: checks 
*** RIVER *** [3c 2h As Qd] [5h]
Unipoker11: bets $3.12
VahTang_89: calls $3.12
*** SHOW DOWN ***
Unipoker11: shows [9c Td] (high card Ace)
VahTang_89: shows [Jh Js] (a pair of Jacks)
VahTang_89 collected $10.58 from pot
*** SUMMARY ***
Total pot $11.14 | Rake $0.56 
Board [3c 2h As Qd 5h]
Seat 1: z00mba folded before Flop (didn't bet)
Seat 2: Osmontaneiro17 folded before Flop (didn't bet)
Seat 3: VahTang_89 showed [Jh Js] and won ($10.58) with a pair of Jacks
Seat 4: andutu34 (button) folded before Flop (didn't bet)
Seat 5: Supermegopro (small blind) folded before Flop
Seat 6: Unipoker11 (big blind) showed [9c Td] and lost with high card Ace



PokerStars Hand #254587225204:  Hold'em No Limit ($0.50/$1.00 USD) - 2025/01/27 23:20:30 WET [2025/01/27 18:20:30 ET]
Table 'Medusa IV' 6-max Seat #5 is the button
Seat 1: z00mba ($100 in chips) 
Seat 2: Osmontaneiro17 ($100 in chips) 
Seat 3: VahTang_89 ($105.26 in chips) 
Seat 4: andutu34 ($100 in chips) 
Seat 5: Supermegopro ($100 in chips) 
Seat 6: Unipoker11 ($101.66 in chips) 
Unipoker11: posts small blind $0.50
z00mba: posts big blind $1
*** HOLE CARDS ***
Osmontaneiro17: raises $1 to $2
VahTang_89: raises $5 to $7
andutu34: folds 
Supermegopro: folds 
Unipoker11: folds 
z00mba: folds 
Osmontaneiro17: calls $5
*** FLOP *** [4h Ts 3d]
Osmontaneiro17: checks 
VahTang_89: bets $4.86
Osmontaneiro17: raises $4.86 to $9.72
VahTang_89: folds 
Uncalled bet ($4.86) returned to Osmontaneiro17
Osmontaneiro17 collected $23.96 from pot
*** SUMMARY ***
Total pot $25.22 | Rake $1.26 
Board [4h Ts 3d]
Seat 1: z00mba (big blind) folded before Flop
Seat 2: Osmontaneiro17 collected ($23.96)
Seat 3: VahTang_89 folded on the Flop
Seat 4: andutu34 folded before Flop (didn't bet)
Seat 5: Supermegopro (button) folded before Flop (didn't bet)
Seat 6: Unipoker11 (small blind) folded before Flop



PokerStars Hand #254587234544:  Hold'em No Limit ($0.50/$1.00 USD) - 2025/01/27 23:21:07 WET [2025/01/27 18:21:07 ET]
Table 'Medusa IV' 6-max Seat #6 is the button
Seat 1: z00mba ($100 in chips) 
Seat 2: Osmontaneiro17 ($112.10 in chips) 
Seat 3: VahTang_89 ($100 in chips) 
Seat 4: andutu34 ($100 in chips) 
Seat 5: Supermegopro ($100 in chips) 
Seat 6: Unipoker11 ($101.16 in chips) 
z00mba: posts small blind $0.50
Osmontaneiro17: posts big blind $1
*** HOLE CARDS ***
VahTang_89: folds 
andutu34: folds 
Supermegopro: folds 
Unipoker11: raises $1.50 to $2.50
z00mba: folds 
Osmontaneiro17: calls $1.50
*** FLOP *** [Th 9s 5d]
Osmontaneiro17: checks 
Unipoker11: checks 
*** TURN *** [Th 9s 5d] [Kh]
Osmontaneiro17: bets $3
Unipoker11: calls $3
*** RIVER *** [Th 9s 5d Kh] [Kc]
Osmontaneiro17: checks 
Unipoker11: checks 
*** SHOW DOWN ***
Osmontaneiro17: shows [Qd 7d] (a pair of Kings)
Unipoker11: shows [9d 8s] (two pair, Kings and Nines)
Unipoker11 collected $10.92 from pot
*** SUMMARY ***
Total pot $11.50 | Rake $0.58 
Board [Th 9s 5d Kh Kc]
Seat 1: z00mba (small blind) folded before Flop
Seat 2: Osmontaneiro17 (big blind) showed [Qd 7d] and lost with a pair of Kings
Seat 3: VahTang_89 folded before Flop (didn't bet)
Seat 4: andutu34 folded before Flop (didn't bet)
Seat 5: Supermegopro folded before Flop (didn't bet)
Seat 6: Unipoker11 (button) showed [9d 8s] and won ($10.92) with two pair, Kings and Nines



PokerStars Hand #254587249454:  Hold'em No Limit ($0.50/$1.00 USD) - 2025/01/27 23:22:06 WET [2025/01/27 18:22:06 ET]
Table 'Medusa IV' 6-max Seat #1 is the button
Seat 1: z00mba ($100 in chips) 
Seat 2: Osmontaneiro17 ($106.60 in chips) 
Seat 3: VahTang_89 ($100 in chips) 
Seat 4: andutu34 ($100 in chips) 
Seat 5: Supermegopro ($100 in chips) 
Seat 6: Unipoker11 ($106.58 in chips) 
Osmontaneiro17: posts small blind $0.50
VahTang_89: posts big blind $1
*** HOLE CARDS ***
andutu34: folds 
Supermegopro: folds 
Unipoker11: folds 
z00mba: raises $1.50 to $2.50
Osmontaneiro17: folds 
VahTang_89: folds 
Uncalled bet ($1.50) returned to z00mba
z00mba collected $2.50 from pot
z00mba: doesn't show hand 
*** SUMMARY ***
Total pot $2.50 | Rake $0 
Seat 1: z00mba (button) collected ($2.50)
Seat 2: Osmontaneiro17 (small blind) folded before Flop
Seat 3: VahTang_89 (big blind) folded before Flop
Seat 4: andutu34 folded before Flop (didn't bet)
Seat 5: Supermegopro folded before Flop (didn't bet)
Seat 6: Unipoker11 folded before Flop (didn't bet)



PokerStars Hand #254587254798:  Hold'em No Limit ($0.50/$1.00 USD) - 2025/01/27 23:22:26 WET [2025/01/27 18:22:26 ET]
Table 'Medusa IV' 6-max Seat #2 is the button
Seat 1: z00mba ($101.50 in chips) 
Seat 2: Osmontaneiro17 ($106.10 in chips) 
Seat 3: VahTang_89 ($100 in chips) 
Seat 4: andutu34 ($100 in chips) 
Seat 5: Supermegopro ($100 in chips) 
Seat 6: Unipoker11 ($106.58 in chips) 
VahTang_89: posts small blind $0.50
andutu34: posts big blind $1
*** HOLE CARDS ***
Supermegopro: folds 
Unipoker11: raises $1 to $2
z00mba: folds 
Osmontaneiro17: folds 
VahTang_89: folds 
andutu34: folds 
Uncalled bet ($1) returned to Unipoker11
Unipoker11 collected $2.50 from pot
Unipoker11: doesn't show hand 
*** SUMMARY ***
Total pot $2.50 | Rake $0 
Seat 1: z00mba folded before Flop (didn't bet)
Seat 2: Osmontaneiro17 (button) folded before Flop (didn't bet)
Seat 3: VahTang_89 (small blind) folded before Flop
Seat 4: andutu34 (big blind) folded before Flop
Seat 5: Supermegopro folded before Flop (didn't bet)
Seat 6: Unipoker11 collected ($2.50)



PokerStars Hand #254587262320:  Hold'em No Limit ($0.50/$1.00 USD) - 2025/01/27 23:22:56 WET [2025/01/27 18:22:56 ET]
Table 'Medusa IV' 6-max Seat #3 is the button
Seat 1: z00mba ($101.50 in chips) 
Seat 2: Osmontaneiro17 ($106.10 in chips) 
Seat 3: VahTang_89 ($100 in chips) 
Seat 4: andutu34 ($100 in chips) 
Seat 5: Supermegopro ($100 in chips) 
Seat 6: Unipoker11 ($108.08 in chips) 
andutu34: posts small blind $0.50
Supermegopro: posts big blind $1
*** HOLE CARDS ***
Unipoker11: folds 
z00mba: folds 
Osmontaneiro17: folds 
VahTang_89: folds 
andutu34: folds 
Uncalled bet ($0.50) returned to Supermegopro
Supermegopro collected $1 from pot
Supermegopro: doesn't show hand 
*** SUMMARY ***
Total pot $1 | Rake $0 
Seat 1: z00mba folded before Flop (didn't bet)
Seat 2: Osmontaneiro17 folded before Flop (didn't bet)
Seat 3: VahTang_89 (button) folded before Flop (didn't bet)
Seat 4: andutu34 (small blind) folded before Flop
Seat 5: Supermegopro (big blind) collected ($1)
Seat 6: Unipoker11 folded before Flop (didn't bet)



PokerStars Hand #254587265881:  Hold'em No Limit ($0.50/$1.00 USD) - 2025/01/27 23:23:10 WET [2025/01/27 18:23:10 ET]
Table 'Medusa IV' 6-max Seat #4 is the button
Seat 1: z00mba ($101.50 in chips) 
Seat 2: Osmontaneiro17 ($106.10 in chips) 
Seat 3: VahTang_89 ($100 in chips) 
Seat 4: andutu34 ($100 in chips) 
Seat 5: Supermegopro ($100.50 in chips) 
Seat 6: Unipoker11 ($108.08 in chips) 
Supermegopro: posts small blind $0.50
Unipoker11: posts big blind $1
*** HOLE CARDS ***
z00mba: folds 
Osmontaneiro17: raises $1 to $2
VahTang_89: folds 
andutu34: folds 
Supermegopro: calls $1.50
Unipoker11: calls $1
*** FLOP *** [3c 5c 8s]
Supermegopro: checks 
Unipoker11: checks 
Osmontaneiro17: bets $3
Supermegopro: folds 
Unipoker11: folds 
Uncalled bet ($3) returned to Osmontaneiro17
Osmontaneiro17 collected $5.70 from pot
*** SUMMARY ***
Total pot $6 | Rake $0.30 
Board [3c 5c 8s]
Seat 1: z00mba folded before Flop (didn't bet)
Seat 2: Osmontaneiro17 collected ($5.70)
Seat 3: VahTang_89 folded before Flop (didn't bet)
Seat 4: andutu34 (button) folded before Flop (didn't bet)
Seat 5: Supermegopro (small blind) folded on the Flop
Seat 6: Unipoker11 (big blind) folded on the Flop



PokerStars Hand #254587274805:  Hold'em No Limit ($0.50/$1.00 USD) - 2025/01/27 23:23:45 WET [2025/01/27 18:23:45 ET]
Table 'Medusa IV' 6-max Seat #5 is the button
Seat 1: z00mba ($101.50 in chips) 
Seat 2: Osmontaneiro17 ($109.80 in chips) 
Seat 3: VahTang_89 ($100 in chips) 
Seat 4: andutu34 ($100 in chips) 
Seat 5: Supermegopro ($100 in chips) 
Seat 6: Unipoker11 ($106.08 in chips) 
Unipoker11: posts small blind $0.50
z00mba: posts big blind $1
*** HOLE CARDS ***
Osmontaneiro17: folds 
VahTang_89: raises $1.20 to $2.20
andutu34: folds 
Supermegopro: folds 
Unipoker11: folds 
z00mba: calls $1.20
*** FLOP *** [7d As Jd]
z00mba: checks 
VahTang_89: checks 
*** TURN *** [7d As Jd] [Qh]
z00mba: checks 
VahTang_89: checks 
*** RIVER *** [7d As Jd Qh] [2c]
z00mba: checks 
VahTang_89: bets $1.54
z00mba: folds 
Uncalled bet ($1.54) returned to VahTang_89
VahTang_89 collected $4.66 from pot
VahTang_89: doesn't show hand 
*** SUMMARY ***
Total pot $4.90 | Rake $0.24 
Board [7d As Jd Qh 2c]
Seat 1: z00mba (big blind) folded on the River
Seat 2: Osmontaneiro17 folded before Flop (didn't bet)
Seat 3: VahTang_89 collected ($4.66)
Seat 4: andutu34 folded before Flop (didn't bet)
Seat 5: Supermegopro (button) folded before Flop (didn't bet)
Seat 6: Unipoker11 (small blind) folded before Flop



PokerStars Hand #254587288407:  Hold'em No Limit ($0.50/$1.00 USD) - 2025/01/27 23:24:38 WET [2025/01/27 18:24:38 ET]
Table 'Medusa IV' 6-max Seat #6 is the button
Seat 1: z00mba ($100 in chips) 
Seat 2: Osmontaneiro17 ($109.80 in chips) 
Seat 3: VahTang_89 ($102.46 in chips) 
Seat 4: andutu34 ($100 in chips) 
Seat 5: Supermegopro ($100 in chips) 
Seat 6: Unipoker11 ($105.58 in chips) 
z00mba: posts small blind $0.50
Osmontaneiro17: posts big blind $1
*** HOLE CARDS ***
VahTang_89: raises $1.20 to $2.20
andutu34: folds 
Supermegopro: folds 
Unipoker11: calls $2.20
z00mba: folds 
Osmontaneiro17: folds 
*** FLOP *** [4c 5d Tc]
VahTang_89: bets $3.70
Unipoker11: folds 
Uncalled bet ($3.70) returned to VahTang_89
VahTang_89 collected $5.60 from pot
VahTang_89: doesn't show hand 
*** SUMMARY ***
Total pot $5.90 | Rake $0.30 
Board [4c 5d Tc]
Seat 1: z00mba (small blind) folded before Flop
Seat 2: Osmontaneiro17 (big blind) folded before Flop
Seat 3: VahTang_89 collected ($5.60)
Seat 4: andutu34 folded before Flop (didn't bet)
Seat 5: Supermegopro folded before Flop (didn't bet)
Seat 6: Unipoker11 (button) folded on the Flop



PokerStars Hand #254587295056:  Hold'em No Limit ($0.50/$1.00 USD) - 2025/01/27 23:25:05 WET [2025/01/27 18:25:05 ET]
Table 'Medusa IV' 6-max Seat #1 is the button
Seat 1: z00mba ($100 in chips) 
Seat 2: Osmontaneiro17 ($108.80 in chips) 
Seat 3: VahTang_89 ($105.86 in chips) 
Seat 4: andutu34 ($100 in chips) 
Seat 5: Supermegopro ($100 in chips) 
Seat 6: Unipoker11 ($103.38 in chips) 
Osmontaneiro17: posts small blind $0.50
VahTang_89: posts big blind $1
*** HOLE CARDS ***
andutu34: folds 
Supermegopro: folds 
Unipoker11: folds 
z00mba: raises $1.50 to $2.50
Osmontaneiro17: calls $2
VahTang_89: raises $10.50 to $13
z00mba: calls $10.50
Osmontaneiro17: folds 
*** FLOP *** [9h 8s 6c]
VahTang_89: checks 
z00mba: checks 
*** TURN *** [9h 8s 6c] [Js]
VahTang_89: checks 
z00mba: checks 
*** RIVER *** [9h 8s 6c Js] [9c]
VahTang_89: checks 
z00mba: checks 
*** SHOW DOWN ***
VahTang_89: shows [Kh Ah] (a pair of Nines)
z00mba: mucks hand 
VahTang_89 collected $27.08 from pot
*** SUMMARY ***
Total pot $28.50 | Rake $1.42 
Board [9h 8s 6c Js 9c]
Seat 1: z00mba (button) mucked
Seat 2: Osmontaneiro17 (small blind) folded before Flop
Seat 3: VahTang_89 (big blind) showed [Kh Ah] and won ($27.08) with a pair of Nines
Seat 4: andutu34 folded before Flop (didn't bet)
Seat 5: Supermegopro folded before Flop (didn't bet)
Seat 6: Unipoker11 folded before Flop (didn't bet)



PokerStars Hand #254587313373:  Hold'em No Limit ($0.50/$1.00 USD) - 2025/01/27 23:26:16 WET [2025/01/27 18:26:16 ET]
Table 'Medusa IV' 6-max Seat #2 is the button
Seat 1: z00mba ($100 in chips) 
Seat 2: Osmontaneiro17 ($106.30 in chips) 
Seat 3: VahTang_89 ($119.94 in chips) 
Seat 4: andutu34 ($100 in chips) 
Seat 5: Supermegopro ($100 in chips) 
Seat 6: Unipoker11 ($103.38 in chips) 
VahTang_89: posts small blind $0.50
andutu34: posts big blind $1
*** HOLE CARDS ***
Supermegopro: folds 
Unipoker11: raises $1 to $2
z00mba: folds 
Osmontaneiro17: folds 
VahTang_89: folds 
andutu34: folds 
Uncalled bet ($1) returned to Unipoker11
Unipoker11 collected $2.50 from pot
Unipoker11: doesn't show hand 
*** SUMMARY ***
Total pot $2.50 | Rake $0 
Seat 1: z00mba folded before Flop (didn't bet)
Seat 2: Osmontaneiro17 (button) folded before Flop (didn't bet)
Seat 3: VahTang_89 (small blind) folded before Flop
Seat 4: andutu34 (big blind) folded before Flop
Seat 5: Supermegopro folded before Flop (didn't bet)
Seat 6: Unipoker11 collected ($2.50)



PokerStars Hand #254587320382:  Hold'em No Limit ($0.50/$1.00 USD) - 2025/01/27 23:26:43 WET [2025/01/27 18:26:43 ET]
Table 'Medusa IV' 6-max Seat #3 is the button
Seat 1: z00mba ($100 in chips) 
Seat 2: Osmontaneiro17 ($106.30 in chips) 
Seat 3: VahTang_89 ($119.44 in chips) 
Seat 4: andutu34 ($100 in chips) 
Seat 5: Supermegopro ($100 in chips) 
Seat 6: Unipoker11 ($104.88 in chips) 
andutu34: posts small blind $0.50
Supermegopro: posts big blind $1
*** HOLE CARDS ***
Unipoker11: raises $1 to $2
z00mba: folds 
Osmontaneiro17: folds 
VahTang_89: folds 
andutu34: folds 
Supermegopro: folds 
Uncalled bet ($1) returned to Unipoker11
Unipoker11 collected $2.50 from pot
Unipoker11: doesn't show hand 
*** SUMMARY ***
Total pot $2.50 | Rake $0 
Seat 1: z00mba folded before Flop (didn't bet)
Seat 2: Osmontaneiro17 folded before Flop (didn't bet)
Seat 3: VahTang_89 (button) folded before Flop (didn't bet)
Seat 4: andutu34 (small blind) folded before Flop
Seat 5: Supermegopro (big blind) folded before Flop
Seat 6: Unipoker11 collected ($2.50)



PokerStars Hand #254587323669:  Hold'em No Limit ($0.50/$1.00 USD) - 2025/01/27 23:26:56 WET [2025/01/27 18:26:56 ET]
Table 'Medusa IV' 6-max Seat #4 is the button
Seat 1: z00mba ($100 in chips) 
Seat 2: Osmontaneiro17 ($106.30 in chips) 
Seat 3: VahTang_89 ($119.44 in chips) 
Seat 4: andutu34 ($100 in chips) 
Seat 5: Supermegopro ($100 in chips) 
Seat 6: Unipoker11 ($106.38 in chips) 
Supermegopro: posts small blind $0.50
Unipoker11: posts big blind $1
*** HOLE CARDS ***
z00mba: folds 
Osmontaneiro17: folds 
VahTang_89: raises $1.20 to $2.20
andutu34: folds 
Supermegopro: folds 
Unipoker11: folds 
Uncalled bet ($1.20) returned to VahTang_89
VahTang_89 collected $2.50 from pot
VahTang_89: doesn't show hand 
z00mba leaves the table
*** SUMMARY ***
Total pot $2.50 | Rake $0 
Seat 1: z00mba folded before Flop (didn't bet)
Seat 2: Osmontaneiro17 folded before Flop (didn't bet)
Seat 3: VahTang_89 collected ($2.50)
Seat 4: andutu34 (button) folded before Flop (didn't bet)
Seat 5: Supermegopro (small blind) folded before Flop
Seat 6: Unipoker11 (big blind) folded before Flop



PokerStars Hand #254587326638:  Hold'em No Limit ($0.50/$1.00 USD) - 2025/01/27 23:27:08 WET [2025/01/27 18:27:08 ET]
Table 'Medusa IV' 6-max Seat #5 is the button
Seat 2: Osmontaneiro17 ($106.30 in chips) 
Seat 3: VahTang_89 ($120.94 in chips) 
Seat 4: andutu34 ($100 in chips) 
Seat 5: Supermegopro ($100 in chips) 
Seat 6: Unipoker11 ($105.38 in chips) 
Unipoker11: posts small blind $0.50
Osmontaneiro17: posts big blind $1
*** HOLE CARDS ***
VahTang_89: folds 
andutu34: folds 
Supermegopro: raises $1.50 to $2.50
Unipoker11: folds 
Osmontaneiro17: folds 
Uncalled bet ($1.50) returned to Supermegopro
Supermegopro collected $2.50 from pot
Supermegopro: doesn't show hand 
*** SUMMARY ***
Total pot $2.50 | Rake $0 
Seat 2: Osmontaneiro17 (big blind) folded before Flop
Seat 3: VahTang_89 folded before Flop (didn't bet)
Seat 4: andutu34 folded before Flop (didn't bet)
Seat 5: Supermegopro (button) collected ($2.50)
Seat 6: Unipoker11 (small blind) folded before Flop



PokerStars Hand #254587329773:  Hold'em No Limit ($0.50/$1.00 USD) - 2025/01/27 23:27:20 WET [2025/01/27 18:27:20 ET]
Table 'Medusa IV' 6-max Seat #6 is the button
Seat 2: Osmontaneiro17 ($105.30 in chips) 
Seat 3: VahTang_89 ($120.94 in chips) 
Seat 4: andutu34 ($100 in chips) 
Seat 5: Supermegopro ($101.50 in chips) 
Seat 6: Unipoker11 ($104.88 in chips) 
Osmontaneiro17: posts small blind $0.50
VahTang_89: posts big blind $1
*** HOLE CARDS ***
andutu34: raises $1 to $2
Supermegopro: folds 
Unipoker11: folds 
Osmontaneiro17: folds 
VahTang_89: folds 
Uncalled bet ($1) returned to andutu34
andutu34 collected $2.50 from pot
andutu34: doesn't show hand 
elcutez joins the table at seat #1 
elcutez is disconnected 
*** SUMMARY ***
Total pot $2.50 | Rake $0 
Seat 2: Osmontaneiro17 (small blind) folded before Flop
Seat 3: VahTang_89 (big blind) folded before Flop
Seat 4: andutu34 collected ($2.50)
Seat 5: Supermegopro folded before Flop (didn't bet)
Seat 6: Unipoker11 (button) folded before Flop (didn't bet)



PokerStars Hand #254587333598:  Hold'em No Limit ($0.50/$1.00 USD) - 2025/01/27 23:27:35 WET [2025/01/27 18:27:35 ET]
Table 'Medusa IV' 6-max Seat #2 is the button
Seat 1: elcutez ($100 in chips) is sitting out
Seat 2: Osmontaneiro17 ($104.80 in chips) 
Seat 3: VahTang_89 ($119.94 in chips) 
Seat 4: andutu34 ($101.50 in chips) 
Seat 5: Supermegopro ($101.50 in chips) 
Seat 6: Unipoker11 ($104.88 in chips) 
VahTang_89: posts small blind $0.50
andutu34: posts big blind $1
elcutez: sits out 
*** HOLE CARDS ***
Supermegopro: folds 
Unipoker11: raises $1.30 to $2.30
Osmontaneiro17: folds 
VahTang_89: folds 
andutu34: folds 
Uncalled bet ($1.30) returned to Unipoker11
Unipoker11 collected $2.50 from pot
Unipoker11: doesn't show hand 
*** SUMMARY ***
Total pot $2.50 | Rake $0 
Seat 1: elcutez
Seat 2: Osmontaneiro17 (button) folded before Flop (didn't bet)
Seat 3: VahTang_89 (small blind) folded before Flop
Seat 4: andutu34 (big blind) folded before Flop
Seat 5: Supermegopro folded before Flop (didn't bet)
Seat 6: Unipoker11 collected ($2.50)



PokerStars Hand #254587338393:  Hold'em No Limit ($0.50/$1.00 USD) - 2025/01/27 23:27:53 WET [2025/01/27 18:27:53 ET]
Table 'Medusa IV' 6-max Seat #3 is the button
Seat 1: elcutez ($100 in chips) 
Seat 2: Osmontaneiro17 ($104.80 in chips) 
Seat 3: VahTang_89 ($119.44 in chips) 
Seat 4: andutu34 ($100.50 in chips) 
Seat 5: Supermegopro ($101.50 in chips) 
Seat 6: Unipoker11 ($106.38 in chips) 
andutu34: posts small blind $0.50
Supermegopro: posts big blind $1
elcutez: posts big blind $1
*** HOLE CARDS ***
Unipoker11: folds 
elcutez: raises $2 to $3
Osmontaneiro17: folds 
VahTang_89: folds 
andutu34: folds 
Supermegopro: calls $2
*** FLOP *** [Ac 2c 3d]
Supermegopro: checks 
elcutez: bets $6.18
Supermegopro: calls $6.18
*** TURN *** [Ac 2c 3d] [Kh]
Supermegopro: checks 
elcutez: bets $11
Supermegopro: calls $11
*** RIVER *** [Ac 2c 3d Kh] [5d]
Supermegopro: checks 
elcutez: checks 
*** SHOW DOWN ***
Supermegopro: shows [Ad Js] (a pair of Aces)
elcutez: shows [As Qs] (a pair of Aces - King+Queen kicker)
elcutez collected $38.82 from pot
*** SUMMARY ***
Total pot $40.86 | Rake $2.04 
Board [Ac 2c 3d Kh 5d]
Seat 1: elcutez showed [As Qs] and won ($38.82) with a pair of Aces
Seat 2: Osmontaneiro17 folded before Flop (didn't bet)
Seat 3: VahTang_89 (button) folded before Flop (didn't bet)
Seat 4: andutu34 (small blind) folded before Flop
Seat 5: Supermegopro (big blind) showed [Ad Js] and lost with a pair of Aces
Seat 6: Unipoker11 folded before Flop (didn't bet)



PokerStars Hand #254587353099:  Hold'em No Limit ($0.50/$1.00 USD) - 2025/01/27 23:28:51 WET [2025/01/27 18:28:51 ET]
Table 'Medusa IV' 6-max Seat #4 is the button
Seat 1: elcutez ($118.64 in chips) 
Seat 2: Osmontaneiro17 ($104.80 in chips) 
Seat 3: VahTang_89 ($119.44 in chips) 
Seat 4: andutu34 ($100 in chips) 
Seat 5: Supermegopro ($100 in chips) 
Seat 6: Unipoker11 ($106.38 in chips) 
Supermegopro: posts small blind $0.50
Unipoker11: posts big blind $1
*** HOLE CARDS ***
elcutez: folds 
Osmontaneiro17: raises $1 to $2
VahTang_89: raises $4 to $6
andutu34: folds 
Supermegopro: folds 
Unipoker11: folds 
Osmontaneiro17: calls $4
*** FLOP *** [Th 5c Qc]
Osmontaneiro17: checks 
VahTang_89: bets $6.41
Osmontaneiro17: calls $6.41
*** TURN *** [Th 5c Qc] [3c]
Osmontaneiro17: checks 
VahTang_89: bets $8.25
Osmontaneiro17: calls $8.25
*** RIVER *** [Th 5c Qc 3c] [9s]
Osmontaneiro17: bets $25
VahTang_89: calls $25
*** SHOW DOWN ***
Osmontaneiro17: shows [Td Ac] (a pair of Tens)
VahTang_89: shows [Qs Kd] (a pair of Queens)
VahTang_89 collected $90.32 from pot
*** SUMMARY ***
Total pot $92.82 | Rake $2.50 
Board [Th 5c Qc 3c 9s]
Seat 1: elcutez folded before Flop (didn't bet)
Seat 2: Osmontaneiro17 showed [Td Ac] and lost with a pair of Tens
Seat 3: VahTang_89 showed [Qs Kd] and won ($90.32) with a pair of Queens
Seat 4: andutu34 (button) folded before Flop (didn't bet)
Seat 5: Supermegopro (small blind) folded before Flop
Seat 6: Unipoker11 (big blind) folded before Flop



PokerStars Hand #254587372494:  Hold'em No Limit ($0.50/$1.00 USD) - 2025/01/27 23:30:08 WET [2025/01/27 18:30:08 ET]
Table 'Medusa IV' 6-max Seat #5 is the button
Seat 1: elcutez ($118.64 in chips) 
Seat 2: Osmontaneiro17 ($59.14 in chips) 
Seat 3: VahTang_89 ($164.10 in chips) 
Seat 4: andutu34 ($100 in chips) 
Seat 5: Supermegopro ($100 in chips) 
Seat 6: Unipoker11 ($105.38 in chips) 
Unipoker11: posts small blind $0.50
elcutez: posts big blind $1
*** HOLE CARDS ***
Osmontaneiro17: folds 
VahTang_89: folds 
andutu34: folds 
Supermegopro: raises $2 to $3
Unipoker11: folds 
elcutez: raises $6.50 to $9.50
Supermegopro: folds 
Uncalled bet ($6.50) returned to elcutez
elcutez collected $6.50 from pot
*** SUMMARY ***
Total pot $6.50 | Rake $0 
Seat 1: elcutez (big blind) collected ($6.50)
Seat 2: Osmontaneiro17 folded before Flop (didn't bet)
Seat 3: VahTang_89 folded before Flop (didn't bet)
Seat 4: andutu34 folded before Flop (didn't bet)
Seat 5: Supermegopro (button) folded before Flop
Seat 6: Unipoker11 (small blind) folded before Flop



PokerStars Hand #254587381429:  Hold'em No Limit ($0.50/$1.00 USD) - 2025/01/27 23:30:43 WET [2025/01/27 18:30:43 ET]
Table 'Medusa IV' 6-max Seat #6 is the button
Seat 1: elcutez ($122.14 in chips) 
Seat 2: Osmontaneiro17 ($59.14 in chips) 
Seat 3: VahTang_89 ($164.10 in chips) 
Seat 4: andutu34 ($100 in chips) 
Seat 5: Supermegopro ($100 in chips) 
Seat 6: Unipoker11 ($104.88 in chips) 
elcutez: posts small blind $0.50
Osmontaneiro17: posts big blind $1
*** HOLE CARDS ***
VahTang_89: folds 
andutu34: folds 
Supermegopro: folds 
Unipoker11: raises $1.50 to $2.50
elcutez: folds 
Osmontaneiro17: calls $1.50
*** FLOP *** [Td 4d 3s]
Osmontaneiro17: checks 
Unipoker11: bets $1.30
Osmontaneiro17: calls $1.30
*** TURN *** [Td 4d 3s] [8c]
Osmontaneiro17: bets $7
Unipoker11: calls $7
*** RIVER *** [Td 4d 3s 8c] [3h]
Osmontaneiro17: bets $15.75
Unipoker11: folds 
Uncalled bet ($15.75) returned to Osmontaneiro17
Osmontaneiro17 collected $21 from pot
*** SUMMARY ***
Total pot $22.10 | Rake $1.10 
Board [Td 4d 3s 8c 3h]
Seat 1: elcutez (small blind) folded before Flop
Seat 2: Osmontaneiro17 (big blind) collected ($21)
Seat 3: VahTang_89 folded before Flop (didn't bet)
Seat 4: andutu34 folded before Flop (didn't bet)
Seat 5: Supermegopro folded before Flop (didn't bet)
Seat 6: Unipoker11 (button) folded on the River



PokerStars Hand #254587400597:  Hold'em No Limit ($0.50/$1.00 USD) - 2025/01/27 23:31:59 WET [2025/01/27 18:31:59 ET]
Table 'Medusa IV' 6-max Seat #1 is the button
Seat 1: elcutez ($121.64 in chips) 
Seat 2: Osmontaneiro17 ($69.34 in chips) 
Seat 3: VahTang_89 ($164.10 in chips) 
Seat 4: andutu34 ($100 in chips) 
Seat 5: Supermegopro ($100 in chips) 
Seat 6: Unipoker11 ($100 in chips) 
Osmontaneiro17: posts small blind $0.50
VahTang_89: posts big blind $1
*** HOLE CARDS ***
andutu34: raises $1 to $2
Supermegopro: folds 
Unipoker11: folds 
elcutez: folds 
Osmontaneiro17: calls $1.50
VahTang_89: folds 
*** FLOP *** [8d 2s 6d]
Osmontaneiro17: checks 
andutu34: bets $1.57
Osmontaneiro17: calls $1.57
*** TURN *** [8d 2s 6d] [Ac]
Osmontaneiro17: checks 
andutu34: checks 
*** RIVER *** [8d 2s 6d Ac] [Ad]
Osmontaneiro17: bets $10
andutu34: calls $10
*** SHOW DOWN ***
Osmontaneiro17: shows [2d Kd] (a flush, Ace high)
andutu34: mucks hand 
Osmontaneiro17 collected $26.73 from pot
*** SUMMARY ***
Total pot $28.14 | Rake $1.41 
Board [8d 2s 6d Ac Ad]
Seat 1: elcutez (button) folded before Flop (didn't bet)
Seat 2: Osmontaneiro17 (small blind) showed [2d Kd] and won ($26.73) with a flush, Ace high
Seat 3: VahTang_89 (big blind) folded before Flop
Seat 4: andutu34 mucked
Seat 5: Supermegopro folded before Flop (didn't bet)
Seat 6: Unipoker11 folded before Flop (didn't bet)



PokerStars Hand #254587426201:  Hold'em No Limit ($0.50/$1.00 USD) - 2025/01/27 23:33:40 WET [2025/01/27 18:33:40 ET]
Table 'Medusa IV' 6-max Seat #2 is the button
Seat 1: elcutez ($121.64 in chips) 
Seat 2: Osmontaneiro17 ($82.50 in chips) 
Seat 3: VahTang_89 ($163.10 in chips) 
Seat 4: andutu34 ($100 in chips) 
Seat 5: Supermegopro ($100 in chips) 
Seat 6: Unipoker11 ($100 in chips) 
VahTang_89: posts small blind $0.50
andutu34: posts big blind $1
*** HOLE CARDS ***
Supermegopro: folds 
Unipoker11: folds 
elcutez: folds 
Osmontaneiro17: raises $1 to $2
VahTang_89: raises $8 to $10
andutu34: raises $11 to $21
Osmontaneiro17: folds 
VahTang_89: folds 
Uncalled bet ($11) returned to andutu34
andutu34 collected $22 from pot
andutu34: doesn't show hand 
*** SUMMARY ***
Total pot $22 | Rake $0 
Seat 1: elcutez folded before Flop (didn't bet)
Seat 2: Osmontaneiro17 (button) folded before Flop
Seat 3: VahTang_89 (small blind) folded before Flop
Seat 4: andutu34 (big blind) collected ($22)
Seat 5: Supermegopro folded before Flop (didn't bet)
Seat 6: Unipoker11 folded before Flop (didn't bet)



PokerStars Hand #254587435560:  Hold'em No Limit ($0.50/$1.00 USD) - 2025/01/27 23:34:16 WET [2025/01/27 18:34:16 ET]
Table 'Medusa IV' 6-max Seat #3 is the button
Seat 1: elcutez ($121.64 in chips) 
Seat 2: Osmontaneiro17 ($80.50 in chips) 
Seat 3: VahTang_89 ($153.10 in chips) 
Seat 4: andutu34 ($112 in chips) 
Seat 5: Supermegopro ($100 in chips) 
Seat 6: Unipoker11 ($100 in chips) 
andutu34: posts small blind $0.50
Supermegopro: posts big blind $1
*** HOLE CARDS ***
Unipoker11: raises $1 to $2
elcutez: folds 
Osmontaneiro17: folds 
VahTang_89: folds 
andutu34: folds 
Supermegopro: calls $1
*** FLOP *** [2c 9d 3c]
Supermegopro: checks 
Unipoker11: bets $2.14
Supermegopro: folds 
Uncalled bet ($2.14) returned to Unipoker11
Unipoker11 collected $4.28 from pot
Unipoker11: doesn't show hand 
*** SUMMARY ***
Total pot $4.50 | Rake $0.22 
Board [2c 9d 3c]
Seat 1: elcutez folded before Flop (didn't bet)
Seat 2: Osmontaneiro17 folded before Flop (didn't bet)
Seat 3: VahTang_89 (button) folded before Flop (didn't bet)
Seat 4: andutu34 (small blind) folded before Flop
Seat 5: Supermegopro (big blind) folded on the Flop
Seat 6: Unipoker11 collected ($4.28)



PokerStars Hand #254587442546:  Hold'em No Limit ($0.50/$1.00 USD) - 2025/01/27 23:34:44 WET [2025/01/27 18:34:44 ET]
Table 'Medusa IV' 6-max Seat #4 is the button
Seat 1: elcutez ($121.64 in chips) 
Seat 2: Osmontaneiro17 ($80.50 in chips) 
Seat 3: VahTang_89 ($153.10 in chips) 
Seat 4: andutu34 ($111.50 in chips) 
Seat 5: Supermegopro ($100 in chips) 
Seat 6: Unipoker11 ($102.28 in chips) 
Supermegopro: posts small blind $0.50
Unipoker11: posts big blind $1
*** HOLE CARDS ***
elcutez: folds 
Osmontaneiro17: folds 
VahTang_89: raises $1.20 to $2.20
andutu34: folds 
Supermegopro: folds 
Unipoker11: calls $1.20
*** FLOP *** [Ts 7c 4d]
Unipoker11: checks 
VahTang_89: checks 
*** TURN *** [Ts 7c 4d] [Td]
Unipoker11: bets $1.54
VahTang_89: folds 
Uncalled bet ($1.54) returned to Unipoker11
Unipoker11 collected $4.66 from pot
Unipoker11: doesn't show hand 
*** SUMMARY ***
Total pot $4.90 | Rake $0.24 
Board [Ts 7c 4d Td]
Seat 1: elcutez folded before Flop (didn't bet)
Seat 2: Osmontaneiro17 folded before Flop (didn't bet)
Seat 3: VahTang_89 folded on the Turn
Seat 4: andutu34 (button) folded before Flop (didn't bet)
Seat 5: Supermegopro (small blind) folded before Flop
Seat 6: Unipoker11 (big blind) collected ($4.66)



PokerStars Hand #254587597495:  Hold'em No Limit ($0.50/$1.00 USD) - 2025/01/27 23:45:22 WET [2025/01/27 18:45:22 ET]
Table 'Medusa IV' 6-max Seat #5 is the button
Seat 6: tarif77 ($100 in chips) is sitting out
Seat 1: BGS013 ($100 in chips) 
Seat 2: Osmontaneiro17 ($100.42 in chips) 
Seat 3: VahTang_89 ($144.90 in chips) 
Seat 4: andutu34 ($100 in chips) 
Seat 5: Supermegopro ($108.19 in chips) 
BGS013: posts small blind $0.50
Osmontaneiro17: posts big blind $1
*** HOLE CARDS ***
VahTang_89: folds 
andutu34: folds 
Supermegopro: raises $1.50 to $2.50
BGS013: folds 
Osmontaneiro17: calls $1.50
*** FLOP *** [5c Jc 2h]
Osmontaneiro17: checks 
Supermegopro: bets $1.72
Osmontaneiro17: calls $1.72
*** TURN *** [5c Jc 2h] [2s]
Osmontaneiro17: checks 
Supermegopro: bets $2.80
Osmontaneiro17: calls $2.80
*** RIVER *** [5c Jc 2h 2s] [6s]
Osmontaneiro17: checks 
Supermegopro: checks 
*** SHOW DOWN ***
Osmontaneiro17: shows [8c 3c] (a pair of Deuces)
Supermegopro: shows [Ah 8d] (a pair of Deuces - Ace kicker)
Supermegopro collected $13.81 from pot
*** SUMMARY ***
Total pot $14.54 | Rake $0.73 
Board [5c Jc 2h 2s 6s]
Seat 6: tarif77
Seat 1: BGS013 (small blind) folded before Flop
Seat 2: Osmontaneiro17 (big blind) showed [8c 3c] and lost with a pair of Deuces
Seat 3: VahTang_89 folded before Flop (didn't bet)
Seat 4: andutu34 folded before Flop (didn't bet)
Seat 5: Supermegopro (button) showed [Ah 8d] and won ($13.81) with a pair of Deuces



PokerStars Hand #254587607732:  Hold'em No Limit ($0.50/$1.00 USD) - 2025/01/27 23:46:05 WET [2025/01/27 18:46:05 ET]
Table 'Medusa IV' 6-max Seat #1 is the button
Seat 1: BGS013 ($100 in chips) 
Seat 2: Osmontaneiro17 ($93.40 in chips) 
Seat 3: VahTang_89 ($144.90 in chips) 
Seat 4: andutu34 ($100 in chips) 
Seat 5: Supermegopro ($114.98 in chips) 
Seat 6: tarif77 ($100 in chips) 
Osmontaneiro17: posts small blind $0.50
VahTang_89: posts big blind $1
tarif77: posts big blind $1
*** HOLE CARDS ***
andutu34: folds 
Supermegopro: folds 
tarif77: checks 
BGS013: folds 
Osmontaneiro17: folds 
VahTang_89: raises $3.50 to $4.50
tarif77: folds 
Uncalled bet ($3.50) returned to VahTang_89
VahTang_89 collected $2.50 from pot
VahTang_89: doesn't show hand 
*** SUMMARY ***
Total pot $2.50 | Rake $0 
Seat 1: BGS013 (button) folded before Flop (didn't bet)
Seat 2: Osmontaneiro17 (small blind) folded before Flop
Seat 3: VahTang_89 (big blind) collected ($2.50)
Seat 4: andutu34 folded before Flop (didn't bet)
Seat 5: Supermegopro folded before Flop (didn't bet)
Seat 6: tarif77 folded before Flop (didn't bet)



PokerStars Hand #254587615472:  Hold'em No Limit ($0.50/$1.00 USD) - 2025/01/27 23:46:38 WET [2025/01/27 18:46:38 ET]
Table 'Medusa IV' 6-max Seat #2 is the button
Seat 1: BGS013 ($100 in chips) 
Seat 2: Osmontaneiro17 ($92.90 in chips) 
Seat 3: VahTang_89 ($146.40 in chips) 
Seat 4: andutu34 ($100 in chips) 
Seat 5: Supermegopro ($114.98 in chips) 
Seat 6: tarif77 ($99 in chips) 
VahTang_89: posts small blind $0.50
andutu34: posts big blind $1
*** HOLE CARDS ***
Supermegopro: folds 
tarif77: calls $1
BGS013: folds 
Osmontaneiro17: calls $1
VahTang_89: folds 
andutu34: checks 
*** FLOP *** [Jc 8c Ts]
andutu34: checks 
tarif77: bets $1
Osmontaneiro17: raises $1 to $2
andutu34: folds 
tarif77: calls $1
*** TURN *** [Jc 8c Ts] [9h]
tarif77: bets $7.12
Osmontaneiro17: calls $7.12
*** RIVER *** [Jc 8c Ts 9h] [Kc]
tarif77: bets $40
Osmontaneiro17: raises $42.78 to $82.78 and is all-in
tarif77: calls $42.78
*** SHOW DOWN ***
Osmontaneiro17: shows [Qs Ad] (a straight, Ten to Ace)
tarif77: shows [6h 7s] (a straight, Seven to Jack)
Osmontaneiro17 collected $184.80 from pot
*** SUMMARY ***
Total pot $187.30 | Rake $2.50 
Board [Jc 8c Ts 9h Kc]
Seat 1: BGS013 folded before Flop (didn't bet)
Seat 2: Osmontaneiro17 (button) showed [Qs Ad] and won ($184.80) with a straight, Ten to Ace
Seat 3: VahTang_89 (small blind) folded before Flop
Seat 4: andutu34 (big blind) folded on the Flop
Seat 5: Supermegopro folded before Flop (didn't bet)
Seat 6: tarif77 showed [6h 7s] and lost with a straight, Seven to Jack



PokerStars Hand #254587638206:  Hold'em No Limit ($0.50/$1.00 USD) - 2025/01/27 23:48:15 WET [2025/01/27 18:48:15 ET]
Table 'Medusa IV' 6-max Seat #3 is the button
Seat 1: BGS013 ($100 in chips) 
Seat 2: Osmontaneiro17 ($184.80 in chips) 
Seat 3: VahTang_89 ($145.90 in chips) 
Seat 4: andutu34 ($100 in chips) 
Seat 5: Supermegopro ($114.98 in chips) 
Seat 6: tarif77 ($6.10 in chips) 
andutu34: posts small blind $0.50
Supermegopro: posts big blind $1
*** HOLE CARDS ***
tarif77: raises $5.10 to $6.10 and is all-in
BGS013: folds 
Osmontaneiro17: raises $5.10 to $11.20
VahTang_89: folds 
andutu34: folds 
Supermegopro: folds 
Uncalled bet ($5.10) returned to Osmontaneiro17
*** FLOP *** [9h Ts 3s]
*** TURN *** [9h Ts 3s] [As]
*** RIVER *** [9h Ts 3s As] [8d]
*** SHOW DOWN ***
tarif77: shows [8s Qs] (a flush, Ace high)
Osmontaneiro17: shows [3c 3d] (three of a kind, Threes)
tarif77 collected $13.02 from pot
*** SUMMARY ***
Total pot $13.70 | Rake $0.68 
Board [9h Ts 3s As 8d]
Seat 1: BGS013 folded before Flop (didn't bet)
Seat 2: Osmontaneiro17 showed [3c 3d] and lost with three of a kind, Threes
Seat 3: VahTang_89 (button) folded before Flop (didn't bet)
Seat 4: andutu34 (small blind) folded before Flop
Seat 5: Supermegopro (big blind) folded before Flop
Seat 6: tarif77 showed [8s Qs] and won ($13.02) with a flush, Ace high



PokerStars Hand #254587644104:  Hold'em No Limit ($0.50/$1.00 USD) - 2025/01/27 23:48:40 WET [2025/01/27 18:48:40 ET]
Table 'Medusa IV' 6-max Seat #4 is the button
Seat 1: BGS013 ($100 in chips) 
Seat 2: Osmontaneiro17 ($178.70 in chips) 
Seat 3: VahTang_89 ($145.90 in chips) 
Seat 4: andutu34 ($100 in chips) 
Seat 5: Supermegopro ($113.98 in chips) 
Seat 6: tarif77 ($13.02 in chips) 
Supermegopro: posts small blind $0.50
tarif77: posts big blind $1
*** HOLE CARDS ***
BGS013: folds 
Osmontaneiro17: raises $1 to $2
VahTang_89: folds 
andutu34: raises $5.50 to $7.50
Supermegopro: folds 
tarif77: calls $6.50
Osmontaneiro17: calls $5.50
*** FLOP *** [5c 2s 9d]
tarif77: checks 
Osmontaneiro17: checks 
andutu34: bets $10.93
tarif77: folds 
Osmontaneiro17: calls $10.93
*** TURN *** [5c 2s 9d] [9c]
Osmontaneiro17: checks 
andutu34: bets $21.31
Osmontaneiro17: folds 
Uncalled bet ($21.31) returned to andutu34
andutu34 collected $42.62 from pot
andutu34: doesn't show hand 
*** SUMMARY ***
Total pot $44.86 | Rake $2.24 
Board [5c 2s 9d 9c]
Seat 1: BGS013 folded before Flop (didn't bet)
Seat 2: Osmontaneiro17 folded on the Turn
Seat 3: VahTang_89 folded before Flop (didn't bet)
Seat 4: andutu34 (button) collected ($42.62)
Seat 5: Supermegopro (small blind) folded before Flop
Seat 6: tarif77 (big blind) folded on the Flop



PokerStars Hand #254587658142:  Hold'em No Limit ($0.50/$1.00 USD) - 2025/01/27 23:49:40 WET [2025/01/27 18:49:40 ET]
Table 'Medusa IV' 6-max Seat #5 is the button
Seat 1: BGS013 ($100 in chips) 
Seat 2: Osmontaneiro17 ($160.27 in chips) 
Seat 3: VahTang_89 ($145.90 in chips) 
Seat 4: andutu34 ($124.19 in chips) 
Seat 5: Supermegopro ($113.48 in chips) 
Seat 6: tarif77 ($100 in chips) 
tarif77: posts small blind $0.50
BGS013: posts big blind $1
*** HOLE CARDS ***
Osmontaneiro17: raises $1 to $2
VahTang_89: folds 
andutu34: raises $4.68 to $6.68
Supermegopro: folds 
tarif77: calls $6.18
BGS013: folds 
Osmontaneiro17: calls $4.68
*** FLOP *** [4d Ts 9d]
tarif77: bets $6
Osmontaneiro17: folds 
andutu34: raises $16 to $22
tarif77: calls $16
*** TURN *** [4d Ts 9d] [7h]
tarif77: bets $50
andutu34: raises $45.51 to $95.51 and is all-in
tarif77: calls $21.32 and is all-in
Uncalled bet ($24.19) returned to andutu34
*** RIVER *** [4d Ts 9d 7h] [2d]
*** SHOW DOWN ***
tarif77: shows [8c 7c] (a pair of Sevens)
andutu34: shows [Qd Qs] (a pair of Queens)
andutu34 collected $205.18 from pot
*** SUMMARY ***
Total pot $207.68 | Rake $2.50 
Board [4d Ts 9d 7h 2d]
Seat 1: BGS013 (big blind) folded before Flop
Seat 2: Osmontaneiro17 folded on the Flop
Seat 3: VahTang_89 folded before Flop (didn't bet)
Seat 4: andutu34 showed [Qd Qs] and won ($205.18) with a pair of Queens
Seat 5: Supermegopro (button) folded before Flop (didn't bet)
Seat 6: tarif77 (small blind) showed [8c 7c] and lost with a pair of Sevens



PokerStars Hand #254587672195:  Hold'em No Limit ($0.50/$1.00 USD) - 2025/01/27 23:50:41 WET [2025/01/27 18:50:41 ET]
Table 'Medusa IV' 6-max Seat #1 is the button
Seat 6: tarif77 ($0 in chips) is sitting out
Seat 1: BGS013 ($100 in chips) 
Seat 2: Osmontaneiro17 ($153.59 in chips) 
Seat 3: VahTang_89 ($145.90 in chips) 
Seat 4: andutu34 ($229.37 in chips) 
Seat 5: Supermegopro ($113.48 in chips) 
Osmontaneiro17: posts small blind $0.50
VahTang_89: posts big blind $1
*** HOLE CARDS ***
andutu34: folds 
Supermegopro: folds 
tarif77 leaves the table
BGS013: folds 
Osmontaneiro17: folds 
Uncalled bet ($0.50) returned to VahTang_89
VahTang_89 collected $1 from pot
VahTang_89: doesn't show hand 
*** SUMMARY ***
Total pot $1 | Rake $0 
Seat 6: tarif77
Seat 1: BGS013 (button) folded before Flop (didn't bet)
Seat 2: Osmontaneiro17 (small blind) folded before Flop
Seat 3: VahTang_89 (big blind) collected ($1)
Seat 4: andutu34 folded before Flop (didn't bet)
Seat 5: Supermegopro folded before Flop (didn't bet)



PokerStars Hand #254587675301:  Hold'em No Limit ($0.50/$1.00 USD) - 2025/01/27 23:50:55 WET [2025/01/27 18:50:55 ET]
Table 'Medusa IV' 6-max Seat #2 is the button
Seat 1: BGS013 ($100 in chips) 
Seat 2: Osmontaneiro17 ($153.09 in chips) 
Seat 3: VahTang_89 ($146.40 in chips) 
Seat 4: andutu34 ($229.37 in chips) 
Seat 5: Supermegopro ($113.48 in chips) 
VahTang_89: posts small blind $0.50
andutu34: posts big blind $1
*** HOLE CARDS ***
Supermegopro: raises $1.50 to $2.50
BGS013: folds 
Osmontaneiro17: folds 
VahTang_89: folds 
andutu34: folds 
Uncalled bet ($1.50) returned to Supermegopro
Supermegopro collected $2.50 from pot
Supermegopro: doesn't show hand 
MrP1usovoy joins the table at seat #6 
*** SUMMARY ***
Total pot $2.50 | Rake $0 
Seat 1: BGS013 folded before Flop (didn't bet)
Seat 2: Osmontaneiro17 (button) folded before Flop (didn't bet)
Seat 3: VahTang_89 (small blind) folded before Flop
Seat 4: andutu34 (big blind) folded before Flop
Seat 5: Supermegopro collected ($2.50)



PokerStars Hand #254587678713:  Hold'em No Limit ($0.50/$1.00 USD) - 2025/01/27 23:51:10 WET [2025/01/27 18:51:10 ET]
Table 'Medusa IV' 6-max Seat #3 is the button
Seat 6: MrP1usovoy ($100 in chips) is sitting out
Seat 1: BGS013 ($100 in chips) 
Seat 2: Osmontaneiro17 ($153.09 in chips) 
Seat 3: VahTang_89 ($145.90 in chips) 
Seat 4: andutu34 ($228.37 in chips) 
Seat 5: Supermegopro ($114.98 in chips) 
andutu34: posts small blind $0.50
Supermegopro: posts big blind $1
MrP1usovoy: sits out 
*** HOLE CARDS ***
BGS013: raises $1 to $2
Osmontaneiro17: folds 
VahTang_89: folds 
andutu34: folds 
Supermegopro: folds 
Uncalled bet ($1) returned to BGS013
BGS013 collected $2.50 from pot
BGS013: doesn't show hand 
*** SUMMARY ***
Total pot $2.50 | Rake $0 
Seat 6: MrP1usovoy
Seat 1: BGS013 collected ($2.50)
Seat 2: Osmontaneiro17 folded before Flop (didn't bet)
Seat 3: VahTang_89 (button) folded before Flop (didn't bet)
Seat 4: andutu34 (small blind) folded before Flop
Seat 5: Supermegopro (big blind) folded before Flop



PokerStars Hand #254587683603:  Hold'em No Limit ($0.50/$1.00 USD) - 2025/01/27 23:51:31 WET [2025/01/27 18:51:31 ET]
Table 'Medusa IV' 6-max Seat #4 is the button
Seat 1: BGS013 ($101.50 in chips) 
Seat 2: Osmontaneiro17 ($153.09 in chips) 
Seat 3: VahTang_89 ($145.90 in chips) 
Seat 4: andutu34 ($227.87 in chips) 
Seat 5: Supermegopro ($113.98 in chips) 
Seat 6: MrP1usovoy ($100 in chips) 
Supermegopro: posts small blind $0.50
MrP1usovoy: posts big blind $1
*** HOLE CARDS ***
BGS013: folds 
Osmontaneiro17: raises $1 to $2
VahTang_89: folds 
andutu34: folds 
Supermegopro: folds 
MrP1usovoy: calls $1
*** FLOP *** [8c 8h Js]
MrP1usovoy: checks 
Osmontaneiro17: bets $3
MrP1usovoy: folds 
Uncalled bet ($3) returned to Osmontaneiro17
Osmontaneiro17 collected $4.28 from pot
*** SUMMARY ***
Total pot $4.50 | Rake $0.22 
Board [8c 8h Js]
Seat 1: BGS013 folded before Flop (didn't bet)
Seat 2: Osmontaneiro17 collected ($4.28)
Seat 3: VahTang_89 folded before Flop (didn't bet)
Seat 4: andutu34 (button) folded before Flop (didn't bet)
Seat 5: Supermegopro (small blind) folded before Flop
Seat 6: MrP1usovoy (big blind) folded on the Flop



PokerStars Hand #254587690972:  Hold'em No Limit ($0.50/$1.00 USD) - 2025/01/27 23:52:04 WET [2025/01/27 18:52:04 ET]
Table 'Medusa IV' 6-max Seat #5 is the button
Seat 1: BGS013 ($101.50 in chips) 
Seat 2: Osmontaneiro17 ($155.37 in chips) 
Seat 3: VahTang_89 ($145.90 in chips) 
Seat 4: andutu34 ($227.87 in chips) 
Seat 5: Supermegopro ($113.48 in chips) 
Seat 6: MrP1usovoy ($100 in chips) 
MrP1usovoy: posts small blind $0.50
BGS013: posts big blind $1
*** HOLE CARDS ***
Osmontaneiro17: folds 
VahTang_89: folds 
andutu34: raises $1.30 to $2.30
Supermegopro: raises $5.20 to $7.50
MrP1usovoy: raises $14.50 to $22
BGS013: folds 
andutu34: folds 
Supermegopro: folds 
Uncalled bet ($14.50) returned to MrP1usovoy
MrP1usovoy collected $18.30 from pot
MrP1usovoy: doesn't show hand 
*** SUMMARY ***
Total pot $18.30 | Rake $0 
Seat 1: BGS013 (big blind) folded before Flop
Seat 2: Osmontaneiro17 folded before Flop (didn't bet)
Seat 3: VahTang_89 folded before Flop (didn't bet)
Seat 4: andutu34 folded before Flop
Seat 5: Supermegopro (button) folded before Flop
Seat 6: MrP1usovoy (small blind) collected ($18.30)



PokerStars Hand #254587697415:  Hold'em No Limit ($0.50/$1.00 USD) - 2025/01/27 23:52:32 WET [2025/01/27 18:52:32 ET]
Table 'Medusa IV' 6-max Seat #6 is the button
Seat 1: BGS013 ($100.50 in chips) 
Seat 2: Osmontaneiro17 ($155.37 in chips) 
Seat 3: VahTang_89 ($145.90 in chips) 
Seat 4: andutu34 ($225.57 in chips) 
Seat 5: Supermegopro ($105.98 in chips) 
Seat 6: MrP1usovoy ($110.80 in chips) 
BGS013: posts small blind $0.50
Osmontaneiro17: posts big blind $1
*** HOLE CARDS ***
VahTang_89: folds 
andutu34: folds 
Supermegopro: raises $1.50 to $2.50
MrP1usovoy: folds 
BGS013: folds 
Osmontaneiro17: folds 
Uncalled bet ($1.50) returned to Supermegopro
Supermegopro collected $2.50 from pot
Supermegopro: doesn't show hand 
*** SUMMARY ***
Total pot $2.50 | Rake $0 
Seat 1: BGS013 (small blind) folded before Flop
Seat 2: Osmontaneiro17 (big blind) folded before Flop
Seat 3: VahTang_89 folded before Flop (didn't bet)
Seat 4: andutu34 folded before Flop (didn't bet)
Seat 5: Supermegopro collected ($2.50)
Seat 6: MrP1usovoy (button) folded before Flop (didn't bet)



PokerStars Hand #254587702959:  Hold'em No Limit ($0.50/$1.00 USD) - 2025/01/27 23:52:57 WET [2025/01/27 18:52:57 ET]
Table 'Medusa IV' 6-max Seat #1 is the button
Seat 1: BGS013 ($100 in chips) 
Seat 2: Osmontaneiro17 ($154.37 in chips) 
Seat 3: VahTang_89 ($145.90 in chips) 
Seat 4: andutu34 ($225.57 in chips) 
Seat 5: Supermegopro ($107.48 in chips) 
Seat 6: MrP1usovoy ($110.80 in chips) 
Osmontaneiro17: posts small blind $0.50
VahTang_89: posts big blind $1
*** HOLE CARDS ***
andutu34: folds 
Supermegopro: folds 
MrP1usovoy: raises $1.50 to $2.50
BGS013: folds 
Osmontaneiro17: calls $2
VahTang_89: folds 
*** FLOP *** [6s 5s 5c]
Osmontaneiro17: checks 
MrP1usovoy: bets $1.88
Osmontaneiro17: calls $1.88
*** TURN *** [6s 5s 5c] [Ac]
Osmontaneiro17: checks 
MrP1usovoy: checks 
*** RIVER *** [6s 5s 5c Ac] [2h]
Osmontaneiro17: bets $10
MrP1usovoy: folds 
Uncalled bet ($10) returned to Osmontaneiro17
Osmontaneiro17 collected $9.27 from pot
*** SUMMARY ***
Total pot $9.76 | Rake $0.49 
Board [6s 5s 5c Ac 2h]
Seat 1: BGS013 (button) folded before Flop (didn't bet)
Seat 2: Osmontaneiro17 (small blind) collected ($9.27)
Seat 3: VahTang_89 (big blind) folded before Flop
Seat 4: andutu34 folded before Flop (didn't bet)
Seat 5: Supermegopro folded before Flop (didn't bet)
Seat 6: MrP1usovoy folded on the River



PokerStars Hand #254587717414:  Hold'em No Limit ($0.50/$1.00 USD) - 2025/01/27 23:54:01 WET [2025/01/27 18:54:01 ET]
Table 'Medusa IV' 6-max Seat #2 is the button
Seat 1: BGS013 ($100 in chips) 
Seat 2: Osmontaneiro17 ($159.26 in chips) 
Seat 3: VahTang_89 ($144.90 in chips) 
Seat 4: andutu34 ($225.57 in chips) 
Seat 5: Supermegopro ($107.48 in chips) 
Seat 6: MrP1usovoy ($106.42 in chips) 
VahTang_89: posts small blind $0.50
andutu34: posts big blind $1
*** HOLE CARDS ***
Supermegopro: raises $1.50 to $2.50
MrP1usovoy: folds 
BGS013: folds 
Osmontaneiro17: folds 
VahTang_89: folds 
andutu34: folds 
Uncalled bet ($1.50) returned to Supermegopro
Supermegopro collected $2.50 from pot
Supermegopro: doesn't show hand 
*** SUMMARY ***
Total pot $2.50 | Rake $0 
Seat 1: BGS013 folded before Flop (didn't bet)
Seat 2: Osmontaneiro17 (button) folded before Flop (didn't bet)
Seat 3: VahTang_89 (small blind) folded before Flop
Seat 4: andutu34 (big blind) folded before Flop
Seat 5: Supermegopro collected ($2.50)
Seat 6: MrP1usovoy folded before Flop (didn't bet)



PokerStars Hand #254587720723:  Hold'em No Limit ($0.50/$1.00 USD) - 2025/01/27 23:54:15 WET [2025/01/27 18:54:15 ET]
Table 'Medusa IV' 6-max Seat #3 is the button
Seat 1: BGS013 ($100 in chips) 
Seat 2: Osmontaneiro17 ($159.26 in chips) 
Seat 3: VahTang_89 ($144.40 in chips) 
Seat 4: andutu34 ($224.57 in chips) 
Seat 5: Supermegopro ($108.98 in chips) 
Seat 6: MrP1usovoy ($106.42 in chips) 
andutu34: posts small blind $0.50
Supermegopro: posts big blind $1
*** HOLE CARDS ***
MrP1usovoy: folds 
BGS013: folds 
Osmontaneiro17: raises $1 to $2
VahTang_89: folds 
andutu34: folds 
Supermegopro: folds 
Uncalled bet ($1) returned to Osmontaneiro17
Osmontaneiro17 collected $2.50 from pot
*** SUMMARY ***
Total pot $2.50 | Rake $0 
Seat 1: BGS013 folded before Flop (didn't bet)
Seat 2: Osmontaneiro17 collected ($2.50)
Seat 3: VahTang_89 (button) folded before Flop (didn't bet)
Seat 4: andutu34 (small blind) folded before Flop
Seat 5: Supermegopro (big blind) folded before Flop
Seat 6: MrP1usovoy folded before Flop (didn't bet)



PokerStars Hand #254587724559:  Hold'em No Limit ($0.50/$1.00 USD) - 2025/01/27 23:54:32 WET [2025/01/27 18:54:32 ET]
Table 'Medusa IV' 6-max Seat #4 is the button
Seat 1: BGS013 ($100 in chips) 
Seat 2: Osmontaneiro17 ($160.76 in chips) 
Seat 3: VahTang_89 ($144.40 in chips) 
Seat 4: andutu34 ($224.07 in chips) 
Seat 5: Supermegopro ($107.98 in chips) 
Seat 6: MrP1usovoy ($106.42 in chips) 
Supermegopro: posts small blind $0.50
MrP1usovoy: posts big blind $1
*** HOLE CARDS ***
BGS013: folds 
Osmontaneiro17: folds 
VahTang_89: folds 
andutu34: folds 
Supermegopro: folds 
Uncalled bet ($0.50) returned to MrP1usovoy
MrP1usovoy collected $1 from pot
MrP1usovoy: doesn't show hand 
*** SUMMARY ***
Total pot $1 | Rake $0 
Seat 1: BGS013 folded before Flop (didn't bet)
Seat 2: Osmontaneiro17 folded before Flop (didn't bet)
Seat 3: VahTang_89 folded before Flop (didn't bet)
Seat 4: andutu34 (button) folded before Flop (didn't bet)
Seat 5: Supermegopro (small blind) folded before Flop
Seat 6: MrP1usovoy (big blind) collected ($1)



PokerStars Hand #254587726941:  Hold'em No Limit ($0.50/$1.00 USD) - 2025/01/27 23:54:43 WET [2025/01/27 18:54:43 ET]
Table 'Medusa IV' 6-max Seat #5 is the button
Seat 1: BGS013 ($100 in chips) 
Seat 2: Osmontaneiro17 ($160.76 in chips) 
Seat 3: VahTang_89 ($144.40 in chips) 
Seat 4: andutu34 ($224.07 in chips) 
Seat 5: Supermegopro ($107.48 in chips) 
Seat 6: MrP1usovoy ($106.92 in chips) 
MrP1usovoy: posts small blind $0.50
BGS013: posts big blind $1
*** HOLE CARDS ***
Osmontaneiro17: raises $1 to $2
VahTang_89: folds 
andutu34: folds 
Supermegopro: raises $5.50 to $7.50
MrP1usovoy: folds 
BGS013: folds 
Osmontaneiro17: calls $5.50
*** FLOP *** [5s 6c Ac]
Osmontaneiro17: checks 
Supermegopro: checks 
*** TURN *** [5s 6c Ac] [8h]
Osmontaneiro17: bets $8
Supermegopro: folds 
Uncalled bet ($8) returned to Osmontaneiro17
Osmontaneiro17 collected $15.68 from pot
*** SUMMARY ***
Total pot $16.50 | Rake $0.82 
Board [5s 6c Ac 8h]
Seat 1: BGS013 (big blind) folded before Flop
Seat 2: Osmontaneiro17 collected ($15.68)
Seat 3: VahTang_89 folded before Flop (didn't bet)
Seat 4: andutu34 folded before Flop (didn't bet)
Seat 5: Supermegopro (button) folded on the Turn
Seat 6: MrP1usovoy (small blind) folded before Flop



PokerStars Hand #254587738166:  Hold'em No Limit ($0.50/$1.00 USD) - 2025/01/27 23:55:41 WET [2025/01/27 18:55:41 ET]
Table 'Medusa IV' 6-max Seat #6 is the button
Seat 1: BGS013 ($100 in chips) 
Seat 2: Osmontaneiro17 ($168.94 in chips) 
Seat 3: VahTang_89 ($144.40 in chips) 
Seat 4: andutu34 ($224.07 in chips) 
Seat 5: Supermegopro ($100 in chips) 
Seat 6: MrP1usovoy ($106.42 in chips) 
BGS013: posts small blind $0.50
Osmontaneiro17: posts big blind $1
*** HOLE CARDS ***
VahTang_89: folds 
andutu34: folds 
Supermegopro: folds 
MrP1usovoy: folds 
BGS013: raises $2 to $3
Osmontaneiro17: folds 
Uncalled bet ($2) returned to BGS013
BGS013 collected $2 from pot
BGS013: doesn't show hand 
*** SUMMARY ***
Total pot $2 | Rake $0 
Seat 1: BGS013 (small blind) collected ($2)
Seat 2: Osmontaneiro17 (big blind) folded before Flop
Seat 3: VahTang_89 folded before Flop (didn't bet)
Seat 4: andutu34 folded before Flop (didn't bet)
Seat 5: Supermegopro folded before Flop (didn't bet)
Seat 6: MrP1usovoy (button) folded before Flop (didn't bet)



PokerStars Hand #254587740960:  Hold'em No Limit ($0.50/$1.00 USD) - 2025/01/27 23:55:57 WET [2025/01/27 18:55:57 ET]
Table 'Medusa IV' 6-max Seat #1 is the button
Seat 1: BGS013 ($101 in chips) 
Seat 2: Osmontaneiro17 ($167.94 in chips) 
Seat 3: VahTang_89 ($144.40 in chips) 
Seat 4: andutu34 ($224.07 in chips) 
Seat 5: Supermegopro ($100 in chips) 
Seat 6: MrP1usovoy ($106.42 in chips) 
Osmontaneiro17: posts small blind $0.50
VahTang_89: posts big blind $1
*** HOLE CARDS ***
andutu34: folds 
Supermegopro: folds 
MrP1usovoy: raises $1.50 to $2.50
BGS013: folds 
Osmontaneiro17: raises $6.50 to $9
VahTang_89: folds 
MrP1usovoy: folds 
Uncalled bet ($6.50) returned to Osmontaneiro17
Osmontaneiro17 collected $6 from pot
*** SUMMARY ***
Total pot $6 | Rake $0 
Seat 1: BGS013 (button) folded before Flop (didn't bet)
Seat 2: Osmontaneiro17 (small blind) collected ($6)
Seat 3: VahTang_89 (big blind) folded before Flop
Seat 4: andutu34 folded before Flop (didn't bet)
Seat 5: Supermegopro folded before Flop (didn't bet)
Seat 6: MrP1usovoy folded before Flop



PokerStars Hand #254587749244:  Hold'em No Limit ($0.50/$1.00 USD) - 2025/01/27 23:56:44 WET [2025/01/27 18:56:44 ET]
Table 'Medusa IV' 6-max Seat #2 is the button
Seat 4: andutu34 ($224.07 in chips) is sitting out
Seat 1: BGS013 ($101 in chips) 
Seat 2: Osmontaneiro17 ($171.44 in chips) 
Seat 3: VahTang_89 ($143.40 in chips) 
Seat 5: Supermegopro ($100 in chips) 
Seat 6: MrP1usovoy ($103.92 in chips) 
VahTang_89: posts small blind $0.50
andutu34: is sitting out 
Supermegopro: posts big blind $1
*** HOLE CARDS ***
MrP1usovoy: folds 
BGS013: folds 
Osmontaneiro17: folds 
VahTang_89: folds 
Uncalled bet ($0.50) returned to Supermegopro
Supermegopro collected $1 from pot
Supermegopro: doesn't show hand 
*** SUMMARY ***
Total pot $1 | Rake $0 
Seat 4: andutu34
Seat 1: BGS013 folded before Flop (didn't bet)
Seat 2: Osmontaneiro17 (button) folded before Flop (didn't bet)
Seat 3: VahTang_89 (small blind) folded before Flop
Seat 5: Supermegopro (big blind) collected ($1)
Seat 6: MrP1usovoy folded before Flop (didn't bet)



PokerStars Hand #254587752059:  Hold'em No Limit ($0.50/$1.00 USD) - 2025/01/27 23:57:01 WET [2025/01/27 18:57:01 ET]
Table 'Medusa IV' 6-max Seat #3 is the button
Seat 4: andutu34 ($224.07 in chips) is sitting out
Seat 1: BGS013 ($101 in chips) 
Seat 2: Osmontaneiro17 ($171.44 in chips) 
Seat 3: VahTang_89 ($142.90 in chips) 
Seat 5: Supermegopro ($100.50 in chips) 
Seat 6: MrP1usovoy ($103.92 in chips) 
Supermegopro: posts small blind $0.50
MrP1usovoy: posts big blind $1
*** HOLE CARDS ***
BGS013: folds 
Osmontaneiro17: raises $1 to $2
VahTang_89: calls $2
Supermegopro: folds 
MrP1usovoy: folds 
*** FLOP *** [9c Th 7s]
Osmontaneiro17: bets $3
VahTang_89: folds 
Uncalled bet ($3) returned to Osmontaneiro17
Osmontaneiro17 collected $5.22 from pot
*** SUMMARY ***
Total pot $5.50 | Rake $0.28 
Board [9c Th 7s]
Seat 4: andutu34
Seat 1: BGS013 folded before Flop (didn't bet)
Seat 2: Osmontaneiro17 collected ($5.22)
Seat 3: VahTang_89 (button) folded on the Flop
Seat 5: Supermegopro (small blind) folded before Flop
Seat 6: MrP1usovoy (big blind) folded before Flop



PokerStars Hand #254587756813:  Hold'em No Limit ($0.50/$1.00 USD) - 2025/01/27 23:57:28 WET [2025/01/27 18:57:28 ET]
Table 'Medusa IV' 6-max Seat #5 is the button
Seat 4: andutu34 ($224.07 in chips) is sitting out
Seat 1: BGS013 ($101 in chips) 
Seat 2: Osmontaneiro17 ($174.66 in chips) 
Seat 3: VahTang_89 ($140.90 in chips) 
Seat 5: Supermegopro ($100 in chips) 
Seat 6: MrP1usovoy ($102.92 in chips) 
MrP1usovoy: posts small blind $0.50
BGS013: posts big blind $1
andutu34: sits out 
*** HOLE CARDS ***
Osmontaneiro17: folds 
VahTang_89: folds 
Supermegopro: raises $2 to $3
MrP1usovoy: folds 
BGS013: calls $2
*** FLOP *** [Ad 7s Ks]
BGS013: checks 
Supermegopro: bets $4.12
BGS013: folds 
Uncalled bet ($4.12) returned to Supermegopro
Supermegopro collected $6.18 from pot
Supermegopro: doesn't show hand 
*** SUMMARY ***
Total pot $6.50 | Rake $0.32 
Board [Ad 7s Ks]
Seat 4: andutu34
Seat 1: BGS013 (big blind) folded on the Flop
Seat 2: Osmontaneiro17 folded before Flop (didn't bet)
Seat 3: VahTang_89 folded before Flop (didn't bet)
Seat 5: Supermegopro (button) collected ($6.18)
Seat 6: MrP1usovoy (small blind) folded before Flop



PokerStars Hand #254587760912:  Hold'em No Limit ($0.50/$1.00 USD) - 2025/01/27 23:57:51 WET [2025/01/27 18:57:51 ET]
Table 'Medusa IV' 6-max Seat #6 is the button
Seat 4: andutu34 ($224.07 in chips) is sitting out
Seat 1: BGS013 ($100 in chips) 
Seat 2: Osmontaneiro17 ($174.66 in chips) 
Seat 3: VahTang_89 ($140.90 in chips) 
Seat 5: Supermegopro ($103.18 in chips) 
Seat 6: MrP1usovoy ($102.42 in chips) 
BGS013: posts small blind $0.50
Osmontaneiro17: posts big blind $1
andutu34: sits out 
*** HOLE CARDS ***
VahTang_89: folds 
Supermegopro: folds 
MrP1usovoy: raises $1.50 to $2.50
BGS013: raises $8.50 to $11
Osmontaneiro17: folds 
MrP1usovoy: folds 
Uncalled bet ($8.50) returned to BGS013
BGS013 collected $6 from pot
BGS013: doesn't show hand 
*** SUMMARY ***
Total pot $6 | Rake $0 
Seat 4: andutu34
Seat 1: BGS013 (small blind) collected ($6)
Seat 2: Osmontaneiro17 (big blind) folded before Flop
Seat 3: VahTang_89 folded before Flop (didn't bet)
Seat 5: Supermegopro folded before Flop (didn't bet)
Seat 6: MrP1usovoy (button) folded before Flop



PokerStars Hand #254587766191:  Hold'em No Limit ($0.50/$1.00 USD) - 2025/01/27 23:58:23 WET [2025/01/27 18:58:23 ET]
Table 'Medusa IV' 6-max Seat #1 is the button
Seat 4: andutu34 ($224.07 in chips) is sitting out
Seat 1: BGS013 ($103.50 in chips) 
Seat 2: Osmontaneiro17 ($173.66 in chips) 
Seat 3: VahTang_89 ($140.90 in chips) 
Seat 5: Supermegopro ($103.18 in chips) 
Seat 6: MrP1usovoy ($100 in chips) 
Osmontaneiro17: posts small blind $0.50
VahTang_89: posts big blind $1
andutu34: sits out 
*** HOLE CARDS ***
Supermegopro: folds 
MrP1usovoy: folds 
BGS013: folds 
Osmontaneiro17: folds 
Uncalled bet ($0.50) returned to VahTang_89
VahTang_89 collected $1 from pot
VahTang_89: doesn't show hand 
*** SUMMARY ***
Total pot $1 | Rake $0 
Seat 4: andutu34
Seat 1: BGS013 (button) folded before Flop (didn't bet)
Seat 2: Osmontaneiro17 (small blind) folded before Flop
Seat 3: VahTang_89 (big blind) collected ($1)
Seat 5: Supermegopro folded before Flop (didn't bet)
Seat 6: MrP1usovoy folded before Flop (didn't bet)



PokerStars Hand #254587769230:  Hold'em No Limit ($0.50/$1.00 USD) - 2025/01/27 23:58:40 WET [2025/01/27 18:58:40 ET]
Table 'Medusa IV' 6-max Seat #2 is the button
Seat 1: BGS013 ($103.50 in chips) 
Seat 2: Osmontaneiro17 ($173.16 in chips) 
Seat 3: VahTang_89 ($141.40 in chips) 
Seat 4: andutu34 ($224.07 in chips) 
Seat 5: Supermegopro ($103.18 in chips) 
Seat 6: MrP1usovoy ($100 in chips) 
VahTang_89: posts small blind $0.50
andutu34: posts big blind $1
*** HOLE CARDS ***
Supermegopro: raises $1.50 to $2.50
MrP1usovoy: folds 
BGS013: folds 
Osmontaneiro17: folds 
VahTang_89: folds 
andutu34: folds 
Uncalled bet ($1.50) returned to Supermegopro
Supermegopro collected $2.50 from pot
Supermegopro: doesn't show hand 
*** SUMMARY ***
Total pot $2.50 | Rake $0 
Seat 1: BGS013 folded before Flop (didn't bet)
Seat 2: Osmontaneiro17 (button) folded before Flop (didn't bet)
Seat 3: VahTang_89 (small blind) folded before Flop
Seat 4: andutu34 (big blind) folded before Flop
Seat 5: Supermegopro collected ($2.50)
Seat 6: MrP1usovoy folded before Flop (didn't bet)



PokerStars Hand #254587772512:  Hold'em No Limit ($0.50/$1.00 USD) - 2025/01/27 23:58:58 WET [2025/01/27 18:58:58 ET]
Table 'Medusa IV' 6-max Seat #3 is the button
Seat 1: BGS013 ($103.50 in chips) 
Seat 2: Osmontaneiro17 ($173.16 in chips) 
Seat 3: VahTang_89 ($140.90 in chips) 
Seat 4: andutu34 ($223.07 in chips) 
Seat 5: Supermegopro ($104.68 in chips) 
Seat 6: MrP1usovoy ($100 in chips) 
andutu34: posts small blind $0.50
Supermegopro: posts big blind $1
*** HOLE CARDS ***
MrP1usovoy: folds 
BGS013: folds 
Osmontaneiro17: folds 
VahTang_89: folds 
andutu34: folds 
Uncalled bet ($0.50) returned to Supermegopro
Supermegopro collected $1 from pot
Supermegopro: doesn't show hand 
*** SUMMARY ***
Total pot $1 | Rake $0 
Seat 1: BGS013 folded before Flop (didn't bet)
Seat 2: Osmontaneiro17 folded before Flop (didn't bet)
Seat 3: VahTang_89 (button) folded before Flop (didn't bet)
Seat 4: andutu34 (small blind) folded before Flop
Seat 5: Supermegopro (big blind) collected ($1)
Seat 6: MrP1usovoy folded before Flop (didn't bet)



PokerStars Hand #254587776038:  Hold'em No Limit ($0.50/$1.00 USD) - 2025/01/27 23:59:18 WET [2025/01/27 18:59:18 ET]
Table 'Medusa IV' 6-max Seat #4 is the button
Seat 1: BGS013 ($103.50 in chips) 
Seat 2: Osmontaneiro17 ($173.16 in chips) 
Seat 3: VahTang_89 ($140.90 in chips) 
Seat 4: andutu34 ($222.57 in chips) 
Seat 5: Supermegopro ($105.18 in chips) 
Seat 6: MrP1usovoy ($100 in chips) 
Supermegopro: posts small blind $0.50
MrP1usovoy: posts big blind $1
*** HOLE CARDS ***
BGS013: folds 
Osmontaneiro17: folds 
VahTang_89: folds 
andutu34: folds 
Supermegopro: raises $2 to $3
MrP1usovoy: folds 
Uncalled bet ($2) returned to Supermegopro
Supermegopro collected $2 from pot
Supermegopro: doesn't show hand 
*** SUMMARY ***
Total pot $2 | Rake $0 
Seat 1: BGS013 folded before Flop (didn't bet)
Seat 2: Osmontaneiro17 folded before Flop (didn't bet)
Seat 3: VahTang_89 folded before Flop (didn't bet)
Seat 4: andutu34 (button) folded before Flop (didn't bet)
Seat 5: Supermegopro (small blind) collected ($2)
Seat 6: MrP1usovoy (big blind) folded before Flop



PokerStars Hand #254587778520:  Hold'em No Limit ($0.50/$1.00 USD) - 2025/01/27 23:59:32 WET [2025/01/27 18:59:32 ET]
Table 'Medusa IV' 6-max Seat #5 is the button
Seat 1: BGS013 ($103.50 in chips) 
Seat 2: Osmontaneiro17 ($173.16 in chips) 
Seat 3: VahTang_89 ($140.90 in chips) 
Seat 4: andutu34 ($222.57 in chips) 
Seat 5: Supermegopro ($106.18 in chips) 
Seat 6: MrP1usovoy ($100 in chips) 
MrP1usovoy: posts small blind $0.50
BGS013: posts big blind $1
*** HOLE CARDS ***
Osmontaneiro17: folds 
VahTang_89: folds 
andutu34: folds 
Supermegopro: folds 
MrP1usovoy: raises $2 to $3
BGS013: raises $6.50 to $9.50
MrP1usovoy: folds 
Uncalled bet ($6.50) returned to BGS013
BGS013 collected $6 from pot
BGS013: doesn't show hand 
*** SUMMARY ***
Total pot $6 | Rake $0 
Seat 1: BGS013 (big blind) collected ($6)
Seat 2: Osmontaneiro17 folded before Flop (didn't bet)
Seat 3: VahTang_89 folded before Flop (didn't bet)
Seat 4: andutu34 folded before Flop (didn't bet)
Seat 5: Supermegopro (button) folded before Flop (didn't bet)
Seat 6: MrP1usovoy (small blind) folded before Flop



PokerStars Hand #254587782784:  Hold'em No Limit ($0.50/$1.00 USD) - 2025/01/27 23:59:57 WET [2025/01/27 18:59:57 ET]
Table 'Medusa IV' 6-max Seat #6 is the button
Seat 1: BGS013 ($106.50 in chips) 
Seat 2: Osmontaneiro17 ($173.16 in chips) 
Seat 3: VahTang_89 ($140.90 in chips) 
Seat 4: andutu34 ($222.57 in chips) 
Seat 5: Supermegopro ($106.18 in chips) 
Seat 6: MrP1usovoy ($100 in chips) 
BGS013: posts small blind $0.50
Osmontaneiro17: posts big blind $1
*** HOLE CARDS ***
VahTang_89: folds 
andutu34: folds 
Supermegopro: folds 
MrP1usovoy: folds 
BGS013: folds 
Uncalled bet ($0.50) returned to Osmontaneiro17
Osmontaneiro17 collected $1 from pot
*** SUMMARY ***
Total pot $1 | Rake $0 
Seat 1: BGS013 (small blind) folded before Flop
Seat 2: Osmontaneiro17 (big blind) collected ($1)
Seat 3: VahTang_89 folded before Flop (didn't bet)
Seat 4: andutu34 folded before Flop (didn't bet)
Seat 5: Supermegopro folded before Flop (didn't bet)
Seat 6: MrP1usovoy (button) folded before Flop (didn't bet)



PokerStars Hand #254587786022:  Hold'em No Limit ($0.50/$1.00 USD) - 2025/01/27 0:00:15 WET [2025/01/27 19:00:15 ET]
Table 'Medusa IV' 6-max Seat #1 is the button
Seat 1: BGS013 ($106 in chips) 
Seat 2: Osmontaneiro17 ($173.66 in chips) 
Seat 3: VahTang_89 ($140.90 in chips) 
Seat 4: andutu34 ($222.57 in chips) 
Seat 5: Supermegopro ($106.18 in chips) 
Seat 6: MrP1usovoy ($100 in chips) 
Osmontaneiro17: posts small blind $0.50
VahTang_89: posts big blind $1
*** HOLE CARDS ***
andutu34: folds 
Supermegopro: folds 
MrP1usovoy: folds 
BGS013: raises $1.50 to $2.50
Osmontaneiro17: calls $2
VahTang_89: folds 
*** FLOP *** [5c 5h Ad]
Osmontaneiro17: checks 
BGS013: bets $1.48
Osmontaneiro17: calls $1.48
*** TURN *** [5c 5h Ad] [4d]
Osmontaneiro17: checks 
BGS013: bets $6.64
Osmontaneiro17: calls $6.64
*** RIVER *** [5c 5h Ad 4d] [9d]
Osmontaneiro17: checks 
BGS013: checks 
*** SHOW DOWN ***
Osmontaneiro17: shows [4s 5d] (a full house, Fives full of Fours)
BGS013: mucks hand 
Osmontaneiro17 collected $21.13 from pot
*** SUMMARY ***
Total pot $22.24 | Rake $1.11 
Board [5c 5h Ad 4d 9d]
Seat 1: BGS013 (button) mucked
Seat 2: Osmontaneiro17 (small blind) showed [4s 5d] and won ($21.13) with a full house, Fives full of Fours
Seat 3: VahTang_89 (big blind) folded before Flop
Seat 4: andutu34 folded before Flop (didn't bet)
Seat 5: Supermegopro folded before Flop (didn't bet)
Seat 6: MrP1usovoy folded before Flop (didn't bet)



PokerStars Hand #254587797321:  Hold'em No Limit ($0.50/$1.00 USD) - 2025/01/27 0:01:13 WET [2025/01/27 19:01:13 ET]
Table 'Medusa IV' 6-max Seat #2 is the button
Seat 1: BGS013 ($100 in chips) 
Seat 2: Osmontaneiro17 ($184.17 in chips) 
Seat 3: VahTang_89 ($139.90 in chips) 
Seat 4: andutu34 ($222.57 in chips) 
Seat 5: Supermegopro ($106.18 in chips) 
Seat 6: MrP1usovoy ($100 in chips) 
VahTang_89: posts small blind $0.50
andutu34: posts big blind $1
*** HOLE CARDS ***
Supermegopro: folds 
MrP1usovoy: calls $1
BGS013: folds 
Osmontaneiro17: raises $1 to $2
VahTang_89: folds 
andutu34: calls $1
MrP1usovoy: raises $10 to $12
Osmontaneiro17: folds 
andutu34: folds 
Uncalled bet ($10) returned to MrP1usovoy
MrP1usovoy collected $6.50 from pot
MrP1usovoy: doesn't show hand 
*** SUMMARY ***
Total pot $6.50 | Rake $0 
Seat 1: BGS013 folded before Flop (didn't bet)
Seat 2: Osmontaneiro17 (button) folded before Flop
Seat 3: VahTang_89 (small blind) folded before Flop
Seat 4: andutu34 (big blind) folded before Flop
Seat 5: Supermegopro folded before Flop (didn't bet)
Seat 6: MrP1usovoy collected ($6.50)



PokerStars Hand #254587804878:  Hold'em No Limit ($0.50/$1.00 USD) - 2025/01/27 0:01:49 WET [2025/01/27 19:01:49 ET]
Table 'Medusa IV' 6-max Seat #3 is the button
Seat 1: BGS013 ($100 in chips) 
Seat 2: Osmontaneiro17 ($182.17 in chips) 
Seat 3: VahTang_89 ($139.40 in chips) 
Seat 4: andutu34 ($220.57 in chips) 
Seat 5: Supermegopro ($106.18 in chips) 
Seat 6: MrP1usovoy ($104.50 in chips) 
andutu34: posts small blind $0.50
Supermegopro: posts big blind $1
*** HOLE CARDS ***
MrP1usovoy: folds 
BGS013: raises $1 to $2
Osmontaneiro17: raises $6 to $8
VahTang_89: folds 
andutu34: folds 
Supermegopro: folds 
BGS013: calls $6
*** FLOP *** [Ks 3c 8d]
BGS013: checks 
Osmontaneiro17: bets $8
BGS013: folds 
Uncalled bet ($8) returned to Osmontaneiro17
Osmontaneiro17 collected $16.62 from pot
*** SUMMARY ***
Total pot $17.50 | Rake $0.88 
Board [Ks 3c 8d]
Seat 1: BGS013 folded on the Flop
Seat 2: Osmontaneiro17 collected ($16.62)
Seat 3: VahTang_89 (button) folded before Flop (didn't bet)
Seat 4: andutu34 (small blind) folded before Flop
Seat 5: Supermegopro (big blind) folded before Flop
Seat 6: MrP1usovoy folded before Flop (didn't bet)



PokerStars Hand #254587813362:  Hold'em No Limit ($0.50/$1.00 USD) - 2025/01/27 0:02:28 WET [2025/01/27 19:02:28 ET]
Table 'Medusa IV' 6-max Seat #4 is the button
Seat 1: BGS013 ($100 in chips) 
Seat 2: Osmontaneiro17 ($190.79 in chips) 
Seat 3: VahTang_89 ($139.40 in chips) 
Seat 4: andutu34 ($220.07 in chips) 
Seat 5: Supermegopro ($105.18 in chips) 
Seat 6: MrP1usovoy ($104.50 in chips) 
Supermegopro: posts small blind $0.50
MrP1usovoy: posts big blind $1
*** HOLE CARDS ***
BGS013: folds 
Osmontaneiro17: raises $2 to $3
VahTang_89: folds 
andutu34: folds 
Supermegopro: folds 
MrP1usovoy: folds 
Uncalled bet ($2) returned to Osmontaneiro17
Osmontaneiro17 collected $2.50 from pot
*** SUMMARY ***
Total pot $2.50 | Rake $0 
Seat 1: BGS013 folded before Flop (didn't bet)
Seat 2: Osmontaneiro17 collected ($2.50)
Seat 3: VahTang_89 folded before Flop (didn't bet)
Seat 4: andutu34 (button) folded before Flop (didn't bet)
Seat 5: Supermegopro (small blind) folded before Flop
Seat 6: MrP1usovoy (big blind) folded before Flop



PokerStars Hand #254587816789:  Hold'em No Limit ($0.50/$1.00 USD) - 2025/01/27 0:02:44 WET [2025/01/27 19:02:44 ET]
Table 'Medusa IV' 6-max Seat #5 is the button
Seat 1: BGS013 ($100 in chips) 
Seat 2: Osmontaneiro17 ($192.29 in chips) 
Seat 3: VahTang_89 ($139.40 in chips) 
Seat 4: andutu34 ($220.07 in chips) 
Seat 5: Supermegopro ($104.68 in chips) 
Seat 6: MrP1usovoy ($103.50 in chips) 
MrP1usovoy: posts small blind $0.50
BGS013: posts big blind $1
*** HOLE CARDS ***
Osmontaneiro17: raises $1 to $2
VahTang_89: folds 
andutu34: folds 
Supermegopro: folds 
MrP1usovoy: folds 
BGS013: calls $1
*** FLOP *** [2s 4d 2h]
BGS013: checks 
Osmontaneiro17: checks 
*** TURN *** [2s 4d 2h] [9c]
BGS013: bets $1.11
Osmontaneiro17: raises $4.89 to $6
BGS013: folds 
Uncalled bet ($4.89) returned to Osmontaneiro17
Osmontaneiro17 collected $6.38 from pot
*** SUMMARY ***
Total pot $6.72 | Rake $0.34 
Board [2s 4d 2h 9c]
Seat 1: BGS013 (big blind) folded on the Turn
Seat 2: Osmontaneiro17 collected ($6.38)
Seat 3: VahTang_89 folded before Flop (didn't bet)
Seat 4: andutu34 folded before Flop (didn't bet)
Seat 5: Supermegopro (button) folded before Flop (didn't bet)
Seat 6: MrP1usovoy (small blind) folded before Flop



PokerStars Hand #254587828923:  Hold'em No Limit ($0.50/$1.00 USD) - 2025/01/27 0:03:39 WET [2025/01/27 19:03:39 ET]
Table 'Medusa IV' 6-max Seat #6 is the button
Seat 1: BGS013 ($100 in chips) 
Seat 2: Osmontaneiro17 ($195.56 in chips) 
Seat 3: VahTang_89 ($139.40 in chips) 
Seat 4: andutu34 ($220.07 in chips) 
Seat 5: Supermegopro ($104.68 in chips) 
Seat 6: MrP1usovoy ($103 in chips) 
BGS013: posts small blind $0.50
Osmontaneiro17: posts big blind $1
*** HOLE CARDS ***
VahTang_89: folds 
andutu34: folds 
Supermegopro: raises $1.50 to $2.50
MrP1usovoy: folds 
BGS013: folds 
Osmontaneiro17: calls $1.50
*** FLOP *** [3s 7s Kh]
Osmontaneiro17: checks 
Supermegopro: bets $1.72
Osmontaneiro17: calls $1.72
*** TURN *** [3s 7s Kh] [7h]
Osmontaneiro17: checks 
Supermegopro: bets $2.80
Osmontaneiro17: raises $6.20 to $9
Supermegopro: folds 
Uncalled bet ($6.20) returned to Osmontaneiro17
Osmontaneiro17 collected $13.81 from pot
*** SUMMARY ***
Total pot $14.54 | Rake $0.73 
Board [3s 7s Kh 7h]
Seat 1: BGS013 (small blind) folded before Flop
Seat 2: Osmontaneiro17 (big blind) collected ($13.81)
Seat 3: VahTang_89 folded before Flop (didn't bet)
Seat 4: andutu34 folded before Flop (didn't bet)
Seat 5: Supermegopro folded on the Turn
Seat 6: MrP1usovoy (button) folded before Flop (didn't bet)



PokerStars Hand #254587836864:  Hold'em No Limit ($0.50/$1.00 USD) - 2025/01/27 0:04:15 WET [2025/01/27 19:04:15 ET]
Table 'Medusa IV' 6-max Seat #1 is the button
Seat 1: BGS013 ($100 in chips) 
Seat 2: Osmontaneiro17 ($202.35 in chips) 
Seat 3: VahTang_89 ($139.40 in chips) 
Seat 4: andutu34 ($220.07 in chips) 
Seat 5: Supermegopro ($100 in chips) 
Seat 6: MrP1usovoy ($103 in chips) 
Osmontaneiro17: posts small blind $0.50
VahTang_89: posts big blind $1
*** HOLE CARDS ***
andutu34: folds 
Supermegopro: folds 
MrP1usovoy: raises $1.50 to $2.50
BGS013: folds 
Osmontaneiro17: calls $2
VahTang_89: folds 
*** FLOP *** [Ac Th 7h]
Osmontaneiro17: checks 
MrP1usovoy: bets $1.50
Osmontaneiro17: calls $1.50
*** TURN *** [Ac Th 7h] [8s]
Osmontaneiro17: checks 
MrP1usovoy: checks 
*** RIVER *** [Ac Th 7h 8s] [7c]
Osmontaneiro17: checks 
MrP1usovoy: bets $2.82
Osmontaneiro17: calls $2.82
*** SHOW DOWN ***
MrP1usovoy: shows [Td Ks] (two pair, Tens and Sevens)
Osmontaneiro17: shows [Tc Qc] (two pair, Tens and Sevens)
Osmontaneiro17 collected $6.96 from pot
MrP1usovoy collected $6.95 from pot
*** SUMMARY ***
Total pot $14.64 | Rake $0.73 
Board [Ac Th 7h 8s 7c]
Seat 1: BGS013 (button) folded before Flop (didn't bet)
Seat 2: Osmontaneiro17 (small blind) showed [Tc Qc] and won ($6.96) with two pair, Tens and Sevens
Seat 3: VahTang_89 (big blind) folded before Flop
Seat 4: andutu34 folded before Flop (didn't bet)
Seat 5: Supermegopro folded before Flop (didn't bet)
Seat 6: MrP1usovoy showed [Td Ks] and won ($6.95) with two pair, Tens and Sevens



PokerStars Hand #254587845655:  Hold'em No Limit ($0.50/$1.00 USD) - 2025/01/27 0:04:55 WET [2025/01/27 19:04:55 ET]
Table 'Medusa IV' 6-max Seat #2 is the button
Seat 1: BGS013 ($100 in chips) 
Seat 2: Osmontaneiro17 ($202.49 in chips) 
Seat 3: VahTang_89 ($138.40 in chips) 
Seat 4: andutu34 ($220.07 in chips) 
Seat 5: Supermegopro ($100 in chips) 
Seat 6: MrP1usovoy ($103.13 in chips) 
VahTang_89: posts small blind $0.50
andutu34: posts big blind $1
*** HOLE CARDS ***
Supermegopro: folds 
MrP1usovoy: folds 
BGS013: raises $1.50 to $2.50
Osmontaneiro17: calls $2.50
VahTang_89: calls $2
andutu34: folds 
*** FLOP *** [Qc Ad 6s]
VahTang_89: checks 
BGS013: checks 
Osmontaneiro17: bets $4
VahTang_89: folds 
BGS013: folds 
Uncalled bet ($4) returned to Osmontaneiro17
Osmontaneiro17 collected $8.08 from pot
*** SUMMARY ***
Total pot $8.50 | Rake $0.42 
Board [Qc Ad 6s]
Seat 1: BGS013 folded on the Flop
Seat 2: Osmontaneiro17 (button) collected ($8.08)
Seat 3: VahTang_89 (small blind) folded on the Flop
Seat 4: andutu34 (big blind) folded before Flop
Seat 5: Supermegopro folded before Flop (didn't bet)
Seat 6: MrP1usovoy folded before Flop (didn't bet)



PokerStars Hand #254587852353:  Hold'em No Limit ($0.50/$1.00 USD) - 2025/01/27 0:05:26 WET [2025/01/27 19:05:26 ET]
Table 'Medusa IV' 6-max Seat #3 is the button
Seat 1: BGS013 ($100 in chips) 
Seat 2: Osmontaneiro17 ($208.07 in chips) 
Seat 3: VahTang_89 ($135.90 in chips) 
Seat 4: andutu34 ($219.07 in chips) 
Seat 5: Supermegopro ($100 in chips) 
Seat 6: MrP1usovoy ($103.13 in chips) 
andutu34: posts small blind $0.50
Supermegopro: posts big blind $1
*** HOLE CARDS ***
MrP1usovoy: folds 
BGS013: folds 
Osmontaneiro17: raises $2 to $3
VahTang_89: folds 
andutu34: folds 
Supermegopro: folds 
Uncalled bet ($2) returned to Osmontaneiro17
Osmontaneiro17 collected $2.50 from pot
*** SUMMARY ***
Total pot $2.50 | Rake $0 
Seat 1: BGS013 folded before Flop (didn't bet)
Seat 2: Osmontaneiro17 collected ($2.50)
Seat 3: VahTang_89 (button) folded before Flop (didn't bet)
Seat 4: andutu34 (small blind) folded before Flop
Seat 5: Supermegopro (big blind) folded before Flop
Seat 6: MrP1usovoy folded before Flop (didn't bet)



PokerStars Hand #254587857091:  Hold'em No Limit ($0.50/$1.00 USD) - 2025/01/27 0:05:47 WET [2025/01/27 19:05:47 ET]
Table 'Medusa IV' 6-max Seat #4 is the button
Seat 1: BGS013 ($100 in chips) 
Seat 2: Osmontaneiro17 ($209.57 in chips) 
Seat 3: VahTang_89 ($135.90 in chips) 
Seat 4: andutu34 ($218.57 in chips) 
Seat 5: Supermegopro ($100 in chips) 
Seat 6: MrP1usovoy ($103.13 in chips) 
Supermegopro: posts small blind $0.50
MrP1usovoy: posts big blind $1
*** HOLE CARDS ***
BGS013: folds 
Osmontaneiro17: raises $2 to $3
VahTang_89: folds 
andutu34: folds 
Supermegopro: folds 
MrP1usovoy: folds 
Uncalled bet ($2) returned to Osmontaneiro17
Osmontaneiro17 collected $2.50 from pot
*** SUMMARY ***
Total pot $2.50 | Rake $0 
Seat 1: BGS013 folded before Flop (didn't bet)
Seat 2: Osmontaneiro17 collected ($2.50)
Seat 3: VahTang_89 folded before Flop (didn't bet)
Seat 4: andutu34 (button) folded before Flop (didn't bet)
Seat 5: Supermegopro (small blind) folded before Flop
Seat 6: MrP1usovoy (big blind) folded before Flop



PokerStars Hand #254587861069:  Hold'em No Limit ($0.50/$1.00 USD) - 2025/01/27 0:06:05 WET [2025/01/27 19:06:05 ET]
Table 'Medusa IV' 6-max Seat #5 is the button
Seat 1: BGS013 ($100 in chips) 
Seat 2: Osmontaneiro17 ($211.07 in chips) 
Seat 3: VahTang_89 ($135.90 in chips) 
Seat 4: andutu34 ($218.57 in chips) 
Seat 5: Supermegopro ($100 in chips) 
Seat 6: MrP1usovoy ($102.13 in chips) 
MrP1usovoy: posts small blind $0.50
BGS013: posts big blind $1
*** HOLE CARDS ***
Osmontaneiro17: folds 
VahTang_89: raises $1.20 to $2.20
andutu34: folds 
Supermegopro: folds 
MrP1usovoy: folds 
BGS013: folds 
Uncalled bet ($1.20) returned to VahTang_89
VahTang_89 collected $2.50 from pot
VahTang_89: doesn't show hand 
*** SUMMARY ***
Total pot $2.50 | Rake $0 
Seat 1: BGS013 (big blind) folded before Flop
Seat 2: Osmontaneiro17 folded before Flop (didn't bet)
Seat 3: VahTang_89 collected ($2.50)
Seat 4: andutu34 folded before Flop (didn't bet)
Seat 5: Supermegopro (button) folded before Flop (didn't bet)
Seat 6: MrP1usovoy (small blind) folded before Flop



PokerStars Hand #254587865168:  Hold'em No Limit ($0.50/$1.00 USD) - 2025/01/27 0:06:24 WET [2025/01/27 19:06:24 ET]
Table 'Medusa IV' 6-max Seat #6 is the button
Seat 1: BGS013 ($100 in chips) 
Seat 2: Osmontaneiro17 ($211.07 in chips) 
Seat 3: VahTang_89 ($137.40 in chips) 
Seat 4: andutu34 ($218.57 in chips) 
Seat 5: Supermegopro ($100 in chips) 
Seat 6: MrP1usovoy ($101.63 in chips) 
BGS013: posts small blind $0.50
Osmontaneiro17: posts big blind $1
*** HOLE CARDS ***
VahTang_89: folds 
andutu34: folds 
Supermegopro: folds 
MrP1usovoy: raises $1.50 to $2.50
BGS013: folds 
Osmontaneiro17: folds 
Uncalled bet ($1.50) returned to MrP1usovoy
MrP1usovoy collected $2.50 from pot
MrP1usovoy: doesn't show hand 
*** SUMMARY ***
Total pot $2.50 | Rake $0 
Seat 1: BGS013 (small blind) folded before Flop
Seat 2: Osmontaneiro17 (big blind) folded before Flop
Seat 3: VahTang_89 folded before Flop (didn't bet)
Seat 4: andutu34 folded before Flop (didn't bet)
Seat 5: Supermegopro folded before Flop (didn't bet)
Seat 6: MrP1usovoy (button) collected ($2.50)



PokerStars Hand #254587456119:  Hold'em No Limit ($0.50/$1.00 USD) - 2025/01/27 23:35:38 WET [2025/01/27 18:35:38 ET]
Table 'Medusa IV' 6-max Seat #5 is the button
Seat 1: elcutez ($121.64 in chips) 
Seat 2: Osmontaneiro17 ($80.50 in chips) 
Seat 3: VahTang_89 ($150.90 in chips) 
Seat 4: andutu34 ($111.50 in chips) 
Seat 5: Supermegopro ($100 in chips) 
Seat 6: Unipoker11 ($104.74 in chips) 
Unipoker11: posts small blind $0.50
elcutez: posts big blind $1
*** HOLE CARDS ***
Osmontaneiro17: raises $2 to $3
VahTang_89: folds 
andutu34: folds 
Supermegopro: folds 
Unipoker11: folds 
elcutez: folds 
Uncalled bet ($2) returned to Osmontaneiro17
Osmontaneiro17 collected $2.50 from pot
*** SUMMARY ***
Total pot $2.50 | Rake $0 
Seat 1: elcutez (big blind) folded before Flop
Seat 2: Osmontaneiro17 collected ($2.50)
Seat 3: VahTang_89 folded before Flop (didn't bet)
Seat 4: andutu34 folded before Flop (didn't bet)
Seat 5: Supermegopro (button) folded before Flop (didn't bet)
Seat 6: Unipoker11 (small blind) folded before Flop



PokerStars Hand #254587460979:  Hold'em No Limit ($0.50/$1.00 USD) - 2025/01/27 23:35:58 WET [2025/01/27 18:35:58 ET]
Table 'Medusa IV' 6-max Seat #6 is the button
Seat 1: elcutez ($120.64 in chips) 
Seat 2: Osmontaneiro17 ($82 in chips) 
Seat 3: VahTang_89 ($150.90 in chips) 
Seat 4: andutu34 ($111.50 in chips) 
Seat 5: Supermegopro ($100 in chips) 
Seat 6: Unipoker11 ($104.24 in chips) 
elcutez: posts small blind $0.50
Osmontaneiro17: posts big blind $1
*** HOLE CARDS ***
VahTang_89: folds 
andutu34: folds 
Supermegopro: raises $1.50 to $2.50
Unipoker11: folds 
elcutez: folds 
Osmontaneiro17: folds 
Uncalled bet ($1.50) returned to Supermegopro
Supermegopro collected $2.50 from pot
Supermegopro: doesn't show hand 
*** SUMMARY ***
Total pot $2.50 | Rake $0 
Seat 1: elcutez (small blind) folded before Flop
Seat 2: Osmontaneiro17 (big blind) folded before Flop
Seat 3: VahTang_89 folded before Flop (didn't bet)
Seat 4: andutu34 folded before Flop (didn't bet)
Seat 5: Supermegopro collected ($2.50)
Seat 6: Unipoker11 (button) folded before Flop (didn't bet)



PokerStars Hand #254587464184:  Hold'em No Limit ($0.50/$1.00 USD) - 2025/01/27 23:36:11 WET [2025/01/27 18:36:11 ET]
Table 'Medusa IV' 6-max Seat #1 is the button
Seat 1: elcutez ($120.14 in chips) 
Seat 2: Osmontaneiro17 ($81 in chips) 
Seat 3: VahTang_89 ($150.90 in chips) 
Seat 4: andutu34 ($111.50 in chips) 
Seat 5: Supermegopro ($101.50 in chips) 
Seat 6: Unipoker11 ($104.24 in chips) 
Osmontaneiro17: posts small blind $0.50
VahTang_89: posts big blind $1
*** HOLE CARDS ***
andutu34: folds 
Supermegopro: folds 
Unipoker11: raises $1.30 to $2.30
elcutez: folds 
Osmontaneiro17: calls $1.80
VahTang_89: folds 
*** FLOP *** [6h 5c Js]
Osmontaneiro17: checks 
Unipoker11: bets $1.33
Osmontaneiro17: calls $1.33
*** TURN *** [6h 5c Js] [Kd]
Osmontaneiro17: checks 
Unipoker11: checks 
*** RIVER *** [6h 5c Js Kd] [8d]
Osmontaneiro17: bets $7
Unipoker11: calls $7
*** SHOW DOWN ***
Osmontaneiro17: shows [Ah 4h] (high card Ace)
Unipoker11: shows [5s Ac] (a pair of Fives)
Unipoker11 collected $21.15 from pot
*** SUMMARY ***
Total pot $22.26 | Rake $1.11 
Board [6h 5c Js Kd 8d]
Seat 1: elcutez (button) folded before Flop (didn't bet)
Seat 2: Osmontaneiro17 (small blind) showed [Ah 4h] and lost with high card Ace
Seat 3: VahTang_89 (big blind) folded before Flop
Seat 4: andutu34 folded before Flop (didn't bet)
Seat 5: Supermegopro folded before Flop (didn't bet)
Seat 6: Unipoker11 showed [5s Ac] and won ($21.15) with a pair of Fives



PokerStars Hand #254587477986:  Hold'em No Limit ($0.50/$1.00 USD) - 2025/01/27 23:37:06 WET [2025/01/27 18:37:06 ET]
Table 'Medusa IV' 6-max Seat #2 is the button
Seat 1: elcutez ($120.14 in chips) 
Seat 2: Osmontaneiro17 ($70.37 in chips) 
Seat 3: VahTang_89 ($149.90 in chips) 
Seat 4: andutu34 ($111.50 in chips) 
Seat 5: Supermegopro ($101.50 in chips) 
Seat 6: Unipoker11 ($114.76 in chips) 
VahTang_89: posts small blind $0.50
andutu34: posts big blind $1
*** HOLE CARDS ***
Supermegopro: folds 
Unipoker11: folds 
elcutez: folds 
Osmontaneiro17: raises $2 to $3
VahTang_89: folds 
andutu34: folds 
Uncalled bet ($2) returned to Osmontaneiro17
Osmontaneiro17 collected $2.50 from pot
*** SUMMARY ***
Total pot $2.50 | Rake $0 
Seat 1: elcutez folded before Flop (didn't bet)
Seat 2: Osmontaneiro17 (button) collected ($2.50)
Seat 3: VahTang_89 (small blind) folded before Flop
Seat 4: andutu34 (big blind) folded before Flop
Seat 5: Supermegopro folded before Flop (didn't bet)
Seat 6: Unipoker11 folded before Flop (didn't bet)



PokerStars Hand #254587488765:  Hold'em No Limit ($0.50/$1.00 USD) - 2025/01/27 23:37:50 WET [2025/01/27 18:37:50 ET]
Table 'Medusa IV' 6-max Seat #3 is the button
Seat 1: elcutez ($120.14 in chips) 
Seat 2: Osmontaneiro17 ($71.87 in chips) 
Seat 3: VahTang_89 ($149.40 in chips) 
Seat 4: andutu34 ($110.50 in chips) 
Seat 5: Supermegopro ($101.50 in chips) 
Seat 6: Unipoker11 ($114.76 in chips) 
andutu34: posts small blind $0.50
Supermegopro: posts big blind $1
*** HOLE CARDS ***
Unipoker11: folds 
elcutez: folds 
Osmontaneiro17: raises $1 to $2
VahTang_89: folds 
andutu34: folds 
Supermegopro: folds 
Uncalled bet ($1) returned to Osmontaneiro17
Osmontaneiro17 collected $2.50 from pot
*** SUMMARY ***
Total pot $2.50 | Rake $0 
Seat 1: elcutez folded before Flop (didn't bet)
Seat 2: Osmontaneiro17 collected ($2.50)
Seat 3: VahTang_89 (button) folded before Flop (didn't bet)
Seat 4: andutu34 (small blind) folded before Flop
Seat 5: Supermegopro (big blind) folded before Flop
Seat 6: Unipoker11 folded before Flop (didn't bet)



PokerStars Hand #254587493392:  Hold'em No Limit ($0.50/$1.00 USD) - 2025/01/27 23:38:09 WET [2025/01/27 18:38:09 ET]
Table 'Medusa IV' 6-max Seat #4 is the button
Seat 1: elcutez ($120.14 in chips) 
Seat 2: Osmontaneiro17 ($73.37 in chips) 
Seat 3: VahTang_89 ($149.40 in chips) 
Seat 4: andutu34 ($110 in chips) 
Seat 5: Supermegopro ($100.50 in chips) 
Seat 6: Unipoker11 ($114.76 in chips) 
Supermegopro: posts small blind $0.50
Unipoker11: posts big blind $1
*** HOLE CARDS ***
elcutez: raises $1.80 to $2.80
Osmontaneiro17: folds 
VahTang_89: folds 
andutu34: folds 
Supermegopro: folds 
Unipoker11: folds 
Uncalled bet ($1.80) returned to elcutez
elcutez collected $2.50 from pot
*** SUMMARY ***
Total pot $2.50 | Rake $0 
Seat 1: elcutez collected ($2.50)
Seat 2: Osmontaneiro17 folded before Flop (didn't bet)
Seat 3: VahTang_89 folded before Flop (didn't bet)
Seat 4: andutu34 (button) folded before Flop (didn't bet)
Seat 5: Supermegopro (small blind) folded before Flop
Seat 6: Unipoker11 (big blind) folded before Flop



PokerStars Hand #254587497204:  Hold'em No Limit ($0.50/$1.00 USD) - 2025/01/27 23:38:25 WET [2025/01/27 18:38:25 ET]
Table 'Medusa IV' 6-max Seat #5 is the button
Seat 1: elcutez ($121.64 in chips) 
Seat 2: Osmontaneiro17 ($73.37 in chips) 
Seat 3: VahTang_89 ($149.40 in chips) 
Seat 4: andutu34 ($110 in chips) 
Seat 5: Supermegopro ($100 in chips) 
Seat 6: Unipoker11 ($113.76 in chips) 
Unipoker11: posts small blind $0.50
elcutez: posts big blind $1
*** HOLE CARDS ***
Osmontaneiro17: folds 
VahTang_89: folds 
andutu34: folds 
Supermegopro: raises $1.50 to $2.50
Unipoker11: folds 
elcutez: calls $1.50
*** FLOP *** [Qd Th 9s]
elcutez: checks 
Supermegopro: checks 
*** TURN *** [Qd Th 9s] [7c]
elcutez: bets $2.61
Supermegopro: folds 
Uncalled bet ($2.61) returned to elcutez
elcutez collected $5.22 from pot
*** SUMMARY ***
Total pot $5.50 | Rake $0.28 
Board [Qd Th 9s 7c]
Seat 1: elcutez (big blind) collected ($5.22)
Seat 2: Osmontaneiro17 folded before Flop (didn't bet)
Seat 3: VahTang_89 folded before Flop (didn't bet)
Seat 4: andutu34 folded before Flop (didn't bet)
Seat 5: Supermegopro (button) folded on the Turn
Seat 6: Unipoker11 (small blind) folded before Flop



PokerStars Hand #254587506148:  Hold'em No Limit ($0.50/$1.00 USD) - 2025/01/27 23:39:01 WET [2025/01/27 18:39:01 ET]
Table 'Medusa IV' 6-max Seat #6 is the button
Seat 1: elcutez ($124.36 in chips) 
Seat 2: Osmontaneiro17 ($73.37 in chips) 
Seat 3: VahTang_89 ($149.40 in chips) 
Seat 4: andutu34 ($110 in chips) 
Seat 5: Supermegopro ($100 in chips) 
Seat 6: Unipoker11 ($113.26 in chips) 
elcutez: posts small blind $0.50
Osmontaneiro17: posts big blind $1
*** HOLE CARDS ***
VahTang_89: folds 
andutu34: folds 
Supermegopro: folds 
Unipoker11: folds 
elcutez: raises $2 to $3
Osmontaneiro17: folds 
Uncalled bet ($2) returned to elcutez
elcutez collected $2 from pot
*** SUMMARY ***
Total pot $2 | Rake $0 
Seat 1: elcutez (small blind) collected ($2)
Seat 2: Osmontaneiro17 (big blind) folded before Flop
Seat 3: VahTang_89 folded before Flop (didn't bet)
Seat 4: andutu34 folded before Flop (didn't bet)
Seat 5: Supermegopro folded before Flop (didn't bet)
Seat 6: Unipoker11 (button) folded before Flop (didn't bet)



PokerStars Hand #254587510794:  Hold'em No Limit ($0.50/$1.00 USD) - 2025/01/27 23:39:20 WET [2025/01/27 18:39:20 ET]
Table 'Medusa IV' 6-max Seat #1 is the button
Seat 1: elcutez ($125.36 in chips) 
Seat 2: Osmontaneiro17 ($72.37 in chips) 
Seat 3: VahTang_89 ($149.40 in chips) 
Seat 4: andutu34 ($110 in chips) 
Seat 5: Supermegopro ($100 in chips) 
Seat 6: Unipoker11 ($113.26 in chips) 
Osmontaneiro17: posts small blind $0.50
VahTang_89: posts big blind $1
*** HOLE CARDS ***
andutu34: raises $1 to $2
Supermegopro: calls $2
Unipoker11: folds 
elcutez: calls $2
Osmontaneiro17: raises $9 to $11
VahTang_89: folds 
andutu34: folds 
Supermegopro: folds 
elcutez: calls $9
*** FLOP *** [Tc 4c 9h]
Osmontaneiro17: bets $11.54
elcutez: folds 
Uncalled bet ($11.54) returned to Osmontaneiro17
Osmontaneiro17 collected $25.65 from pot
*** SUMMARY ***
Total pot $27 | Rake $1.35 
Board [Tc 4c 9h]
Seat 1: elcutez (button) folded on the Flop
Seat 2: Osmontaneiro17 (small blind) collected ($25.65)
Seat 3: VahTang_89 (big blind) folded before Flop
Seat 4: andutu34 folded before Flop
Seat 5: Supermegopro folded before Flop
Seat 6: Unipoker11 folded before Flop (didn't bet)



PokerStars Hand #254587520508:  Hold'em No Limit ($0.50/$1.00 USD) - 2025/01/27 23:40:00 WET [2025/01/27 18:40:00 ET]
Table 'Medusa IV' 6-max Seat #2 is the button
Seat 1: elcutez ($114.36 in chips) 
Seat 2: Osmontaneiro17 ($87.02 in chips) 
Seat 3: VahTang_89 ($148.40 in chips) 
Seat 4: andutu34 ($108 in chips) 
Seat 5: Supermegopro ($100 in chips) 
Seat 6: Unipoker11 ($113.26 in chips) 
VahTang_89: posts small blind $0.50
andutu34: posts big blind $1
*** HOLE CARDS ***
Supermegopro: raises $1.50 to $2.50
Unipoker11: folds 
elcutez: folds 
Osmontaneiro17: folds 
VahTang_89: folds 
andutu34: folds 
Uncalled bet ($1.50) returned to Supermegopro
Supermegopro collected $2.50 from pot
Supermegopro: doesn't show hand 
*** SUMMARY ***
Total pot $2.50 | Rake $0 
Seat 1: elcutez folded before Flop (didn't bet)
Seat 2: Osmontaneiro17 (button) folded before Flop (didn't bet)
Seat 3: VahTang_89 (small blind) folded before Flop
Seat 4: andutu34 (big blind) folded before Flop
Seat 5: Supermegopro collected ($2.50)
Seat 6: Unipoker11 folded before Flop (didn't bet)



PokerStars Hand #254587526368:  Hold'em No Limit ($0.50/$1.00 USD) - 2025/01/27 23:40:24 WET [2025/01/27 18:40:24 ET]
Table 'Medusa IV' 6-max Seat #3 is the button
Seat 1: elcutez ($114.36 in chips) 
Seat 2: Osmontaneiro17 ($87.02 in chips) 
Seat 3: VahTang_89 ($147.90 in chips) 
Seat 4: andutu34 ($107 in chips) 
Seat 5: Supermegopro ($101.50 in chips) 
Seat 6: Unipoker11 ($113.26 in chips) 
andutu34: posts small blind $0.50
Supermegopro: posts big blind $1
*** HOLE CARDS ***
Unipoker11: folds 
elcutez: raises $2.50 to $3.50
Osmontaneiro17: folds 
VahTang_89: folds 
andutu34: folds 
Supermegopro: folds 
Uncalled bet ($2.50) returned to elcutez
elcutez collected $2.50 from pot
*** SUMMARY ***
Total pot $2.50 | Rake $0 
Seat 1: elcutez collected ($2.50)
Seat 2: Osmontaneiro17 folded before Flop (didn't bet)
Seat 3: VahTang_89 (button) folded before Flop (didn't bet)
Seat 4: andutu34 (small blind) folded before Flop
Seat 5: Supermegopro (big blind) folded before Flop
Seat 6: Unipoker11 folded before Flop (didn't bet)



PokerStars Hand #254587530538:  Hold'em No Limit ($0.50/$1.00 USD) - 2025/01/27 23:40:42 WET [2025/01/27 18:40:42 ET]
Table 'Medusa IV' 6-max Seat #4 is the button
Seat 1: elcutez ($115.86 in chips) 
Seat 2: Osmontaneiro17 ($87.02 in chips) 
Seat 3: VahTang_89 ($147.90 in chips) 
Seat 4: andutu34 ($106.50 in chips) 
Seat 5: Supermegopro ($100.50 in chips) 
Seat 6: Unipoker11 ($113.26 in chips) 
Supermegopro: posts small blind $0.50
Unipoker11: posts big blind $1
*** HOLE CARDS ***
elcutez: raises $2 to $3
Osmontaneiro17: folds 
VahTang_89: folds 
andutu34: folds 
Supermegopro: folds 
Unipoker11: folds 
Uncalled bet ($2) returned to elcutez
elcutez collected $2.50 from pot
*** SUMMARY ***
Total pot $2.50 | Rake $0 
Seat 1: elcutez collected ($2.50)
Seat 2: Osmontaneiro17 folded before Flop (didn't bet)
Seat 3: VahTang_89 folded before Flop (didn't bet)
Seat 4: andutu34 (button) folded before Flop (didn't bet)
Seat 5: Supermegopro (small blind) folded before Flop
Seat 6: Unipoker11 (big blind) folded before Flop



PokerStars Hand #254587535780:  Hold'em No Limit ($0.50/$1.00 USD) - 2025/01/27 23:41:04 WET [2025/01/27 18:41:04 ET]
Table 'Medusa IV' 6-max Seat #5 is the button
Seat 1: elcutez ($117.36 in chips) 
Seat 2: Osmontaneiro17 ($87.02 in chips) 
Seat 3: VahTang_89 ($147.90 in chips) 
Seat 4: andutu34 ($106.50 in chips) 
Seat 5: Supermegopro ($100 in chips) 
Seat 6: Unipoker11 ($112.26 in chips) 
Unipoker11: posts small blind $0.50
elcutez: posts big blind $1
*** HOLE CARDS ***
Osmontaneiro17: raises $1 to $2
VahTang_89: folds 
andutu34: folds 
Supermegopro: folds 
Unipoker11: raises $8 to $10
elcutez: folds 
Osmontaneiro17: folds 
Uncalled bet ($8) returned to Unipoker11
Unipoker11 collected $5 from pot
Unipoker11: doesn't show hand 
*** SUMMARY ***
Total pot $5 | Rake $0 
Seat 1: elcutez (big blind) folded before Flop
Seat 2: Osmontaneiro17 folded before Flop
Seat 3: VahTang_89 folded before Flop (didn't bet)
Seat 4: andutu34 folded before Flop (didn't bet)
Seat 5: Supermegopro (button) folded before Flop (didn't bet)
Seat 6: Unipoker11 (small blind) collected ($5)



PokerStars Hand #254587543589:  Hold'em No Limit ($0.50/$1.00 USD) - 2025/01/27 23:41:36 WET [2025/01/27 18:41:36 ET]
Table 'Medusa IV' 6-max Seat #6 is the button
Seat 1: elcutez ($116.36 in chips) 
Seat 2: Osmontaneiro17 ($85.02 in chips) 
Seat 3: VahTang_89 ($147.90 in chips) 
Seat 4: andutu34 ($106.50 in chips) 
Seat 5: Supermegopro ($100 in chips) 
Seat 6: Unipoker11 ($115.26 in chips) 
elcutez: posts small blind $0.50
Osmontaneiro17: posts big blind $1
*** HOLE CARDS ***
VahTang_89: folds 
andutu34: folds 
Supermegopro: folds 
Unipoker11: folds 
elcutez: folds 
Uncalled bet ($0.50) returned to Osmontaneiro17
Osmontaneiro17 collected $1 from pot
*** SUMMARY ***
Total pot $1 | Rake $0 
Seat 1: elcutez (small blind) folded before Flop
Seat 2: Osmontaneiro17 (big blind) collected ($1)
Seat 3: VahTang_89 folded before Flop (didn't bet)
Seat 4: andutu34 folded before Flop (didn't bet)
Seat 5: Supermegopro folded before Flop (didn't bet)
Seat 6: Unipoker11 (button) folded before Flop (didn't bet)



PokerStars Hand #254587546868:  Hold'em No Limit ($0.50/$1.00 USD) - 2025/01/27 23:41:50 WET [2025/01/27 18:41:50 ET]
Table 'Medusa IV' 6-max Seat #1 is the button
Seat 1: elcutez ($115.86 in chips) 
Seat 2: Osmontaneiro17 ($85.52 in chips) 
Seat 3: VahTang_89 ($147.90 in chips) 
Seat 4: andutu34 ($106.50 in chips) 
Seat 5: Supermegopro ($100 in chips) 
Seat 6: Unipoker11 ($115.26 in chips) 
Osmontaneiro17: posts small blind $0.50
VahTang_89: posts big blind $1
*** HOLE CARDS ***
andutu34: folds 
Supermegopro: raises $1.50 to $2.50
Unipoker11: folds 
elcutez: folds 
Osmontaneiro17: folds 
VahTang_89: folds 
Uncalled bet ($1.50) returned to Supermegopro
Supermegopro collected $2.50 from pot
Supermegopro: doesn't show hand 
*** SUMMARY ***
Total pot $2.50 | Rake $0 
Seat 1: elcutez (button) folded before Flop (didn't bet)
Seat 2: Osmontaneiro17 (small blind) folded before Flop
Seat 3: VahTang_89 (big blind) folded before Flop
Seat 4: andutu34 folded before Flop (didn't bet)
Seat 5: Supermegopro collected ($2.50)
Seat 6: Unipoker11 folded before Flop (didn't bet)



PokerStars Hand #254587553869:  Hold'em No Limit ($0.50/$1.00 USD) - 2025/01/27 23:42:18 WET [2025/01/27 18:42:18 ET]
Table 'Medusa IV' 6-max Seat #2 is the button
Seat 1: elcutez ($115.86 in chips) 
Seat 2: Osmontaneiro17 ($85.02 in chips) 
Seat 3: VahTang_89 ($146.90 in chips) 
Seat 4: andutu34 ($106.50 in chips) 
Seat 5: Supermegopro ($101.50 in chips) 
Seat 6: Unipoker11 ($115.26 in chips) 
VahTang_89: posts small blind $0.50
andutu34: posts big blind $1
*** HOLE CARDS ***
Supermegopro: folds 
Unipoker11: folds 
elcutez: folds 
Osmontaneiro17: raises $1 to $2
VahTang_89: calls $1.50
andutu34: calls $1
*** FLOP *** [Ts 4d Td]
VahTang_89: checks 
andutu34: checks 
Osmontaneiro17: bets $3
VahTang_89: folds 
andutu34: calls $3
*** TURN *** [Ts 4d Td] [8c]
andutu34: checks 
Osmontaneiro17: bets $10
elcutez leaves the table
andutu34: calls $10
*** RIVER *** [Ts 4d Td 8c] [Th]
BGS013 joins the table at seat #1 
Unipoker11 leaves the table
andutu34: checks 
Osmontaneiro17: bets $30
andutu34: folds 
Uncalled bet ($30) returned to Osmontaneiro17
Osmontaneiro17 collected $30.40 from pot
*** SUMMARY ***
Total pot $32 | Rake $1.60 
Board [Ts 4d Td 8c Th]
Seat 1: elcutez folded before Flop (didn't bet)
Seat 2: Osmontaneiro17 (button) collected ($30.40)
Seat 3: VahTang_89 (small blind) folded on the Flop
Seat 4: andutu34 (big blind) folded on the River
Seat 5: Supermegopro folded before Flop (didn't bet)
Seat 6: Unipoker11 folded before Flop (didn't bet)



PokerStars Hand #254587574704:  Hold'em No Limit ($0.50/$1.00 USD) - 2025/01/27 23:43:45 WET [2025/01/27 18:43:45 ET]
Table 'Medusa IV' 6-max Seat #3 is the button
Seat 1: BGS013 ($100 in chips) is sitting out
Seat 2: Osmontaneiro17 ($100.42 in chips) 
Seat 3: VahTang_89 ($144.90 in chips) 
Seat 4: andutu34 ($100 in chips) 
Seat 5: Supermegopro ($101.50 in chips) 
andutu34: posts small blind $0.50
Supermegopro: posts big blind $1
BGS013: sits out 
*** HOLE CARDS ***
Osmontaneiro17: folds 
VahTang_89: folds 
andutu34: raises $2 to $3
Supermegopro: calls $2
*** FLOP *** [Kc Qh Js]
andutu34: bets $1.43
Supermegopro: calls $1.43
*** TURN *** [Kc Qh Js] [4c]
andutu34: checks 
Supermegopro: bets $12.63
andutu34: folds 
Uncalled bet ($12.63) returned to Supermegopro
Supermegopro collected $8.42 from pot
Supermegopro: doesn't show hand 
*** SUMMARY ***
Total pot $8.86 | Rake $0.44 
Board [Kc Qh Js 4c]
Seat 1: BGS013
Seat 2: Osmontaneiro17 folded before Flop (didn't bet)
Seat 3: VahTang_89 (button) folded before Flop (didn't bet)
Seat 4: andutu34 (small blind) folded on the Turn
Seat 5: Supermegopro (big blind) collected ($8.42)



PokerStars Hand #254587586086:  Hold'em No Limit ($0.50/$1.00 USD) - 2025/01/27 23:44:34 WET [2025/01/27 18:44:34 ET]
Table 'Medusa IV' 6-max Seat #4 is the button
Seat 1: BGS013 ($100 in chips) 
Seat 2: Osmontaneiro17 ($100.42 in chips) 
Seat 3: VahTang_89 ($144.90 in chips) 
Seat 4: andutu34 ($100 in chips) 
Seat 5: Supermegopro ($105.49 in chips) 
Supermegopro: posts small blind $0.50
BGS013: posts big blind $1
*** HOLE CARDS ***
Osmontaneiro17: folds 
VahTang_89: folds 
andutu34: folds 
Supermegopro: raises $2 to $3
BGS013: calls $2
*** FLOP *** [Qd 9c As]
Supermegopro: checks 
tarif77 joins the table at seat #6 
tarif77 is disconnected 
BGS013: checks 
*** TURN *** [Qd 9c As] [3h]
Supermegopro: bets $8.55
BGS013: folds 
Uncalled bet ($8.55) returned to Supermegopro
Supermegopro collected $5.70 from pot
Supermegopro: doesn't show hand 
*** SUMMARY ***
Total pot $6 | Rake $0.30 
Board [Qd 9c As 3h]
Seat 1: BGS013 (big blind) folded on the Turn
Seat 2: Osmontaneiro17 folded before Flop (didn't bet)
Seat 3: VahTang_89 folded before Flop (didn't bet)
Seat 4: andutu34 (button) folded before Flop (didn't bet)
Seat 5: Supermegopro (small blind) collected ($5.70)



PokerStars Hand #254587868255:  Hold'em No Limit ($0.50/$1.00 USD) - 2025/01/27 0:06:38 WET [2025/01/27 19:06:38 ET]
Table 'Medusa IV' 6-max Seat #1 is the button
Seat 1: BGS013 ($100 in chips) 
Seat 2: Osmontaneiro17 ($210.07 in chips) 
Seat 3: VahTang_89 ($137.40 in chips) 
Seat 4: andutu34 ($218.57 in chips) 
Seat 5: Supermegopro ($100 in chips) 
Seat 6: MrP1usovoy ($103.13 in chips) 
Osmontaneiro17: posts small blind $0.50
VahTang_89: posts big blind $1
*** HOLE CARDS ***
andutu34: folds 
Supermegopro: raises $1.50 to $2.50
MrP1usovoy: folds 
BGS013: folds 
Osmontaneiro17: calls $2
VahTang_89: folds 
*** FLOP *** [Js 3s 8d]
Osmontaneiro17: checks 
Supermegopro: checks 
*** TURN *** [Js 3s 8d] [Qs]
Osmontaneiro17: checks 
Supermegopro: bets $11.40
Osmontaneiro17: calls $11.40
*** RIVER *** [Js 3s 8d Qs] [4d]
Osmontaneiro17: checks 
Supermegopro: checks 
*** SHOW DOWN ***
Osmontaneiro17: shows [Jh 8c] (two pair, Jacks and Eights)
Supermegopro: mucks hand 
Osmontaneiro17 collected $27.36 from pot
*** SUMMARY ***
Total pot $28.80 | Rake $1.44 
Board [Js 3s 8d Qs 4d]
Seat 1: BGS013 (button) folded before Flop (didn't bet)
Seat 2: Osmontaneiro17 (small blind) showed [Jh 8c] and won ($27.36) with two pair, Jacks and Eights
Seat 3: VahTang_89 (big blind) folded before Flop
Seat 4: andutu34 folded before Flop (didn't bet)
Seat 5: Supermegopro mucked
Seat 6: MrP1usovoy folded before Flop (didn't bet)



PokerStars Hand #254587880380:  Hold'em No Limit ($0.50/$1.00 USD) - 2025/01/27 0:07:35 WET [2025/01/27 19:07:35 ET]
Table 'Medusa IV' 6-max Seat #2 is the button
Seat 1: BGS013 ($100 in chips) 
Seat 2: Osmontaneiro17 ($223.53 in chips) 
Seat 3: VahTang_89 ($136.40 in chips) 
Seat 4: andutu34 ($218.57 in chips) 
Seat 5: Supermegopro ($100 in chips) 
Seat 6: MrP1usovoy ($103.13 in chips) 
VahTang_89: posts small blind $0.50
andutu34: posts big blind $1
*** HOLE CARDS ***
Supermegopro: folds 
MrP1usovoy: folds 
BGS013: folds 
Osmontaneiro17: folds 
VahTang_89: raises $2 to $3
andutu34: folds 
Uncalled bet ($2) returned to VahTang_89
Osmontaneiro17 leaves the table
VahTang_89 collected $2 from pot
VahTang_89: doesn't show hand 
*** SUMMARY ***
Total pot $2 | Rake $0 
Seat 1: BGS013 folded before Flop (didn't bet)
Seat 2: Osmontaneiro17 (button) folded before Flop (didn't bet)
Seat 3: VahTang_89 (small blind) collected ($2)
Seat 4: andutu34 (big blind) folded before Flop
Seat 5: Supermegopro folded before Flop (didn't bet)
Seat 6: MrP1usovoy folded before Flop (didn't bet)



PokerStars Hand #254587885206:  Hold'em No Limit ($0.50/$1.00 USD) - 2025/01/27 0:07:57 WET [2025/01/27 19:07:57 ET]
Table 'Medusa IV' 6-max Seat #3 is the button
Seat 1: BGS013 ($100 in chips) 
Seat 3: VahTang_89 ($137.40 in chips) 
Seat 4: andutu34 ($217.57 in chips) 
Seat 5: Supermegopro ($100 in chips) 
Seat 6: MrP1usovoy ($103.13 in chips) 
andutu34: posts small blind $0.50
Supermegopro: posts big blind $1
*** HOLE CARDS ***
MrP1usovoy: folds 
BGS013: folds 
VahTang_89: raises $1.20 to $2.20
andutu34: folds 
Supermegopro: folds 
Uncalled bet ($1.20) returned to VahTang_89
VahTang_89 collected $2.50 from pot
VahTang_89: doesn't show hand 
*** SUMMARY ***
Total pot $2.50 | Rake $0 
Seat 1: BGS013 folded before Flop (didn't bet)
Seat 3: VahTang_89 (button) collected ($2.50)
Seat 4: andutu34 (small blind) folded before Flop
Seat 5: Supermegopro (big blind) folded before Flop
Seat 6: MrP1usovoy folded before Flop (didn't bet)



