PokerStars Hand #254534161130:  Hold'em No Limit ($0.50/$1.00 USD) - 2025/01/24 20:12:36 WET [2025/01/24 15:12:36 ET]
Table 'Merapi IV' 6-max Seat #1 is the button
Seat 3: Supermegopro ($102 in chips) is sitting out
Seat 1: sta$igk ($100 in chips) 
Seat 2: ptolejmus ($10 in chips) 
Seat 4: aoish30 ($114.58 in chips) 
Seat 6: Gfoer ($100 in chips) 
ptolejmus: posts small blind $0.50
Supermegopro: is sitting out 
aoish30: posts big blind $1
*** HOLE CARDS ***
Gfoer: folds 
sta$igk: folds 
Supermegopro leaves the table
ptolejmus: raises $1 to $2
yassine2525 joins the table at seat #3 
yassine2525 is disconnected 
aoish30: raises $13 to $15
ptolejmus: folds 
Uncalled bet ($13) returned to aoish30
aoish30 collected $4 from pot
aoish30: doesn't show hand 
*** SUMMARY ***
Total pot $4 | Rake $0 
Seat 3: Supermegopro
Seat 1: sta$igk (button) folded before Flop (didn't bet)
Seat 2: ptolejmus (small blind) folded before Flop
Seat 4: aoish30 (big blind) collected ($4)
Seat 6: Gfoer folded before Flop (didn't bet)



PokerStars Hand #254534169632:  Hold'em No Limit ($0.50/$1.00 USD) - 2025/01/24 20:13:03 WET [2025/01/24 15:13:03 ET]
Table 'Merapi IV' 6-max Seat #2 is the button
Seat 3: yassine2525 ($13.52 in chips) is sitting out
Seat 6: Gfoer ($100 in chips) is sitting out
Seat 1: sta$igk ($100 in chips) 
Seat 2: ptolejmus ($10 in chips) 
Seat 4: aoish30 ($116.58 in chips) 
aoish30: posts small blind $0.50
Gfoer: is sitting out 
sta$igk: posts big blind $1
*** HOLE CARDS ***
Cositorto joins the table at seat #5 
ptolejmus: folds 
aoish30: raises $2 to $3
sta$igk: calls $2
*** FLOP *** [Tc Ac Jc]
aoish30: checks 
sta$igk: checks 
*** TURN *** [Tc Ac Jc] [2d]
Gfoer leaves the table
aoish30: checks 
MAO_DZEDYN_S joins the table at seat #6 
sta$igk: checks 
*** RIVER *** [Tc Ac Jc 2d] [9c]
aoish30: bets $1.88
sta$igk: folds 
Uncalled bet ($1.88) returned to aoish30
aoish30 collected $5.70 from pot
aoish30: doesn't show hand 
*** SUMMARY ***
Total pot $6 | Rake $0.30 
Board [Tc Ac Jc 2d 9c]
Seat 3: yassine2525
Seat 6: Gfoer
Seat 1: sta$igk (big blind) folded on the River
Seat 2: ptolejmus (button) folded before Flop (didn't bet)
Seat 4: aoish30 (small blind) collected ($5.70)



PokerStars Hand #254534181855:  Hold'em No Limit ($0.50/$1.00 USD) - 2025/01/24 20:13:43 WET [2025/01/24 15:13:43 ET]
Table 'Merapi IV' 6-max Seat #4 is the button
Seat 5: Cositorto ($100 in chips) is sitting out
Seat 6: MAO_DZEDYN_S ($100 in chips) is sitting out
Seat 1: sta$igk ($100 in chips) 
Seat 2: ptolejmus ($10 in chips) 
Seat 3: yassine2525 ($13.52 in chips) 
Seat 4: aoish30 ($119.28 in chips) 
sta$igk: posts small blind $0.50
ptolejmus: posts big blind $1
yassine2525: posts big blind $1
*** HOLE CARDS ***
yassine2525: checks 
aoish30: folds 
sta$igk: raises $99 to $100 and is all-in
ptolejmus: folds 
yassine2525: calls $12.52 and is all-in
Uncalled bet ($86.48) returned to sta$igk
*** FLOP *** [5d 6h Js]
*** TURN *** [5d 6h Js] [5h]
*** RIVER *** [5d 6h Js 5h] [7d]
*** SHOW DOWN ***
sta$igk: shows [Kd Ac] (a pair of Fives)
yassine2525: shows [2d 2h] (two pair, Fives and Deuces)
yassine2525 collected $27.04 from pot
*** SUMMARY ***
Total pot $28.04 | Rake $1 
Board [5d 6h Js 5h 7d]
Seat 5: Cositorto
Seat 6: MAO_DZEDYN_S
Seat 1: sta$igk (small blind) showed [Kd Ac] and lost with a pair of Fives
Seat 2: ptolejmus (big blind) folded before Flop
Seat 3: yassine2525 showed [2d 2h] and won ($27.04) with two pair, Fives and Deuces
Seat 4: aoish30 (button) folded before Flop (didn't bet)



PokerStars Hand #254534189291:  Hold'em No Limit ($0.50/$1.00 USD) - 2025/01/24 20:14:07 WET [2025/01/24 15:14:07 ET]
Table 'Merapi IV' 6-max Seat #1 is the button
Seat 5: Cositorto ($100 in chips) is sitting out
Seat 6: MAO_DZEDYN_S ($100 in chips) is sitting out
Seat 1: sta$igk ($100 in chips) 
Seat 2: ptolejmus ($10 in chips) 
Seat 3: yassine2525 ($27.04 in chips) 
Seat 4: aoish30 ($119.28 in chips) 
ptolejmus: posts small blind $0.50
yassine2525: posts big blind $1
Cositorto: sits out 
MAO_DZEDYN_S: sits out 
*** HOLE CARDS ***
aoish30: folds 
sta$igk: raises $1 to $2
ptolejmus: raises $8 to $10 and is all-in
yassine2525: folds 
sta$igk: folds 
Uncalled bet ($8) returned to ptolejmus
ptolejmus collected $5 from pot
*** SUMMARY ***
Total pot $5 | Rake $0 
Seat 5: Cositorto
Seat 6: MAO_DZEDYN_S
Seat 1: sta$igk (button) folded before Flop
Seat 2: ptolejmus (small blind) collected ($5)
Seat 3: yassine2525 (big blind) folded before Flop
Seat 4: aoish30 folded before Flop (didn't bet)



PokerStars Hand #254534195009:  Hold'em No Limit ($0.50/$1.00 USD) - 2025/01/24 20:14:26 WET [2025/01/24 15:14:26 ET]
Table 'Merapi IV' 6-max Seat #2 is the button
Seat 5: Cositorto ($100 in chips) is sitting out
Seat 6: MAO_DZEDYN_S ($100 in chips) is sitting out
Seat 1: sta$igk ($100 in chips) 
Seat 2: ptolejmus ($13 in chips) 
Seat 3: yassine2525 ($26.04 in chips) 
Seat 4: aoish30 ($119.28 in chips) 
yassine2525: posts small blind $0.50
aoish30: posts big blind $1
Cositorto: sits out 
MAO_DZEDYN_S: sits out 
*** HOLE CARDS ***
sta$igk: folds 
ptolejmus: folds 
yassine2525: raises $1 to $2
aoish30: raises $6.80 to $8.80
yassine2525: raises $17.24 to $26.04 and is all-in
aoish30: calls $17.24
*** FLOP *** [2d 4c Ah]
*** TURN *** [2d 4c Ah] [Qd]
*** RIVER *** [2d 4c Ah Qd] [Ks]
*** SHOW DOWN ***
yassine2525: shows [2c 2s] (three of a kind, Deuces)
aoish30: shows [Kd Ad] (two pair, Aces and Kings)
yassine2525 collected $51.08 from pot
*** SUMMARY ***
Total pot $52.08 | Rake $1 
Board [2d 4c Ah Qd Ks]
Seat 5: Cositorto
Seat 6: MAO_DZEDYN_S
Seat 1: sta$igk folded before Flop (didn't bet)
Seat 2: ptolejmus (button) folded before Flop (didn't bet)
Seat 3: yassine2525 (small blind) showed [2c 2s] and won ($51.08) with three of a kind, Deuces
Seat 4: aoish30 (big blind) showed [Kd Ad] and lost with two pair, Aces and Kings



PokerStars Hand #254534204709:  Hold'em No Limit ($0.50/$1.00 USD) - 2025/01/24 20:14:57 WET [2025/01/24 15:14:57 ET]
Table 'Merapi IV' 6-max Seat #3 is the button
Seat 6: MAO_DZEDYN_S ($100 in chips) is sitting out
Seat 1: sta$igk ($100 in chips) 
Seat 2: ptolejmus ($13 in chips) 
Seat 3: yassine2525 ($51.08 in chips) 
Seat 4: aoish30 ($100 in chips) 
Seat 5: Cositorto ($100 in chips) 
aoish30: posts small blind $0.50
Cositorto: posts big blind $1
MAO_DZEDYN_S: sits out 
*** HOLE CARDS ***
sta$igk: folds 
ptolejmus: folds 
yassine2525: folds 
aoish30: raises $2 to $3
Cositorto: raises $6 to $9
aoish30: calls $6
*** FLOP *** [Jd 5h Js]
aoish30: checks 
Cositorto: bets $8.55
aoish30: folds 
Uncalled bet ($8.55) returned to Cositorto
Cositorto collected $17.10 from pot
Cositorto: doesn't show hand 
*** SUMMARY ***
Total pot $18 | Rake $0.90 
Board [Jd 5h Js]
Seat 6: MAO_DZEDYN_S
Seat 1: sta$igk folded before Flop (didn't bet)
Seat 2: ptolejmus folded before Flop (didn't bet)
Seat 3: yassine2525 (button) folded before Flop (didn't bet)
Seat 4: aoish30 (small blind) folded on the Flop
Seat 5: Cositorto (big blind) collected ($17.10)



PokerStars Hand #254534217193:  Hold'em No Limit ($0.50/$1.00 USD) - 2025/01/24 20:15:37 WET [2025/01/24 15:15:37 ET]
Table 'Merapi IV' 6-max Seat #4 is the button
Seat 1: sta$igk ($100 in chips) 
Seat 2: ptolejmus ($13 in chips) 
Seat 3: yassine2525 ($51.08 in chips) 
Seat 4: aoish30 ($100 in chips) 
Seat 5: Cositorto ($108.10 in chips) 
Seat 6: MAO_DZEDYN_S ($100 in chips) 
Cositorto: posts small blind $0.50
MAO_DZEDYN_S: posts big blind $1
*** HOLE CARDS ***
sta$igk: folds 
ptolejmus: raises $1 to $2
yassine2525: calls $2
aoish30: folds 
Cositorto: folds 
MAO_DZEDYN_S: folds 
*** FLOP *** [8c 7h 3h]
ptolejmus: bets $1.41
yassine2525: raises $4.02 to $5.43
ptolejmus: folds 
Uncalled bet ($4.02) returned to yassine2525
yassine2525 collected $7.90 from pot
*** SUMMARY ***
Total pot $8.32 | Rake $0.42 
Board [8c 7h 3h]
Seat 1: sta$igk folded before Flop (didn't bet)
Seat 2: ptolejmus folded on the Flop
Seat 3: yassine2525 collected ($7.90)
Seat 4: aoish30 (button) folded before Flop (didn't bet)
Seat 5: Cositorto (small blind) folded before Flop
Seat 6: MAO_DZEDYN_S (big blind) folded before Flop



PokerStars Hand #254534229384:  Hold'em No Limit ($0.50/$1.00 USD) - 2025/01/24 20:16:17 WET [2025/01/24 15:16:17 ET]
Table 'Merapi IV' 6-max Seat #5 is the button
Seat 1: sta$igk ($100 in chips) 
Seat 2: ptolejmus ($10 in chips) 
Seat 3: yassine2525 ($55.57 in chips) 
Seat 4: aoish30 ($100 in chips) 
Seat 5: Cositorto ($107.60 in chips) 
Seat 6: MAO_DZEDYN_S ($100 in chips) 
MAO_DZEDYN_S: posts small blind $0.50
sta$igk: posts big blind $1
*** HOLE CARDS ***
ptolejmus: folds 
yassine2525: folds 
aoish30: raises $2 to $3
Cositorto: folds 
MAO_DZEDYN_S: folds 
sta$igk: folds 
Uncalled bet ($2) returned to aoish30
aoish30 collected $2.50 from pot
aoish30: doesn't show hand 
*** SUMMARY ***
Total pot $2.50 | Rake $0 
Seat 1: sta$igk (big blind) folded before Flop
Seat 2: ptolejmus folded before Flop (didn't bet)
Seat 3: yassine2525 folded before Flop (didn't bet)
Seat 4: aoish30 collected ($2.50)
Seat 5: Cositorto (button) folded before Flop (didn't bet)
Seat 6: MAO_DZEDYN_S (small blind) folded before Flop



PokerStars Hand #254534233002:  Hold'em No Limit ($0.50/$1.00 USD) - 2025/01/24 20:16:29 WET [2025/01/24 15:16:29 ET]
Table 'Merapi IV' 6-max Seat #6 is the button
Seat 1: sta$igk ($100 in chips) 
Seat 2: ptolejmus ($10 in chips) 
Seat 3: yassine2525 ($55.57 in chips) 
Seat 4: aoish30 ($101.50 in chips) 
Seat 5: Cositorto ($107.60 in chips) 
Seat 6: MAO_DZEDYN_S ($100 in chips) 
sta$igk: posts small blind $0.50
ptolejmus: posts big blind $1
*** HOLE CARDS ***
yassine2525: folds 
aoish30: folds 
Cositorto: folds 
MAO_DZEDYN_S: folds 
sta$igk: folds 
Uncalled bet ($0.50) returned to ptolejmus
ptolejmus collected $1 from pot
*** SUMMARY ***
Total pot $1 | Rake $0 
Seat 1: sta$igk (small blind) folded before Flop
Seat 2: ptolejmus (big blind) collected ($1)
Seat 3: yassine2525 folded before Flop (didn't bet)
Seat 4: aoish30 folded before Flop (didn't bet)
Seat 5: Cositorto folded before Flop (didn't bet)
Seat 6: MAO_DZEDYN_S (button) folded before Flop (didn't bet)



PokerStars Hand #254534236732:  Hold'em No Limit ($0.50/$1.00 USD) - 2025/01/24 20:16:41 WET [2025/01/24 15:16:41 ET]
Table 'Merapi IV' 6-max Seat #1 is the button
Seat 1: sta$igk ($100 in chips) 
Seat 2: ptolejmus ($10.50 in chips) 
Seat 3: yassine2525 ($55.57 in chips) 
Seat 4: aoish30 ($101.50 in chips) 
Seat 5: Cositorto ($107.60 in chips) 
Seat 6: MAO_DZEDYN_S ($100 in chips) 
ptolejmus: posts small blind $0.50
yassine2525: posts big blind $1
*** HOLE CARDS ***
aoish30: raises $1.10 to $2.10
Cositorto: folds 
MAO_DZEDYN_S: folds 
sta$igk: folds 
ptolejmus: folds 
yassine2525: calls $1.10
*** FLOP *** [Qs Ad As]
yassine2525: checks 
aoish30: bets $1.47
yassine2525: folds 
Uncalled bet ($1.47) returned to aoish30
aoish30 collected $4.46 from pot
aoish30: doesn't show hand 
*** SUMMARY ***
Total pot $4.70 | Rake $0.24 
Board [Qs Ad As]
Seat 1: sta$igk (button) folded before Flop (didn't bet)
Seat 2: ptolejmus (small blind) folded before Flop
Seat 3: yassine2525 (big blind) folded on the Flop
Seat 4: aoish30 collected ($4.46)
Seat 5: Cositorto folded before Flop (didn't bet)
Seat 6: MAO_DZEDYN_S folded before Flop (didn't bet)



PokerStars Hand #254534242186:  Hold'em No Limit ($0.50/$1.00 USD) - 2025/01/24 20:16:59 WET [2025/01/24 15:16:59 ET]
Table 'Merapi IV' 6-max Seat #2 is the button
Seat 1: sta$igk ($100 in chips) 
Seat 2: ptolejmus ($10 in chips) 
Seat 3: yassine2525 ($53.47 in chips) 
Seat 4: aoish30 ($103.86 in chips) 
Seat 5: Cositorto ($107.60 in chips) 
Seat 6: MAO_DZEDYN_S ($100 in chips) 
yassine2525: posts small blind $0.50
aoish30: posts big blind $1
*** HOLE CARDS ***
Cositorto: folds 
MAO_DZEDYN_S: folds 
sta$igk: raises $1 to $2
ptolejmus: folds 
yassine2525: calls $1.50
aoish30: calls $1
*** FLOP *** [7h 4d 5c]
yassine2525: checks 
aoish30: checks 
sta$igk: bets $2.85
yassine2525: folds 
aoish30: calls $2.85
*** TURN *** [7h 4d 5c] [6s]
aoish30: checks 
sta$igk: checks 
*** RIVER *** [7h 4d 5c 6s] [Kh]
aoish30: bets $8.34
sta$igk: calls $8.34
*** SHOW DOWN ***
aoish30: shows [Td 8d] (a straight, Four to Eight)
sta$igk: mucks hand 
aoish30 collected $26.96 from pot
*** SUMMARY ***
Total pot $28.38 | Rake $1.42 
Board [7h 4d 5c 6s Kh]
Seat 1: sta$igk mucked
Seat 2: ptolejmus (button) folded before Flop (didn't bet)
Seat 3: yassine2525 (small blind) folded on the Flop
Seat 4: aoish30 (big blind) showed [Td 8d] and won ($26.96) with a straight, Four to Eight
Seat 5: Cositorto folded before Flop (didn't bet)
Seat 6: MAO_DZEDYN_S folded before Flop (didn't bet)



PokerStars Hand #254534267382:  Hold'em No Limit ($0.50/$1.00 USD) - 2025/01/24 20:18:20 WET [2025/01/24 15:18:20 ET]
Table 'Merapi IV' 6-max Seat #3 is the button
Seat 1: sta$igk ($100 in chips) 
Seat 2: ptolejmus ($10 in chips) 
Seat 3: yassine2525 ($51.47 in chips) 
Seat 4: aoish30 ($117.63 in chips) 
Seat 5: Cositorto ($107.60 in chips) 
Seat 6: MAO_DZEDYN_S ($100 in chips) 
aoish30: posts small blind $0.50
Cositorto: posts big blind $1
*** HOLE CARDS ***
MAO_DZEDYN_S: folds 
sta$igk: folds 
ptolejmus: folds 
yassine2525: raises $1 to $2
aoish30: folds 
Cositorto: calls $1
*** FLOP *** [4s Kc 4c]
Cositorto: checks 
yassine2525: bets $2
Cositorto: folds 
Uncalled bet ($2) returned to yassine2525
yassine2525 collected $4.28 from pot
*** SUMMARY ***
Total pot $4.50 | Rake $0.22 
Board [4s Kc 4c]
Seat 1: sta$igk folded before Flop (didn't bet)
Seat 2: ptolejmus folded before Flop (didn't bet)
Seat 3: yassine2525 (button) collected ($4.28)
Seat 4: aoish30 (small blind) folded before Flop
Seat 5: Cositorto (big blind) folded on the Flop
Seat 6: MAO_DZEDYN_S folded before Flop (didn't bet)



PokerStars Hand #254534275591:  Hold'em No Limit ($0.50/$1.00 USD) - 2025/01/24 20:18:47 WET [2025/01/24 15:18:47 ET]
Table 'Merapi IV' 6-max Seat #4 is the button
Seat 1: sta$igk ($100 in chips) 
Seat 2: ptolejmus ($10 in chips) 
Seat 3: yassine2525 ($53.75 in chips) 
Seat 4: aoish30 ($117.13 in chips) 
Seat 5: Cositorto ($105.60 in chips) 
Seat 6: MAO_DZEDYN_S ($100 in chips) 
Cositorto: posts small blind $0.50
MAO_DZEDYN_S: posts big blind $1
*** HOLE CARDS ***
sta$igk: folds 
ptolejmus: folds 
yassine2525: folds 
yassine2525 leaves the table
aoish30: raises $1.50 to $2.50
Cositorto: folds 
MAO_DZEDYN_S: raises $9.68 to $12.18
aoish30: folds 
Uncalled bet ($9.68) returned to MAO_DZEDYN_S
MAO_DZEDYN_S collected $5.50 from pot
MAO_DZEDYN_S: doesn't show hand 
*** SUMMARY ***
Total pot $5.50 | Rake $0 
Seat 1: sta$igk folded before Flop (didn't bet)
Seat 2: ptolejmus folded before Flop (didn't bet)
Seat 3: yassine2525 folded before Flop (didn't bet)
Seat 4: aoish30 (button) folded before Flop
Seat 5: Cositorto (small blind) folded before Flop
Seat 6: MAO_DZEDYN_S (big blind) collected ($5.50)



PokerStars Hand #254534281876:  Hold'em No Limit ($0.50/$1.00 USD) - 2025/01/24 20:19:07 WET [2025/01/24 15:19:07 ET]
Table 'Merapi IV' 6-max Seat #5 is the button
Seat 1: sta$igk ($100 in chips) is sitting out
Seat 2: ptolejmus ($10 in chips) is sitting out
Seat 4: aoish30 ($114.63 in chips) 
Seat 5: Cositorto ($105.10 in chips) 
Seat 6: MAO_DZEDYN_S ($103 in chips) 
MAO_DZEDYN_S: posts small blind $0.50
sta$igk: is sitting out 
ptolejmus: is sitting out 
aoish30: posts big blind $1
*** HOLE CARDS ***
Cositorto: folds 
ptolejmus leaves the table
sta$igk leaves the table
MAO_DZEDYN_S: raises $2 to $3
aoish30: folds 
Uncalled bet ($2) returned to MAO_DZEDYN_S
MAO_DZEDYN_S collected $2 from pot
MAO_DZEDYN_S: doesn't show hand 
*** SUMMARY ***
Total pot $2 | Rake $0 
Seat 1: sta$igk
Seat 2: ptolejmus
Seat 4: aoish30 (big blind) folded before Flop
Seat 5: Cositorto (button) folded before Flop (didn't bet)
Seat 6: MAO_DZEDYN_S (small blind) collected ($2)



PokerStars Hand #254534285498:  Hold'em No Limit ($0.50/$1.00 USD) - 2025/01/24 20:19:18 WET [2025/01/24 15:19:18 ET]
Table 'Merapi IV' 6-max Seat #6 is the button
Seat 4: aoish30 ($113.63 in chips) 
Seat 5: Cositorto ($105.10 in chips) 
Seat 6: MAO_DZEDYN_S ($104 in chips) 
aoish30: posts small blind $0.50
Cositorto: posts big blind $1
*** HOLE CARDS ***
MAO_DZEDYN_S: raises $1.50 to $2.50
aoish30: folds 
elcutez joins the table at seat #3 
elcutez is disconnected 
Cositorto: calls $1.50
*** FLOP *** [9h 8d 3d]
Cositorto: checks 
BumHuntKing joins the table at seat #2 
MAO_DZEDYN_S: checks 
*** TURN *** [9h 8d 3d] [Jh]
Cositorto: checks 
MAO_DZEDYN_S: checks 
*** RIVER *** [9h 8d 3d Jh] [7c]
Cositorto: checks 
MAO_DZEDYN_S: checks 
*** SHOW DOWN ***
Cositorto: shows [Ah 9c] (a pair of Nines)
MAO_DZEDYN_S: mucks hand 
Cositorto collected $5.22 from pot
*** SUMMARY ***
Total pot $5.50 | Rake $0.28 
Board [9h 8d 3d Jh 7c]
Seat 4: aoish30 (small blind) folded before Flop
Seat 5: Cositorto (big blind) showed [Ah 9c] and won ($5.22) with a pair of Nines
Seat 6: MAO_DZEDYN_S (button) mucked



PokerStars Hand #254534302800:  Hold'em No Limit ($0.50/$1.00 USD) - 2025/01/24 20:20:14 WET [2025/01/24 15:20:14 ET]
Table 'Merapi IV' 6-max Seat #4 is the button
Seat 6: MAO_DZEDYN_S ($101.50 in chips) is sitting out
Seat 2: BumHuntKing ($100 in chips) 
Seat 3: elcutez ($100 in chips) 
Seat 4: aoish30 ($113.13 in chips) 
Seat 5: Cositorto ($107.82 in chips) 
Cositorto: posts small blind $0.50
MAO_DZEDYN_S: is sitting out 
BumHuntKing: posts big blind $1
elcutez: posts big blind $1
*** HOLE CARDS ***
elcutez: checks 
MAO_DZEDYN_S leaves the table
aoish30: raises $3 to $4
Cositorto: folds 
BumHuntKing: folds 
elcutez: folds 
Uncalled bet ($3) returned to aoish30
aoish30 collected $3.50 from pot
aoish30: doesn't show hand 
*** SUMMARY ***
Total pot $3.50 | Rake $0 
Seat 6: MAO_DZEDYN_S
Seat 2: BumHuntKing (big blind) folded before Flop
Seat 3: elcutez folded before Flop (didn't bet)
Seat 4: aoish30 (button) collected ($3.50)
Seat 5: Cositorto (small blind) folded before Flop



PokerStars Hand #254534307415:  Hold'em No Limit ($0.50/$1.00 USD) - 2025/01/24 20:20:29 WET [2025/01/24 15:20:29 ET]
Table 'Merapi IV' 6-max Seat #5 is the button
Seat 2: BumHuntKing ($100 in chips) 
Seat 3: elcutez ($99 in chips) 
Seat 4: aoish30 ($115.63 in chips) 
Seat 5: Cositorto ($107.32 in chips) 
BumHuntKing: posts small blind $0.50
elcutez: posts big blind $1
*** HOLE CARDS ***
aoish30: raises $1.50 to $2.50
Cositorto: folds 
BumHuntKing: folds 
elcutez: folds 
Uncalled bet ($1.50) returned to aoish30
aoish30 collected $2.50 from pot
aoish30: doesn't show hand 
*** SUMMARY ***
Total pot $2.50 | Rake $0 
Seat 2: BumHuntKing (small blind) folded before Flop
Seat 3: elcutez (big blind) folded before Flop
Seat 4: aoish30 collected ($2.50)
Seat 5: Cositorto (button) folded before Flop (didn't bet)



PokerStars Hand #254534313463:  Hold'em No Limit ($0.50/$1.00 USD) - 2025/01/24 20:20:49 WET [2025/01/24 15:20:49 ET]
Table 'Merapi IV' 6-max Seat #2 is the button
Seat 4: aoish30 ($117.13 in chips) is sitting out
Seat 2: BumHuntKing ($100 in chips) 
Seat 3: elcutez ($98 in chips) 
Seat 5: Cositorto ($107.32 in chips) 
elcutez: posts small blind $0.50
aoish30: is sitting out 
Cositorto: posts big blind $1
*** HOLE CARDS ***
itaba joins the table at seat #1 
aoish30 leaves the table
BumHuntKing: folds 
elcutez: folds 
Uncalled bet ($0.50) returned to Cositorto
Cositorto collected $1 from pot
Cositorto: doesn't show hand 
*** SUMMARY ***
Total pot $1 | Rake $0 
Seat 4: aoish30
Seat 2: BumHuntKing (button) folded before Flop (didn't bet)
Seat 3: elcutez (small blind) folded before Flop
Seat 5: Cositorto (big blind) collected ($1)



PokerStars Hand #254534321162:  Hold'em No Limit ($0.50/$1.00 USD) - 2025/01/24 20:21:14 WET [2025/01/24 15:21:14 ET]
Table 'Merapi IV' 6-max Seat #3 is the button
Seat 1: itaba ($10 in chips) 
Seat 2: BumHuntKing ($100 in chips) 
Seat 3: elcutez ($97.50 in chips) 
Seat 5: Cositorto ($107.82 in chips) 
Cositorto: posts small blind $0.50
itaba: posts big blind $1
*** HOLE CARDS ***
BumHuntKing: raises $1.20 to $2.20
elcutez: folds 
Cositorto: folds 
itaba: folds 
Uncalled bet ($1.20) returned to BumHuntKing
BumHuntKing collected $2.50 from pot
BumHuntKing: doesn't show hand 
*** SUMMARY ***
Total pot $2.50 | Rake $0 
Seat 1: itaba (big blind) folded before Flop
Seat 2: BumHuntKing collected ($2.50)
Seat 3: elcutez (button) folded before Flop (didn't bet)
Seat 5: Cositorto (small blind) folded before Flop



PokerStars Hand #254534325816:  Hold'em No Limit ($0.50/$1.00 USD) - 2025/01/24 20:21:29 WET [2025/01/24 15:21:29 ET]
Table 'Merapi IV' 6-max Seat #5 is the button
Seat 2: BumHuntKing ($101.50 in chips) is sitting out
Seat 1: itaba ($9 in chips) 
Seat 3: elcutez ($97.50 in chips) 
Seat 5: Cositorto ($107.32 in chips) 
itaba: posts small blind $0.50
BumHuntKing: is sitting out 
elcutez: posts big blind $1
*** HOLE CARDS ***
Cositorto: folds 
BumHuntKing leaves the table
itaba: raises $8 to $9 and is all-in
elcutez: folds 
Uncalled bet ($8) returned to itaba
itaba collected $2 from pot
itaba: doesn't show hand 
*** SUMMARY ***
Total pot $2 | Rake $0 
Seat 2: BumHuntKing
Seat 1: itaba (small blind) collected ($2)
Seat 3: elcutez (big blind) folded before Flop
Seat 5: Cositorto (button) folded before Flop (didn't bet)



PokerStars Hand #254534332583:  Hold'em No Limit ($0.50/$1.00 USD) - 2025/01/24 20:21:51 WET [2025/01/24 15:21:51 ET]
Table 'Merapi IV' 6-max Seat #1 is the button
Seat 1: itaba ($10 in chips) 
Seat 3: elcutez ($96.50 in chips) 
Seat 5: Cositorto ($107.32 in chips) 
elcutez: posts small blind $0.50
Cositorto: posts big blind $1
*** HOLE CARDS ***
itaba: folds 
elcutez: folds 
Uncalled bet ($0.50) returned to Cositorto
saral1 joins the table at seat #4 
saral1 is disconnected 
Cositorto collected $1 from pot
Cositorto: doesn't show hand 
*** SUMMARY ***
Total pot $1 | Rake $0 
Seat 1: itaba (button) folded before Flop (didn't bet)
Seat 3: elcutez (small blind) folded before Flop
Seat 5: Cositorto (big blind) collected ($1)



PokerStars Hand #254534334719:  Hold'em No Limit ($0.50/$1.00 USD) - 2025/01/24 20:21:57 WET [2025/01/24 15:21:57 ET]
Table 'Merapi IV' 6-max Seat #3 is the button
Seat 4: saral1 ($50.75 in chips) is sitting out
Seat 1: itaba ($10 in chips) 
Seat 3: elcutez ($96 in chips) 
Seat 5: Cositorto ($107.82 in chips) 
Cositorto: posts small blind $0.50
itaba: posts big blind $1
*** HOLE CARDS ***
blackclan7 joins the table at seat #6 
elcutez: raises $2 to $3
Cositorto: folds 
itaba: folds 
Uncalled bet ($2) returned to elcutez
elcutez collected $2.50 from pot
*** SUMMARY ***
Total pot $2.50 | Rake $0 
Seat 4: saral1
Seat 1: itaba (big blind) folded before Flop
Seat 3: elcutez (button) collected ($2.50)
Seat 5: Cositorto (small blind) folded before Flop



PokerStars Hand #254534337807:  Hold'em No Limit ($0.50/$1.00 USD) - 2025/01/24 20:22:08 WET [2025/01/24 15:22:08 ET]
Table 'Merapi IV' 6-max Seat #5 is the button
Seat 4: saral1 ($50.75 in chips) is sitting out
Seat 6: blackclan7 ($100 in chips) is sitting out
Seat 1: itaba ($9 in chips) 
Seat 3: elcutez ($97.50 in chips) 
Seat 5: Cositorto ($107.32 in chips) 
itaba: posts small blind $0.50
elcutez: posts big blind $1
saral1: sits out 
*** HOLE CARDS ***
Cositorto: raises $1.50 to $2.50
itaba: folds 
elcutez: folds 
Uncalled bet ($1.50) returned to Cositorto
praclovekzig joins the table at seat #2 
praclovekzig is disconnected 
Cositorto collected $2.50 from pot
Cositorto: doesn't show hand 
*** SUMMARY ***
Total pot $2.50 | Rake $0 
Seat 4: saral1
Seat 6: blackclan7
Seat 1: itaba (small blind) folded before Flop
Seat 3: elcutez (big blind) folded before Flop
Seat 5: Cositorto (button) collected ($2.50)



PokerStars Hand #254534340100:  Hold'em No Limit ($0.50/$1.00 USD) - 2025/01/24 20:22:15 WET [2025/01/24 15:22:15 ET]
Table 'Merapi IV' 6-max Seat #1 is the button
Seat 2: praclovekzig ($27.06 in chips) is sitting out
Seat 6: blackclan7 ($100 in chips) is sitting out
Seat 1: itaba ($8.50 in chips) 
Seat 3: elcutez ($96.50 in chips) 
Seat 4: saral1 ($50.75 in chips) 
Seat 5: Cositorto ($108.82 in chips) 
elcutez: posts small blind $0.50
saral1: posts big blind $1
blackclan7: sits out 
*** HOLE CARDS ***
Cositorto: raises $1 to $2
itaba: folds 
elcutez: folds 
saral1: folds 
Uncalled bet ($1) returned to Cositorto
Cositorto collected $2.50 from pot
Cositorto: doesn't show hand 
*** SUMMARY ***
Total pot $2.50 | Rake $0 
Seat 2: praclovekzig
Seat 6: blackclan7
Seat 1: itaba (button) folded before Flop (didn't bet)
Seat 3: elcutez (small blind) folded before Flop
Seat 4: saral1 (big blind) folded before Flop
Seat 5: Cositorto collected ($2.50)



PokerStars Hand #254534346940:  Hold'em No Limit ($0.50/$1.00 USD) - 2025/01/24 20:22:37 WET [2025/01/24 15:22:37 ET]
Table 'Merapi IV' 6-max Seat #4 is the button
Seat 3: elcutez ($96 in chips) is sitting out
Seat 1: itaba ($8.50 in chips) 
Seat 2: praclovekzig ($27.06 in chips) 
Seat 4: saral1 ($49.75 in chips) 
Seat 5: Cositorto ($110.32 in chips) 
Seat 6: blackclan7 ($100 in chips) 
Cositorto: posts small blind $0.50
blackclan7: posts big blind $1
praclovekzig: posts big blind $1
*** HOLE CARDS ***
itaba: folds 
praclovekzig: raises $2 to $3
saral1: calls $3
Cositorto: folds 
blackclan7: folds 
*** FLOP *** [6s 2s 8d]
praclovekzig: checks 
elcutez is disconnected 
saral1: checks 
*** TURN *** [6s 2s 8d] [Ts]
praclovekzig: checks 
saral1: checks 
*** RIVER *** [6s 2s 8d Ts] [Ah]
praclovekzig: checks 
saral1: bets $5.12
praclovekzig: folds 
Uncalled bet ($5.12) returned to saral1
saral1 collected $7.12 from pot
*** SUMMARY ***
Total pot $7.50 | Rake $0.38 
Board [6s 2s 8d Ts Ah]
Seat 3: elcutez
Seat 1: itaba folded before Flop (didn't bet)
Seat 2: praclovekzig folded on the River
Seat 4: saral1 (button) collected ($7.12)
Seat 5: Cositorto (small blind) folded before Flop
Seat 6: blackclan7 (big blind) folded before Flop



PokerStars Hand #254534362799:  Hold'em No Limit ($0.50/$1.00 USD) - 2025/01/24 20:23:29 WET [2025/01/24 15:23:29 ET]
Table 'Merapi IV' 6-max Seat #5 is the button
Seat 3: elcutez ($96 in chips) is sitting out
Seat 1: itaba ($8.50 in chips) 
Seat 2: praclovekzig ($24.06 in chips) 
Seat 4: saral1 ($53.87 in chips) 
Seat 5: Cositorto ($109.82 in chips) 
Seat 6: blackclan7 ($100 in chips) 
blackclan7: posts small blind $0.50
itaba: posts big blind $1
*** HOLE CARDS ***
praclovekzig: raises $2 to $3
saral1: folds 
Cositorto: folds 
blackclan7: folds 
itaba: folds 
Uncalled bet ($2) returned to praclovekzig
praclovekzig collected $2.50 from pot
*** SUMMARY ***
Total pot $2.50 | Rake $0 
Seat 3: elcutez
Seat 1: itaba (big blind) folded before Flop
Seat 2: praclovekzig collected ($2.50)
Seat 4: saral1 folded before Flop (didn't bet)
Seat 5: Cositorto (button) folded before Flop (didn't bet)
Seat 6: blackclan7 (small blind) folded before Flop



PokerStars Hand #254534372128:  Hold'em No Limit ($0.50/$1.00 USD) - 2025/01/24 20:23:59 WET [2025/01/24 15:23:59 ET]
Table 'Merapi IV' 6-max Seat #6 is the button
Seat 3: elcutez ($96 in chips) is sitting out
Seat 1: itaba ($7.50 in chips) 
Seat 2: praclovekzig ($25.56 in chips) 
Seat 4: saral1 ($53.87 in chips) 
Seat 5: Cositorto ($109.82 in chips) 
Seat 6: blackclan7 ($100 in chips) 
itaba: posts small blind $0.50
praclovekzig: posts big blind $1
*** HOLE CARDS ***
saral1: folds 
Cositorto: folds 
blackclan7: folds 
itaba: raises $6.50 to $7.50 and is all-in
praclovekzig: folds 
Uncalled bet ($6.50) returned to itaba
itaba collected $2 from pot
itaba: doesn't show hand 
*** SUMMARY ***
Total pot $2 | Rake $0 
Seat 3: elcutez
Seat 1: itaba (small blind) collected ($2)
Seat 2: praclovekzig (big blind) folded before Flop
Seat 4: saral1 folded before Flop (didn't bet)
Seat 5: Cositorto folded before Flop (didn't bet)
Seat 6: blackclan7 (button) folded before Flop (didn't bet)



PokerStars Hand #254534380158:  Hold'em No Limit ($0.50/$1.00 USD) - 2025/01/24 20:24:25 WET [2025/01/24 15:24:25 ET]
Table 'Merapi IV' 6-max Seat #1 is the button
Seat 1: itaba ($8.50 in chips) 
Seat 2: praclovekzig ($24.56 in chips) 
Seat 3: elcutez ($96 in chips) 
Seat 4: saral1 ($53.87 in chips) 
Seat 5: Cositorto ($109.82 in chips) 
Seat 6: blackclan7 ($100 in chips) 
praclovekzig: posts small blind $0.50
elcutez: posts big blind $1
*** HOLE CARDS ***
saral1: raises $2 to $3
Cositorto: folds 
blackclan7: folds 
itaba: folds 
praclovekzig: raises $7 to $10
elcutez: folds 
saral1: calls $7
*** FLOP *** [Td 4s Qh]
praclovekzig: bets $14.56 and is all-in
saral1: calls $14.56
*** TURN *** [Td 4s Qh] [9s]
*** RIVER *** [Td 4s Qh 9s] [2s]
*** SHOW DOWN ***
praclovekzig: shows [Jd Js] (a pair of Jacks)
saral1: shows [4d 4h] (three of a kind, Fours)
saral1 collected $47.62 from pot
*** SUMMARY ***
Total pot $50.12 | Rake $2.50 
Board [Td 4s Qh 9s 2s]
Seat 1: itaba (button) folded before Flop (didn't bet)
Seat 2: praclovekzig (small blind) showed [Jd Js] and lost with a pair of Jacks
Seat 3: elcutez (big blind) folded before Flop
Seat 4: saral1 showed [4d 4h] and won ($47.62) with three of a kind, Fours
Seat 5: Cositorto folded before Flop (didn't bet)
Seat 6: blackclan7 folded before Flop (didn't bet)



PokerStars Hand #254534393502:  Hold'em No Limit ($0.50/$1.00 USD) - 2025/01/24 20:25:08 WET [2025/01/24 15:25:08 ET]
Table 'Merapi IV' 6-max Seat #3 is the button
Seat 2: praclovekzig ($0 in chips) is sitting out
Seat 1: itaba ($8.50 in chips) 
Seat 3: elcutez ($95 in chips) 
Seat 4: saral1 ($76.93 in chips) 
Seat 5: Cositorto ($109.82 in chips) 
Seat 6: blackclan7 ($100 in chips) 
saral1: posts small blind $0.50
Cositorto: posts big blind $1
*** HOLE CARDS ***
blackclan7: folds 
itaba: folds 
blackclan7 leaves the table
elcutez: raises $2.50 to $3.50
praclovekzig leaves the table
saral1: folds 
GuigaMan joins the table at seat #6 
Cositorto: folds 
Uncalled bet ($2.50) returned to elcutez
elcutez collected $2.50 from pot
*** SUMMARY ***
Total pot $2.50 | Rake $0 
Seat 2: praclovekzig
Seat 1: itaba folded before Flop (didn't bet)
Seat 3: elcutez (button) collected ($2.50)
Seat 4: saral1 (small blind) folded before Flop
Seat 5: Cositorto (big blind) folded before Flop
Seat 6: blackclan7 folded before Flop (didn't bet)



PokerStars Hand #254534398687:  Hold'em No Limit ($0.50/$1.00 USD) - 2025/01/24 20:25:25 WET [2025/01/24 15:25:25 ET]
Table 'Merapi IV' 6-max Seat #4 is the button
Seat 1: itaba ($8.50 in chips) 
Seat 3: elcutez ($96.50 in chips) 
Seat 4: saral1 ($76.43 in chips) 
Seat 5: Cositorto ($108.82 in chips) 
Seat 6: GuigaMan ($100 in chips) 
Cositorto: posts small blind $0.50
GuigaMan: posts big blind $1
*** HOLE CARDS ***
41ElCapo02 joins the table at seat #2 
41ElCapo02 is disconnected 
itaba: folds 
elcutez: folds 
saral1: calls $1
Cositorto: raises $3 to $4
GuigaMan: calls $3
saral1: calls $3
*** FLOP *** [9h 2h 6s]
Cositorto: checks 
GuigaMan: checks 
saral1: checks 
*** TURN *** [9h 2h 6s] [5s]
Cositorto: checks 
GuigaMan: checks 
saral1: checks 
*** RIVER *** [9h 2h 6s 5s] [Qs]
Cositorto: checks 
GuigaMan: checks 
saral1: bets $11.40
Cositorto: folds 
GuigaMan: folds 
Uncalled bet ($11.40) returned to saral1
saral1 collected $11.40 from pot
*** SUMMARY ***
Total pot $12 | Rake $0.60 
Board [9h 2h 6s 5s Qs]
Seat 1: itaba folded before Flop (didn't bet)
Seat 3: elcutez folded before Flop (didn't bet)
Seat 4: saral1 (button) collected ($11.40)
Seat 5: Cositorto (small blind) folded on the River
Seat 6: GuigaMan (big blind) folded on the River



PokerStars Hand #254534428689:  Hold'em No Limit ($0.50/$1.00 USD) - 2025/01/24 20:27:02 WET [2025/01/24 15:27:02 ET]
Table 'Merapi IV' 6-max Seat #5 is the button
Seat 1: itaba ($8.50 in chips) is sitting out
Seat 2: 41ElCapo02 ($14.71 in chips) 
Seat 3: elcutez ($96.50 in chips) 
Seat 4: saral1 ($83.83 in chips) 
Seat 5: Cositorto ($104.82 in chips) 
Seat 6: GuigaMan ($100 in chips) 
GuigaMan: posts small blind $0.50
itaba: is sitting out 
41ElCapo02: posts big blind $1
*** HOLE CARDS ***
elcutez: folds 
saral1: folds 
itaba leaves the table
Cositorto: folds 
sta$igk joins the table at seat #1 
GuigaMan: raises $2 to $3
41ElCapo02: folds 
Uncalled bet ($2) returned to GuigaMan
GuigaMan collected $2 from pot
GuigaMan: doesn't show hand 
*** SUMMARY ***
Total pot $2 | Rake $0 
Seat 1: itaba
Seat 2: 41ElCapo02 (big blind) folded before Flop
Seat 3: elcutez folded before Flop (didn't bet)
Seat 4: saral1 folded before Flop (didn't bet)
Seat 5: Cositorto (button) folded before Flop (didn't bet)
Seat 6: GuigaMan (small blind) collected ($2)



PokerStars Hand #254534439628:  Hold'em No Limit ($0.50/$1.00 USD) - 2025/01/24 20:27:37 WET [2025/01/24 15:27:37 ET]
Table 'Merapi IV' 6-max Seat #6 is the button
Seat 1: sta$igk ($100 in chips) is sitting out
Seat 2: 41ElCapo02 ($13.71 in chips) 
Seat 3: elcutez ($96.50 in chips) 
Seat 4: saral1 ($83.83 in chips) 
Seat 5: Cositorto ($104.82 in chips) 
Seat 6: GuigaMan ($101 in chips) 
41ElCapo02: posts small blind $0.50
elcutez: posts big blind $1
*** HOLE CARDS ***
saral1: folds 
Cositorto: raises $1 to $2
GuigaMan: folds 
41ElCapo02: folds 
elcutez: calls $1
*** FLOP *** [6c 9d 5c]
elcutez: checks 
Cositorto: bets $2.14
elcutez: raises $3.86 to $6
Cositorto: calls $3.86
*** TURN *** [6c 9d 5c] [3d]
elcutez: checks 
Cositorto: bets $4.50
elcutez: folds 
Uncalled bet ($4.50) returned to Cositorto
Cositorto collected $15.68 from pot
Cositorto: doesn't show hand 
*** SUMMARY ***
Total pot $16.50 | Rake $0.82 
Board [6c 9d 5c 3d]
Seat 1: sta$igk
Seat 2: 41ElCapo02 (small blind) folded before Flop
Seat 3: elcutez (big blind) folded on the Turn
Seat 4: saral1 folded before Flop (didn't bet)
Seat 5: Cositorto collected ($15.68)
Seat 6: GuigaMan (button) folded before Flop (didn't bet)



PokerStars Hand #254534460813:  Hold'em No Limit ($0.50/$1.00 USD) - 2025/01/24 20:28:47 WET [2025/01/24 15:28:47 ET]
Table 'Merapi IV' 6-max Seat #2 is the button
Seat 1: sta$igk ($100 in chips) is sitting out
Seat 2: 41ElCapo02 ($13.21 in chips) 
Seat 3: elcutez ($88.50 in chips) 
Seat 4: saral1 ($83.83 in chips) 
Seat 5: Cositorto ($112.50 in chips) 
Seat 6: GuigaMan ($101 in chips) 
elcutez: posts small blind $0.50
saral1: posts big blind $1
sta$igk: sits out 
*** HOLE CARDS ***
Cositorto: folds 
GuigaMan: folds 
41ElCapo02: folds 
elcutez: folds 
Uncalled bet ($0.50) returned to saral1
saral1 collected $1 from pot
*** SUMMARY ***
Total pot $1 | Rake $0 
Seat 1: sta$igk
Seat 2: 41ElCapo02 (button) folded before Flop (didn't bet)
Seat 3: elcutez (small blind) folded before Flop
Seat 4: saral1 (big blind) collected ($1)
Seat 5: Cositorto folded before Flop (didn't bet)
Seat 6: GuigaMan folded before Flop (didn't bet)



PokerStars Hand #254534464959:  Hold'em No Limit ($0.50/$1.00 USD) - 2025/01/24 20:29:00 WET [2025/01/24 15:29:00 ET]
Table 'Merapi IV' 6-max Seat #3 is the button
Seat 1: sta$igk ($100 in chips) is sitting out
Seat 2: 41ElCapo02 ($13.21 in chips) 
Seat 3: elcutez ($88 in chips) 
Seat 4: saral1 ($84.33 in chips) 
Seat 5: Cositorto ($112.50 in chips) 
Seat 6: GuigaMan ($101 in chips) 
saral1: posts small blind $0.50
Cositorto: posts big blind $1
sta$igk: sits out 
*** HOLE CARDS ***
GuigaMan: folds 
41ElCapo02: raises $2 to $3
elcutez: calls $3
saral1: folds 
Cositorto: raises $12 to $15
41ElCapo02: calls $10.21 and is all-in
elcutez: calls $12
*** FLOP *** [5d 2s Qs]
Cositorto: bets $11.21
elcutez: calls $11.21
*** TURN *** [5d 2s Qs] [Qh]
Cositorto: bets $17.18
elcutez: raises $44.61 to $61.79 and is all-in
Cositorto: calls $44.61
*** RIVER *** [5d 2s Qs Qh] [As]
*** SHOW DOWN ***
Cositorto: shows [9c 9d] (two pair, Queens and Nines)
elcutez: shows [Qd Jd] (three of a kind, Queens)
elcutez collected $149.09 from side pot
41ElCapo02: shows [Kd Kh] (two pair, Kings and Queens)
elcutez collected $38.12 from main pot
*** SUMMARY ***
Total pot $189.71 Main pot $38.12. Side pot $149.09. | Rake $2.50 
Board [5d 2s Qs Qh As]
Seat 1: sta$igk
Seat 2: 41ElCapo02 showed [Kd Kh] and lost with two pair, Kings and Queens
Seat 3: elcutez (button) showed [Qd Jd] and won ($187.21) with three of a kind, Queens
Seat 4: saral1 (small blind) folded before Flop
Seat 5: Cositorto (big blind) showed [9c 9d] and lost with two pair, Queens and Nines
Seat 6: GuigaMan folded before Flop (didn't bet)



PokerStars Hand #254534484605:  Hold'em No Limit ($0.50/$1.00 USD) - 2025/01/24 20:30:05 WET [2025/01/24 15:30:05 ET]
Table 'Merapi IV' 6-max Seat #4 is the button
Seat 1: sta$igk ($100 in chips) is sitting out
Seat 2: 41ElCapo02 ($0 in chips) is sitting out
Seat 3: elcutez ($187.21 in chips) 
Seat 4: saral1 ($83.83 in chips) 
Seat 5: Cositorto ($100 in chips) 
Seat 6: GuigaMan ($101 in chips) 
Cositorto: posts small blind $0.50
GuigaMan: posts big blind $1
sta$igk: sits out 
*** HOLE CARDS ***
elcutez: folds 
saral1: folds 
Cositorto: raises $2 to $3
elcutez leaves the table
GuigaMan: folds 
Uncalled bet ($2) returned to Cositorto
Cositorto collected $2 from pot
Cositorto: doesn't show hand 
*** SUMMARY ***
Total pot $2 | Rake $0 
Seat 1: sta$igk
Seat 2: 41ElCapo02
Seat 3: elcutez folded before Flop (didn't bet)
Seat 4: saral1 (button) folded before Flop (didn't bet)
Seat 5: Cositorto (small blind) collected ($2)
Seat 6: GuigaMan (big blind) folded before Flop



PokerStars Hand #254534574143:  Hold'em No Limit ($0.50/$1.00 USD) - 2025/01/24 20:34:59 WET [2025/01/24 15:34:59 ET]
Table 'Merapi IV' 6-max Seat #1 is the button
Seat 2: 41ElCapo02 ($0 in chips) is sitting out
Seat 3: z00mba ($100 in chips) is sitting out
Seat 1: sta$igk ($204.14 in chips) 
Seat 4: saral1 ($51.33 in chips) 
Seat 5: Cositorto ($100 in chips) 
Seat 6: GuigaMan ($130.07 in chips) 
saral1: posts small blind $0.50
Cositorto: posts big blind $1
*** HOLE CARDS ***
GuigaMan: raises $1.50 to $2.50
sta$igk: folds 
saral1: calls $2
Cositorto: folds 
*** FLOP *** [Qd 2h 4d]
saral1: checks 
GuigaMan: checks 
*** TURN *** [Qd 2h 4d] [4s]
saral1: bets $3
GuigaMan: folds 
Uncalled bet ($3) returned to saral1
saral1 collected $5.70 from pot
*** SUMMARY ***
Total pot $6 | Rake $0.30 
Board [Qd 2h 4d 4s]
Seat 2: 41ElCapo02
Seat 3: z00mba
Seat 1: sta$igk (button) folded before Flop (didn't bet)
Seat 4: saral1 (small blind) collected ($5.70)
Seat 5: Cositorto (big blind) folded before Flop
Seat 6: GuigaMan folded on the Turn



PokerStars Hand #254534583594:  Hold'em No Limit ($0.50/$1.00 USD) - 2025/01/24 20:35:30 WET [2025/01/24 15:35:30 ET]
Table 'Merapi IV' 6-max Seat #4 is the button
Seat 2: 41ElCapo02 ($0 in chips) is sitting out
Seat 3: z00mba ($100 in chips) is sitting out
Seat 1: sta$igk ($204.14 in chips) 
Seat 4: saral1 ($54.53 in chips) 
Seat 5: Cositorto ($100 in chips) 
Seat 6: GuigaMan ($127.57 in chips) 
Cositorto: posts small blind $0.50
GuigaMan: posts big blind $1
z00mba: sits out 
*** HOLE CARDS ***
sta$igk: folds 
saral1: folds 
Cositorto: folds 
Uncalled bet ($0.50) returned to GuigaMan
GuigaMan collected $1 from pot
GuigaMan: doesn't show hand 
*** SUMMARY ***
Total pot $1 | Rake $0 
Seat 2: 41ElCapo02
Seat 3: z00mba
Seat 1: sta$igk folded before Flop (didn't bet)
Seat 4: saral1 (button) folded before Flop (didn't bet)
Seat 5: Cositorto (small blind) folded before Flop
Seat 6: GuigaMan (big blind) collected ($1)



PokerStars Hand #254534586049:  Hold'em No Limit ($0.50/$1.00 USD) - 2025/01/24 20:35:38 WET [2025/01/24 15:35:38 ET]
Table 'Merapi IV' 6-max Seat #5 is the button
Seat 2: 41ElCapo02 ($0 in chips) is sitting out
Seat 3: z00mba ($100 in chips) is sitting out
Seat 1: sta$igk ($204.14 in chips) 
Seat 4: saral1 ($54.53 in chips) 
Seat 5: Cositorto ($100 in chips) 
Seat 6: GuigaMan ($128.07 in chips) 
GuigaMan: posts small blind $0.50
sta$igk: posts big blind $1
z00mba: sits out 
*** HOLE CARDS ***
saral1: folds 
Cositorto: folds 
GuigaMan: folds 
Uncalled bet ($0.50) returned to sta$igk
sta$igk collected $1 from pot
sta$igk: doesn't show hand 
*** SUMMARY ***
Total pot $1 | Rake $0 
Seat 2: 41ElCapo02
Seat 3: z00mba
Seat 1: sta$igk (big blind) collected ($1)
Seat 4: saral1 folded before Flop (didn't bet)
Seat 5: Cositorto (button) folded before Flop (didn't bet)
Seat 6: GuigaMan (small blind) folded before Flop



PokerStars Hand #254534588577:  Hold'em No Limit ($0.50/$1.00 USD) - 2025/01/24 20:35:46 WET [2025/01/24 15:35:46 ET]
Table 'Merapi IV' 6-max Seat #6 is the button
Seat 2: 41ElCapo02 ($0 in chips) is sitting out
Seat 1: sta$igk ($204.64 in chips) 
Seat 3: z00mba ($100 in chips) 
Seat 4: saral1 ($54.53 in chips) 
Seat 5: Cositorto ($100 in chips) 
Seat 6: GuigaMan ($127.57 in chips) 
sta$igk: posts small blind $0.50
z00mba: posts big blind $1
*** HOLE CARDS ***
saral1: folds 
Cositorto: folds 
GuigaMan: raises $1.50 to $2.50
sta$igk: folds 
z00mba: calls $1.50
*** FLOP *** [2s 2c 6s]
z00mba: checks 
GuigaMan: checks 
*** TURN *** [2s 2c 6s] [Qc]
z00mba: checks 
GuigaMan: bets $3.92
z00mba: calls $3.92
*** RIVER *** [2s 2c 6s Qc] [2d]
z00mba: checks 
GuigaMan: bets $9.50
z00mba: calls $9.50
*** SHOW DOWN ***
GuigaMan: shows [Tc Qd] (a full house, Deuces full of Queens)
z00mba: mucks hand 
GuigaMan collected $30.72 from pot
*** SUMMARY ***
Total pot $32.34 | Rake $1.62 
Board [2s 2c 6s Qc 2d]
Seat 2: 41ElCapo02
Seat 1: sta$igk (small blind) folded before Flop
Seat 3: z00mba (big blind) mucked
Seat 4: saral1 folded before Flop (didn't bet)
Seat 5: Cositorto folded before Flop (didn't bet)
Seat 6: GuigaMan (button) showed [Tc Qd] and won ($30.72) with a full house, Deuces full of Queens



PokerStars Hand #254534618292:  Hold'em No Limit ($0.50/$1.00 USD) - 2025/01/24 20:37:24 WET [2025/01/24 15:37:24 ET]
Table 'Merapi IV' 6-max Seat #1 is the button
Seat 2: 41ElCapo02 ($0 in chips) is sitting out
Seat 1: sta$igk ($204.14 in chips) 
Seat 3: z00mba ($100 in chips) 
Seat 4: saral1 ($54.53 in chips) 
Seat 5: Cositorto ($100 in chips) 
Seat 6: GuigaMan ($142.37 in chips) 
z00mba: posts small blind $0.50
saral1: posts big blind $1
*** HOLE CARDS ***
Cositorto: folds 
GuigaMan: folds 
sta$igk: folds 
z00mba: folds 
Uncalled bet ($0.50) returned to saral1
saral1 collected $1 from pot
*** SUMMARY ***
Total pot $1 | Rake $0 
Seat 2: 41ElCapo02
Seat 1: sta$igk (button) folded before Flop (didn't bet)
Seat 3: z00mba (small blind) folded before Flop
Seat 4: saral1 (big blind) collected ($1)
Seat 5: Cositorto folded before Flop (didn't bet)
Seat 6: GuigaMan folded before Flop (didn't bet)



PokerStars Hand #254534620989:  Hold'em No Limit ($0.50/$1.00 USD) - 2025/01/24 20:37:33 WET [2025/01/24 15:37:33 ET]
Table 'Merapi IV' 6-max Seat #3 is the button
Seat 2: 41ElCapo02 ($0 in chips) is sitting out
Seat 1: sta$igk ($204.14 in chips) 
Seat 3: z00mba ($100 in chips) 
Seat 4: saral1 ($55.03 in chips) 
Seat 5: Cositorto ($100 in chips) 
Seat 6: GuigaMan ($142.37 in chips) 
saral1: posts small blind $0.50
Cositorto: posts big blind $1
*** HOLE CARDS ***
GuigaMan: folds 
sta$igk: folds 
z00mba: folds 
saral1: raises $3 to $4
Cositorto: folds 
Uncalled bet ($3) returned to saral1
saral1 collected $2 from pot
*** SUMMARY ***
Total pot $2 | Rake $0 
Seat 2: 41ElCapo02
Seat 1: sta$igk folded before Flop (didn't bet)
Seat 3: z00mba (button) folded before Flop (didn't bet)
Seat 4: saral1 (small blind) collected ($2)
Seat 5: Cositorto (big blind) folded before Flop
Seat 6: GuigaMan folded before Flop (didn't bet)



PokerStars Hand #254534628573:  Hold'em No Limit ($0.50/$1.00 USD) - 2025/01/24 20:37:59 WET [2025/01/24 15:37:59 ET]
Table 'Merapi IV' 6-max Seat #4 is the button
Seat 2: 41ElCapo02 ($0 in chips) is sitting out
Seat 1: sta$igk ($204.14 in chips) 
Seat 3: z00mba ($100 in chips) 
Seat 4: saral1 ($56.03 in chips) 
Seat 5: Cositorto ($100 in chips) 
Seat 6: GuigaMan ($142.37 in chips) 
Cositorto: posts small blind $0.50
GuigaMan: posts big blind $1
*** HOLE CARDS ***
sta$igk: folds 
z00mba: folds 
saral1: folds 
Cositorto: raises $2 to $3
GuigaMan: folds 
Uncalled bet ($2) returned to Cositorto
Cositorto collected $2 from pot
Cositorto: doesn't show hand 
*** SUMMARY ***
Total pot $2 | Rake $0 
Seat 2: 41ElCapo02
Seat 1: sta$igk folded before Flop (didn't bet)
Seat 3: z00mba folded before Flop (didn't bet)
Seat 4: saral1 (button) folded before Flop (didn't bet)
Seat 5: Cositorto (small blind) collected ($2)
Seat 6: GuigaMan (big blind) folded before Flop



PokerStars Hand #254534633562:  Hold'em No Limit ($0.50/$1.00 USD) - 2025/01/24 20:38:15 WET [2025/01/24 15:38:15 ET]
Table 'Merapi IV' 6-max Seat #5 is the button
Seat 2: 41ElCapo02 ($0 in chips) is sitting out
Seat 1: sta$igk ($204.14 in chips) 
Seat 3: z00mba ($100 in chips) 
Seat 4: saral1 ($56.03 in chips) 
Seat 5: Cositorto ($101 in chips) 
Seat 6: GuigaMan ($141.37 in chips) 
GuigaMan: posts small blind $0.50
sta$igk: posts big blind $1
*** HOLE CARDS ***
z00mba: folds 
saral1: folds 
Cositorto: folds 
GuigaMan: folds 
Uncalled bet ($0.50) returned to sta$igk
sta$igk collected $1 from pot
sta$igk: doesn't show hand 
*** SUMMARY ***
Total pot $1 | Rake $0 
Seat 2: 41ElCapo02
Seat 1: sta$igk (big blind) collected ($1)
Seat 3: z00mba folded before Flop (didn't bet)
Seat 4: saral1 folded before Flop (didn't bet)
Seat 5: Cositorto (button) folded before Flop (didn't bet)
Seat 6: GuigaMan (small blind) folded before Flop



PokerStars Hand #254534637011:  Hold'em No Limit ($0.50/$1.00 USD) - 2025/01/24 20:38:26 WET [2025/01/24 15:38:26 ET]
Table 'Merapi IV' 6-max Seat #6 is the button
Seat 2: 41ElCapo02 ($0 in chips) is sitting out
Seat 3: z00mba ($100 in chips) is sitting out
Seat 1: sta$igk ($204.64 in chips) 
Seat 4: saral1 ($56.03 in chips) 
Seat 5: Cositorto ($101 in chips) 
Seat 6: GuigaMan ($140.87 in chips) 
sta$igk: posts small blind $0.50
z00mba: is sitting out 
saral1: posts big blind $1
*** HOLE CARDS ***
Cositorto: raises $1 to $2
GuigaMan: folds 
sta$igk: folds 
saral1: folds 
Uncalled bet ($1) returned to Cositorto
Cositorto collected $2.50 from pot
41ElCapo02 leaves the table
Cositorto: doesn't show hand 
*** SUMMARY ***
Total pot $2.50 | Rake $0 
Seat 2: 41ElCapo02
Seat 3: z00mba
Seat 1: sta$igk (small blind) folded before Flop
Seat 4: saral1 (big blind) folded before Flop
Seat 5: Cositorto collected ($2.50)
Seat 6: GuigaMan (button) folded before Flop (didn't bet)



PokerStars Hand #254534641001:  Hold'em No Limit ($0.50/$1.00 USD) - 2025/01/24 20:38:39 WET [2025/01/24 15:38:39 ET]
Table 'Merapi IV' 6-max Seat #1 is the button
Seat 3: z00mba ($100 in chips) is sitting out
Seat 1: sta$igk ($204.14 in chips) 
Seat 4: saral1 ($55.03 in chips) 
Seat 5: Cositorto ($102.50 in chips) 
Seat 6: GuigaMan ($140.87 in chips) 
saral1: posts small blind $0.50
Cositorto: posts big blind $1
*** HOLE CARDS ***
GuigaMan: folds 
sta$igk: raises $1.50 to $2.50
saral1: folds 
Cositorto: folds 
Uncalled bet ($1.50) returned to sta$igk
sta$igk collected $2.50 from pot
sta$igk: doesn't show hand 
*** SUMMARY ***
Total pot $2.50 | Rake $0 
Seat 3: z00mba
Seat 1: sta$igk (button) collected ($2.50)
Seat 4: saral1 (small blind) folded before Flop
Seat 5: Cositorto (big blind) folded before Flop
Seat 6: GuigaMan folded before Flop (didn't bet)



PokerStars Hand #254534645755:  Hold'em No Limit ($0.50/$1.00 USD) - 2025/01/24 20:38:55 WET [2025/01/24 15:38:55 ET]
Table 'Merapi IV' 6-max Seat #4 is the button
Seat 3: z00mba ($100 in chips) is sitting out
Seat 1: sta$igk ($205.64 in chips) 
Seat 4: saral1 ($54.53 in chips) 
Seat 5: Cositorto ($101.50 in chips) 
Seat 6: GuigaMan ($140.87 in chips) 
Cositorto: posts small blind $0.50
GuigaMan: posts big blind $1
*** HOLE CARDS ***
sta$igk: folds 
sta$igk leaves the table
saral1: folds 
Cositorto: raises $2 to $3
z00mba leaves the table
GuigaMan: folds 
Uncalled bet ($2) returned to Cositorto
Cositorto collected $2 from pot
Cositorto: doesn't show hand 
*** SUMMARY ***
Total pot $2 | Rake $0 
Seat 3: z00mba
Seat 1: sta$igk folded before Flop (didn't bet)
Seat 4: saral1 (button) folded before Flop (didn't bet)
Seat 5: Cositorto (small blind) collected ($2)
Seat 6: GuigaMan (big blind) folded before Flop



PokerStars Hand #254534651170:  Hold'em No Limit ($0.50/$1.00 USD) - 2025/01/24 20:39:13 WET [2025/01/24 15:39:13 ET]
Table 'Merapi IV' 6-max Seat #5 is the button
Seat 4: saral1 ($54.53 in chips) 
Seat 5: Cositorto ($102.50 in chips) 
Seat 6: GuigaMan ($139.87 in chips) 
GuigaMan: posts small blind $0.50
saral1: posts big blind $1
*** HOLE CARDS ***
Cositorto: raises $1.50 to $2.50
GuigaMan: folds 
saral1: raises $4.50 to $7
Cositorto: folds 
Uncalled bet ($4.50) returned to saral1
saral1 collected $5.50 from pot
ru_ruu_ru joins the table at seat #1 
*** SUMMARY ***
Total pot $5.50 | Rake $0 
Seat 4: saral1 (big blind) collected ($5.50)
Seat 5: Cositorto (button) folded before Flop
Seat 6: GuigaMan (small blind) folded before Flop



PokerStars Hand #254534655874:  Hold'em No Limit ($0.50/$1.00 USD) - 2025/01/24 20:39:29 WET [2025/01/24 15:39:29 ET]
Table 'Merapi IV' 6-max Seat #6 is the button
Seat 1: ru_ruu_ru ($100 in chips) is sitting out
Seat 4: saral1 ($57.53 in chips) 
Seat 5: Cositorto ($100 in chips) 
Seat 6: GuigaMan ($139.37 in chips) 
saral1: posts small blind $0.50
Cositorto: posts big blind $1
*** HOLE CARDS ***
GuigaMan: raises $1.50 to $2.50
saral1: folds 
Lucastitos joins the table at seat #3 
Cositorto: folds 
Uncalled bet ($1.50) returned to GuigaMan
GuigaMan collected $2.50 from pot
GuigaMan: doesn't show hand 
*** SUMMARY ***
Total pot $2.50 | Rake $0 
Seat 1: ru_ruu_ru
Seat 4: saral1 (small blind) folded before Flop
Seat 5: Cositorto (big blind) folded before Flop
Seat 6: GuigaMan (button) collected ($2.50)



PokerStars Hand #254534658563:  Hold'em No Limit ($0.50/$1.00 USD) - 2025/01/24 20:39:38 WET [2025/01/24 15:39:38 ET]
Table 'Merapi IV' 6-max Seat #4 is the button
Seat 1: ru_ruu_ru ($100 in chips) is sitting out
Seat 3: Lucastitos ($100 in chips) is sitting out
Seat 4: saral1 ($57.03 in chips) 
Seat 5: Cositorto ($100 in chips) 
Seat 6: GuigaMan ($140.87 in chips) 
Cositorto: posts small blind $0.50
GuigaMan: posts big blind $1
ru_ruu_ru: sits out 
Lucastitos: sits out 
*** HOLE CARDS ***
saral1: raises $3 to $4
Cositorto: raises $12 to $16
GuigaMan: folds 
BGS013 joins the table at seat #2 
saral1: calls $12
*** FLOP *** [7s Ks 9h]
Cositorto: bets $7
saral1: calls $7
*** TURN *** [7s Ks 9h] [3h]
Cositorto: checks 
saral1: bets $34.03 and is all-in
Cositorto: calls $34.03
*** RIVER *** [7s Ks 9h 3h] [4d]
*** SHOW DOWN ***
Cositorto: shows [As Kh] (a pair of Kings)
saral1: shows [Js Jc] (a pair of Jacks)
Cositorto collected $114.06 from pot
*** SUMMARY ***
Total pot $115.06 | Rake $1 
Board [7s Ks 9h 3h 4d]
Seat 1: ru_ruu_ru
Seat 3: Lucastitos
Seat 4: saral1 (button) showed [Js Jc] and lost with a pair of Jacks
Seat 5: Cositorto (small blind) showed [As Kh] and won ($114.06) with a pair of Kings
Seat 6: GuigaMan (big blind) folded before Flop



PokerStars Hand #254534672867:  Hold'em No Limit ($0.50/$1.00 USD) - 2025/01/24 20:40:25 WET [2025/01/24 15:40:25 ET]
Table 'Merapi IV' 6-max Seat #5 is the button
Seat 2: BGS013 ($100 in chips) is sitting out
Seat 3: Lucastitos ($100 in chips) is sitting out
Seat 4: saral1 ($0 in chips) is sitting out
Seat 1: ru_ruu_ru ($100 in chips) 
Seat 5: Cositorto ($157.03 in chips) 
Seat 6: GuigaMan ($139.87 in chips) 
GuigaMan: posts small blind $0.50
ru_ruu_ru: posts big blind $1
BGS013: sits out 
Lucastitos: sits out 
*** HOLE CARDS ***
Cositorto: folds 
GuigaMan: raises $2 to $3
ru_ruu_ru: folds 
Uncalled bet ($2) returned to GuigaMan
GuigaMan collected $2 from pot
GuigaMan: doesn't show hand 
*** SUMMARY ***
Total pot $2 | Rake $0 
Seat 2: BGS013
Seat 3: Lucastitos
Seat 4: saral1
Seat 1: ru_ruu_ru (big blind) folded before Flop
Seat 5: Cositorto (button) folded before Flop (didn't bet)
Seat 6: GuigaMan (small blind) collected ($2)



PokerStars Hand #254534676029:  Hold'em No Limit ($0.50/$1.00 USD) - 2025/01/24 20:40:36 WET [2025/01/24 15:40:36 ET]
Table 'Merapi IV' 6-max Seat #6 is the button
Seat 3: Lucastitos ($100 in chips) is sitting out
Seat 4: saral1 ($0 in chips) is sitting out
Seat 1: ru_ruu_ru ($100 in chips) 
Seat 2: BGS013 ($100 in chips) 
Seat 5: Cositorto ($157.03 in chips) 
Seat 6: GuigaMan ($140.87 in chips) 
ru_ruu_ru: posts small blind $0.50
BGS013: posts big blind $1
Lucastitos: sits out 
*** HOLE CARDS ***
Cositorto: raises $1 to $2
saral1 leaves the table
GuigaMan: folds 
ru_ruu_ru: folds 
BGS013: calls $1
*** FLOP *** [9h Td Qh]
BGS013: checks 
Cositorto: bets $2.14
ollyb910 joins the table at seat #4 
ollyb910 is disconnected 
BGS013: raises $6.36 to $8.50
Cositorto: calls $6.36
*** TURN *** [9h Td Qh] [4h]
BGS013: bets $5.50
Cositorto: calls $5.50
*** RIVER *** [9h Td Qh 4h] [6c]
Lucastitos leaves the table
BGS013: bets $10
Cositorto: calls $10
*** SHOW DOWN ***
BGS013: shows [Kh Jc] (a straight, Nine to King)
Cositorto: mucks hand 
BGS013 collected $51.50 from pot
*** SUMMARY ***
Total pot $52.50 | Rake $1 
Board [9h Td Qh 4h 6c]
Seat 3: Lucastitos
Seat 4: saral1
Seat 1: ru_ruu_ru (small blind) folded before Flop
Seat 2: BGS013 (big blind) showed [Kh Jc] and won ($51.50) with a straight, Nine to King
Seat 5: Cositorto mucked
Seat 6: GuigaMan (button) folded before Flop (didn't bet)



PokerStars Hand #254534697741:  Hold'em No Limit ($0.50/$1.00 USD) - 2025/01/24 20:41:48 WET [2025/01/24 15:41:48 ET]
Table 'Merapi IV' 6-max Seat #1 is the button
Seat 1: ru_ruu_ru ($100 in chips) 
Seat 2: BGS013 ($125.50 in chips) 
Seat 4: ollyb910 ($10 in chips) 
Seat 5: Cositorto ($131.03 in chips) 
Seat 6: GuigaMan ($140.87 in chips) 
BGS013: posts small blind $0.50
ollyb910: posts big blind $1
*** HOLE CARDS ***
Cositorto: folds 
GuigaMan: folds 
ru_ruu_ru: folds 
BGS013: folds 
Uncalled bet ($0.50) returned to ollyb910
ollyb910 collected $1 from pot
*** SUMMARY ***
Total pot $1 | Rake $0 
Seat 1: ru_ruu_ru (button) folded before Flop (didn't bet)
Seat 2: BGS013 (small blind) folded before Flop
Seat 4: ollyb910 (big blind) collected ($1)
Seat 5: Cositorto folded before Flop (didn't bet)
Seat 6: GuigaMan folded before Flop (didn't bet)



PokerStars Hand #254534700801:  Hold'em No Limit ($0.50/$1.00 USD) - 2025/01/24 20:41:58 WET [2025/01/24 15:41:58 ET]
Table 'Merapi IV' 6-max Seat #2 is the button
Seat 1: ru_ruu_ru ($100 in chips) 
Seat 2: BGS013 ($125 in chips) 
Seat 4: ollyb910 ($10.50 in chips) 
Seat 5: Cositorto ($131.03 in chips) 
Seat 6: GuigaMan ($140.87 in chips) 
ollyb910: posts small blind $0.50
Cositorto: posts big blind $1
*** HOLE CARDS ***
michasia joins the table at seat #3 
GuigaMan: folds 
ru_ruu_ru: folds 
BGS013: raises $1.50 to $2.50
ollyb910: calls $2
Cositorto: folds 
*** FLOP *** [Kd Jd Qd]
ollyb910: bets $1
BGS013: folds 
Uncalled bet ($1) returned to ollyb910
ollyb910 collected $5.70 from pot
*** SUMMARY ***
Total pot $6 | Rake $0.30 
Board [Kd Jd Qd]
Seat 1: ru_ruu_ru folded before Flop (didn't bet)
Seat 2: BGS013 (button) folded on the Flop
Seat 4: ollyb910 (small blind) collected ($5.70)
Seat 5: Cositorto (big blind) folded before Flop
Seat 6: GuigaMan folded before Flop (didn't bet)



PokerStars Hand #254534711580:  Hold'em No Limit ($0.50/$1.00 USD) - 2025/01/24 20:42:35 WET [2025/01/24 15:42:35 ET]
Table 'Merapi IV' 6-max Seat #4 is the button
Seat 1: ru_ruu_ru ($100 in chips) is sitting out
Seat 2: BGS013 ($122.50 in chips) is sitting out
Seat 6: GuigaMan ($140.87 in chips) is sitting out
Seat 3: michasia ($100 in chips) 
Seat 4: ollyb910 ($13.70 in chips) 
Seat 5: Cositorto ($130.03 in chips) 
Cositorto: posts small blind $0.50
GuigaMan: is sitting out 
ru_ruu_ru: is sitting out 
BGS013: is sitting out 
michasia: posts big blind $1
*** HOLE CARDS ***
ru_ruu_ru leaves the table
ollyb910: calls $1
sta$igk joins the table at seat #1 
Cositorto: folds 
michasia: checks 
*** FLOP *** [Kc Th 6d]
michasia: checks 
BGS013 leaves the table
ollyb910: checks 
*** TURN *** [Kc Th 6d] [Qd]
michasia: checks 
ollyb910: checks 
*** RIVER *** [Kc Th 6d Qd] [Ad]
michasia: checks 
ollyb910: checks 
*** SHOW DOWN ***
michasia: shows [6c 9d] (a pair of Sixes)
ollyb910: mucks hand 
michasia collected $2.38 from pot
*** SUMMARY ***
Total pot $2.50 | Rake $0.12 
Board [Kc Th 6d Qd Ad]
Seat 1: ru_ruu_ru
Seat 2: BGS013
Seat 6: GuigaMan
Seat 3: michasia (big blind) showed [6c 9d] and won ($2.38) with a pair of Sixes
Seat 4: ollyb910 (button) mucked
Seat 5: Cositorto (small blind) folded before Flop



PokerStars Hand #254534721370:  Hold'em No Limit ($0.50/$1.00 USD) - 2025/01/24 20:43:07 WET [2025/01/24 15:43:07 ET]
Table 'Merapi IV' 6-max Seat #5 is the button
Seat 1: sta$igk ($205.64 in chips) is sitting out
Seat 6: GuigaMan ($140.87 in chips) is sitting out
Seat 3: michasia ($101.38 in chips) 
Seat 4: ollyb910 ($12.70 in chips) 
Seat 5: Cositorto ($129.53 in chips) 
michasia: posts small blind $0.50
ollyb910: posts big blind $1
*** HOLE CARDS ***
Cositorto: raises $1.50 to $2.50
michasia: folds 
ollyb910: folds 
Uncalled bet ($1.50) returned to Cositorto
Cositorto collected $2.50 from pot
Cositorto: doesn't show hand 
*** SUMMARY ***
Total pot $2.50 | Rake $0 
Seat 1: sta$igk
Seat 6: GuigaMan
Seat 3: michasia (small blind) folded before Flop
Seat 4: ollyb910 (big blind) folded before Flop
Seat 5: Cositorto (button) collected ($2.50)



PokerStars Hand #254534726707:  Hold'em No Limit ($0.50/$1.00 USD) - 2025/01/24 20:43:24 WET [2025/01/24 15:43:24 ET]
Table 'Merapi IV' 6-max Seat #3 is the button
Seat 1: sta$igk ($205.64 in chips) is sitting out
Seat 6: GuigaMan ($140.87 in chips) is sitting out
Seat 3: michasia ($100.88 in chips) 
Seat 4: ollyb910 ($11.70 in chips) 
Seat 5: Cositorto ($131.03 in chips) 
ollyb910: posts small blind $0.50
Cositorto: posts big blind $1
GuigaMan: sits out 
sta$igk: sits out 
*** HOLE CARDS ***
michasia: raises $1.80 to $2.80
ollyb910: folds 
Cositorto: folds 
Uncalled bet ($1.80) returned to michasia
michasia collected $2.50 from pot
michasia: doesn't show hand 
*** SUMMARY ***
Total pot $2.50 | Rake $0 
Seat 1: sta$igk
Seat 6: GuigaMan
Seat 3: michasia (button) collected ($2.50)
Seat 4: ollyb910 (small blind) folded before Flop
Seat 5: Cositorto (big blind) folded before Flop



PokerStars Hand #254534730990:  Hold'em No Limit ($0.50/$1.00 USD) - 2025/01/24 20:43:39 WET [2025/01/24 15:43:39 ET]
Table 'Merapi IV' 6-max Seat #4 is the button
Seat 1: sta$igk ($205.64 in chips) is sitting out
Seat 3: michasia ($102.38 in chips) 
Seat 4: ollyb910 ($11.20 in chips) 
Seat 5: Cositorto ($130.03 in chips) 
Seat 6: GuigaMan ($140.87 in chips) 
Cositorto: posts small blind $0.50
GuigaMan: posts big blind $1
sta$igk: sits out 
*** HOLE CARDS ***
michasia: folds 
ollyb910: calls $1
JUANS2 joins the table at seat #2 
Cositorto: folds 
GuigaMan: checks 
*** FLOP *** [6h 6c 6s]
GuigaMan: checks 
ollyb910: checks 
*** TURN *** [6h 6c 6s] [8d]
GuigaMan: checks 
ollyb910: checks 
*** RIVER *** [6h 6c 6s 8d] [As]
GuigaMan: checks 
ollyb910: checks 
*** SHOW DOWN ***
GuigaMan: shows [4h 5s] (three of a kind, Sixes)
ollyb910: shows [9c Js] (three of a kind, Sixes - Ace+Jack kicker)
ollyb910 collected $2.38 from pot
*** SUMMARY ***
Total pot $2.50 | Rake $0.12 
Board [6h 6c 6s 8d As]
Seat 1: sta$igk
Seat 3: michasia folded before Flop (didn't bet)
Seat 4: ollyb910 (button) showed [9c Js] and won ($2.38) with three of a kind, Sixes
Seat 5: Cositorto (small blind) folded before Flop
Seat 6: GuigaMan (big blind) showed [4h 5s] and lost with three of a kind, Sixes



PokerStars Hand #254534739610:  Hold'em No Limit ($0.50/$1.00 USD) - 2025/01/24 20:44:08 WET [2025/01/24 15:44:08 ET]
Table 'Merapi IV' 6-max Seat #5 is the button
Seat 2: JUANS2 ($100 in chips) is sitting out
Seat 1: sta$igk ($205.64 in chips) 
Seat 3: michasia ($102.38 in chips) 
Seat 4: ollyb910 ($12.58 in chips) 
Seat 5: Cositorto ($129.53 in chips) 
Seat 6: GuigaMan ($139.87 in chips) 
GuigaMan: posts small blind $0.50
sta$igk: posts big blind $1
JUANS2: sits out 
*** HOLE CARDS ***
michasia: folds 
ollyb910: calls $1
Cositorto: raises $2.50 to $3.50
GuigaMan: folds 
sta$igk: folds 
ollyb910: calls $2.50
*** FLOP *** [4d Qh 7h]
ollyb910: checks 
Cositorto: bets $2.18
ollyb910: folds 
Uncalled bet ($2.18) returned to Cositorto
Cositorto collected $8.08 from pot
Cositorto: doesn't show hand 
*** SUMMARY ***
Total pot $8.50 | Rake $0.42 
Board [4d Qh 7h]
Seat 2: JUANS2
Seat 1: sta$igk (big blind) folded before Flop
Seat 3: michasia folded before Flop (didn't bet)
Seat 4: ollyb910 folded on the Flop
Seat 5: Cositorto (button) collected ($8.08)
Seat 6: GuigaMan (small blind) folded before Flop



PokerStars Hand #254534749177:  Hold'em No Limit ($0.50/$1.00 USD) - 2025/01/24 20:44:39 WET [2025/01/24 15:44:39 ET]
Table 'Merapi IV' 6-max Seat #6 is the button
Seat 1: sta$igk ($204.64 in chips) 
Seat 2: JUANS2 ($100 in chips) 
Seat 3: michasia ($102.38 in chips) 
Seat 4: ollyb910 ($9.08 in chips) 
Seat 5: Cositorto ($134.11 in chips) 
Seat 6: GuigaMan ($139.37 in chips) 
sta$igk: posts small blind $0.50
JUANS2: posts big blind $1
*** HOLE CARDS ***
michasia: folds 
ollyb910: calls $1
Cositorto: folds 
GuigaMan: folds 
sta$igk: folds 
JUANS2: checks 
*** FLOP *** [8s Ah Qc]
JUANS2: checks 
ollyb910: checks 
*** TURN *** [8s Ah Qc] [5s]
JUANS2: bets $1
ollyb910: raises $1 to $2
JUANS2: folds 
Uncalled bet ($1) returned to ollyb910
ollyb910 collected $4.28 from pot
*** SUMMARY ***
Total pot $4.50 | Rake $0.22 
Board [8s Ah Qc 5s]
Seat 1: sta$igk (small blind) folded before Flop
Seat 2: JUANS2 (big blind) folded on the Turn
Seat 3: michasia folded before Flop (didn't bet)
Seat 4: ollyb910 collected ($4.28)
Seat 5: Cositorto folded before Flop (didn't bet)
Seat 6: GuigaMan (button) folded before Flop (didn't bet)



PokerStars Hand #254534758058:  Hold'em No Limit ($0.50/$1.00 USD) - 2025/01/24 20:45:09 WET [2025/01/24 15:45:09 ET]
Table 'Merapi IV' 6-max Seat #1 is the button
Seat 1: sta$igk ($204.14 in chips) 
Seat 2: JUANS2 ($100 in chips) 
Seat 3: michasia ($102.38 in chips) 
Seat 4: ollyb910 ($11.36 in chips) 
Seat 5: Cositorto ($134.11 in chips) 
Seat 6: GuigaMan ($139.37 in chips) 
JUANS2: posts small blind $0.50
michasia: posts big blind $1
*** HOLE CARDS ***
ollyb910: folds 
Cositorto: folds 
GuigaMan: folds 
sta$igk: raises $1.50 to $2.50
JUANS2: raises $8 to $10.50
michasia: folds 
sta$igk: raises $12 to $22.50
JUANS2: raises $77.50 to $100 and is all-in
sta$igk: folds 
Uncalled bet ($77.50) returned to JUANS2
JUANS2 collected $46 from pot
JUANS2: doesn't show hand 
*** SUMMARY ***
Total pot $46 | Rake $0 
Seat 1: sta$igk (button) folded before Flop
Seat 2: JUANS2 (small blind) collected ($46)
Seat 3: michasia (big blind) folded before Flop
Seat 4: ollyb910 folded before Flop (didn't bet)
Seat 5: Cositorto folded before Flop (didn't bet)
Seat 6: GuigaMan folded before Flop (didn't bet)



PokerStars Hand #254534773596:  Hold'em No Limit ($0.50/$1.00 USD) - 2025/01/24 20:46:01 WET [2025/01/24 15:46:01 ET]
Table 'Merapi IV' 6-max Seat #2 is the button
Seat 1: sta$igk ($181.64 in chips) 
Seat 2: JUANS2 ($123.50 in chips) 
Seat 3: michasia ($101.38 in chips) 
Seat 4: ollyb910 ($11.36 in chips) 
Seat 5: Cositorto ($134.11 in chips) 
Seat 6: GuigaMan ($139.37 in chips) 
michasia: posts small blind $0.50
ollyb910: posts big blind $1
*** HOLE CARDS ***
Cositorto: folds 
GuigaMan: raises $1.20 to $2.20
sta$igk: folds 
JUANS2: folds 
michasia: folds 
ollyb910: folds 
Uncalled bet ($1.20) returned to GuigaMan
GuigaMan collected $2.50 from pot
GuigaMan: doesn't show hand 
*** SUMMARY ***
Total pot $2.50 | Rake $0 
Seat 1: sta$igk folded before Flop (didn't bet)
Seat 2: JUANS2 (button) folded before Flop (didn't bet)
Seat 3: michasia (small blind) folded before Flop
Seat 4: ollyb910 (big blind) folded before Flop
Seat 5: Cositorto folded before Flop (didn't bet)
Seat 6: GuigaMan collected ($2.50)



PokerStars Hand #254534783685:  Hold'em No Limit ($0.50/$1.00 USD) - 2025/01/24 20:46:34 WET [2025/01/24 15:46:34 ET]
Table 'Merapi IV' 6-max Seat #3 is the button
Seat 1: sta$igk ($181.64 in chips) 
Seat 2: JUANS2 ($123.50 in chips) 
Seat 3: michasia ($100.88 in chips) 
Seat 4: ollyb910 ($10.36 in chips) 
Seat 5: Cositorto ($134.11 in chips) 
Seat 6: GuigaMan ($140.87 in chips) 
ollyb910: posts small blind $0.50
Cositorto: posts big blind $1
*** HOLE CARDS ***
GuigaMan: raises $1.20 to $2.20
sta$igk: folds 
JUANS2: folds 
michasia: folds 
ollyb910: folds 
Cositorto: calls $1.20
*** FLOP *** [4d Kd Qd]
Cositorto: checks 
GuigaMan: checks 
*** TURN *** [4d Kd Qd] [Ts]
Cositorto: checks 
GuigaMan: checks 
*** RIVER *** [4d Kd Qd Ts] [Ad]
Cositorto: checks 
GuigaMan: checks 
*** SHOW DOWN ***
Cositorto: shows [Qs 7s] (a pair of Queens)
GuigaMan: shows [2c Ac] (a pair of Aces)
GuigaMan collected $4.66 from pot
*** SUMMARY ***
Total pot $4.90 | Rake $0.24 
Board [4d Kd Qd Ts Ad]
Seat 1: sta$igk folded before Flop (didn't bet)
Seat 2: JUANS2 folded before Flop (didn't bet)
Seat 3: michasia (button) folded before Flop (didn't bet)
Seat 4: ollyb910 (small blind) folded before Flop
Seat 5: Cositorto (big blind) showed [Qs 7s] and lost with a pair of Queens
Seat 6: GuigaMan showed [2c Ac] and won ($4.66) with a pair of Aces



PokerStars Hand #254534804177:  Hold'em No Limit ($0.50/$1.00 USD) - 2025/01/24 20:47:43 WET [2025/01/24 15:47:43 ET]
Table 'Merapi IV' 6-max Seat #4 is the button
Seat 1: sta$igk ($181.64 in chips) 
Seat 2: JUANS2 ($123.50 in chips) 
Seat 3: michasia ($100.88 in chips) 
Seat 4: ollyb910 ($9.86 in chips) 
Seat 5: Cositorto ($131.91 in chips) 
Seat 6: GuigaMan ($143.33 in chips) 
Cositorto: posts small blind $0.50
GuigaMan: posts big blind $1
*** HOLE CARDS ***
sta$igk: folds 
JUANS2: folds 
michasia: folds 
ollyb910: calls $1
Cositorto: folds 
GuigaMan: checks 
*** FLOP *** [4d Jc Qd]
GuigaMan: checks 
ollyb910: bets $3
GuigaMan: folds 
Uncalled bet ($3) returned to ollyb910
ollyb910 collected $2.38 from pot
*** SUMMARY ***
Total pot $2.50 | Rake $0.12 
Board [4d Jc Qd]
Seat 1: sta$igk folded before Flop (didn't bet)
Seat 2: JUANS2 folded before Flop (didn't bet)
Seat 3: michasia folded before Flop (didn't bet)
Seat 4: ollyb910 (button) collected ($2.38)
Seat 5: Cositorto (small blind) folded before Flop
Seat 6: GuigaMan (big blind) folded on the Flop



PokerStars Hand #254534813663:  Hold'em No Limit ($0.50/$1.00 USD) - 2025/01/24 20:48:15 WET [2025/01/24 15:48:15 ET]
Table 'Merapi IV' 6-max Seat #5 is the button
Seat 1: sta$igk ($181.64 in chips) 
Seat 2: JUANS2 ($123.50 in chips) 
Seat 3: michasia ($100.88 in chips) 
Seat 4: ollyb910 ($11.24 in chips) 
Seat 5: Cositorto ($131.41 in chips) 
Seat 6: GuigaMan ($142.33 in chips) 
GuigaMan: posts small blind $0.50
sta$igk: posts big blind $1
*** HOLE CARDS ***
JUANS2: folds 
michasia: folds 
ollyb910: calls $1
Cositorto: raises $2.50 to $3.50
GuigaMan: folds 
sta$igk: folds 
ollyb910: calls $2.50
*** FLOP *** [Js 2c 5c]
ollyb910: bets $4
Cositorto: raises $11 to $15
ollyb910: calls $3.74 and is all-in
Uncalled bet ($7.26) returned to Cositorto
*** TURN *** [Js 2c 5c] [Td]
*** RIVER *** [Js 2c 5c Td] [9d]
*** SHOW DOWN ***
ollyb910: shows [Ks Th] (a pair of Tens)
Cositorto: shows [Ah 3h] (high card Ace)
ollyb910 collected $22.78 from pot
*** SUMMARY ***
Total pot $23.98 | Rake $1.20 
Board [Js 2c 5c Td 9d]
Seat 1: sta$igk (big blind) folded before Flop
Seat 2: JUANS2 folded before Flop (didn't bet)
Seat 3: michasia folded before Flop (didn't bet)
Seat 4: ollyb910 showed [Ks Th] and won ($22.78) with a pair of Tens
Seat 5: Cositorto (button) showed [Ah 3h] and lost with high card Ace
Seat 6: GuigaMan (small blind) folded before Flop



PokerStars Hand #254534826354:  Hold'em No Limit ($0.50/$1.00 USD) - 2025/01/24 20:48:57 WET [2025/01/24 15:48:57 ET]
Table 'Merapi IV' 6-max Seat #6 is the button
Seat 1: sta$igk ($180.64 in chips) 
Seat 2: JUANS2 ($123.50 in chips) 
Seat 3: michasia ($100.88 in chips) 
Seat 4: ollyb910 ($22.78 in chips) 
Seat 5: Cositorto ($120.17 in chips) 
Seat 6: GuigaMan ($141.83 in chips) 
sta$igk: posts small blind $0.50
JUANS2: posts big blind $1
*** HOLE CARDS ***
michasia: folds 
ollyb910: calls $1
Cositorto: raises $2 to $3
GuigaMan: folds 
sta$igk: folds 
JUANS2: folds 
ollyb910: calls $2
*** FLOP *** [6c 5s 6d]
ollyb910: checks 
Cositorto: bets $1.92
ollyb910: calls $1.92
*** TURN *** [6c 5s 6d] [Kd]
ollyb910: checks 
Cositorto: bets $9.48
ollyb910: folds 
Uncalled bet ($9.48) returned to Cositorto
Cositorto collected $10.77 from pot
Cositorto: doesn't show hand 
*** SUMMARY ***
Total pot $11.34 | Rake $0.57 
Board [6c 5s 6d Kd]
Seat 1: sta$igk (small blind) folded before Flop
Seat 2: JUANS2 (big blind) folded before Flop
Seat 3: michasia folded before Flop (didn't bet)
Seat 4: ollyb910 folded on the Turn
Seat 5: Cositorto collected ($10.77)
Seat 6: GuigaMan (button) folded before Flop (didn't bet)



PokerStars Hand #254534842921:  Hold'em No Limit ($0.50/$1.00 USD) - 2025/01/24 20:49:52 WET [2025/01/24 15:49:52 ET]
Table 'Merapi IV' 6-max Seat #1 is the button
Seat 1: sta$igk ($180.14 in chips) 
Seat 2: JUANS2 ($122.50 in chips) 
Seat 3: michasia ($100.88 in chips) 
Seat 4: ollyb910 ($17.86 in chips) 
Seat 5: Cositorto ($126.02 in chips) 
Seat 6: GuigaMan ($141.83 in chips) 
JUANS2: posts small blind $0.50
michasia: posts big blind $1
*** HOLE CARDS ***
ollyb910: calls $1
Cositorto: raises $1 to $2
GuigaMan: folds 
sta$igk: folds 
JUANS2: folds 
michasia: folds 
ollyb910: calls $1
*** FLOP *** [3s Td 6h]
ollyb910: checks 
Cositorto: checks 
*** TURN *** [3s Td 6h] [Ac]
ollyb910: checks 
Cositorto: bets $3.50
ollyb910: folds 
Uncalled bet ($3.50) returned to Cositorto
Cositorto collected $5.22 from pot
Cositorto: doesn't show hand 
*** SUMMARY ***
Total pot $5.50 | Rake $0.28 
Board [3s Td 6h Ac]
Seat 1: sta$igk (button) folded before Flop (didn't bet)
Seat 2: JUANS2 (small blind) folded before Flop
Seat 3: michasia (big blind) folded before Flop
Seat 4: ollyb910 folded on the Turn
Seat 5: Cositorto collected ($5.22)
Seat 6: GuigaMan folded before Flop (didn't bet)



PokerStars Hand #254534852270:  Hold'em No Limit ($0.50/$1.00 USD) - 2025/01/24 20:50:23 WET [2025/01/24 15:50:23 ET]
Table 'Merapi IV' 6-max Seat #2 is the button
Seat 1: sta$igk ($180.14 in chips) 
Seat 2: JUANS2 ($122 in chips) 
Seat 3: michasia ($100 in chips) 
Seat 4: ollyb910 ($15.86 in chips) 
Seat 5: Cositorto ($129.24 in chips) 
Seat 6: GuigaMan ($141.83 in chips) 
michasia: posts small blind $0.50
ollyb910: posts big blind $1
*** HOLE CARDS ***
Cositorto: folds 
GuigaMan: folds 
sta$igk: folds 
JUANS2: folds 
michasia: folds 
Uncalled bet ($0.50) returned to ollyb910
ollyb910 collected $1 from pot
*** SUMMARY ***
Total pot $1 | Rake $0 
Seat 1: sta$igk folded before Flop (didn't bet)
Seat 2: JUANS2 (button) folded before Flop (didn't bet)
Seat 3: michasia (small blind) folded before Flop
Seat 4: ollyb910 (big blind) collected ($1)
Seat 5: Cositorto folded before Flop (didn't bet)
Seat 6: GuigaMan folded before Flop (didn't bet)



PokerStars Hand #254534857644:  Hold'em No Limit ($0.50/$1.00 USD) - 2025/01/24 20:50:40 WET [2025/01/24 15:50:40 ET]
Table 'Merapi IV' 6-max Seat #3 is the button
Seat 1: sta$igk ($180.14 in chips) 
Seat 2: JUANS2 ($122 in chips) 
Seat 3: michasia ($100 in chips) 
Seat 4: ollyb910 ($16.36 in chips) 
Seat 5: Cositorto ($129.24 in chips) 
Seat 6: GuigaMan ($141.83 in chips) 
ollyb910: posts small blind $0.50
Cositorto: posts big blind $1
*** HOLE CARDS ***
GuigaMan: folds 
sta$igk: raises $1 to $2
JUANS2: folds 
michasia: folds 
ollyb910: calls $1.50
Cositorto: folds 
*** FLOP *** [7d Kh 5d]
ollyb910: checks 
sta$igk: bets $1.57
ollyb910: calls $1.57
*** TURN *** [7d Kh 5d] [Js]
ollyb910: bets $4
sta$igk: raises $172.57 to $176.57 and is all-in
ollyb910: calls $8.79 and is all-in
Uncalled bet ($163.78) returned to sta$igk
*** RIVER *** [7d Kh 5d Js] [4c]
*** SHOW DOWN ***
ollyb910: shows [Tc Jh] (a pair of Jacks)
sta$igk: shows [Jc 9c] (a pair of Jacks - lower kicker)
ollyb910 collected $32.03 from pot
*** SUMMARY ***
Total pot $33.72 | Rake $1.69 
Board [7d Kh 5d Js 4c]
Seat 1: sta$igk showed [Jc 9c] and lost with a pair of Jacks
Seat 2: JUANS2 folded before Flop (didn't bet)
Seat 3: michasia (button) folded before Flop (didn't bet)
Seat 4: ollyb910 (small blind) showed [Tc Jh] and won ($32.03) with a pair of Jacks
Seat 5: Cositorto (big blind) folded before Flop
Seat 6: GuigaMan folded before Flop (didn't bet)



PokerStars Hand #254534870915:  Hold'em No Limit ($0.50/$1.00 USD) - 2025/01/24 20:51:24 WET [2025/01/24 15:51:24 ET]
Table 'Merapi IV' 6-max Seat #4 is the button
Seat 1: sta$igk ($163.78 in chips) 
Seat 2: JUANS2 ($122 in chips) 
Seat 3: michasia ($100 in chips) 
Seat 4: ollyb910 ($32.03 in chips) 
Seat 5: Cositorto ($128.24 in chips) 
Seat 6: GuigaMan ($141.83 in chips) 
Cositorto: posts small blind $0.50
GuigaMan: posts big blind $1
*** HOLE CARDS ***
sta$igk: folds 
JUANS2: raises $1.50 to $2.50
michasia: raises $5 to $7.50
ollyb910: folds 
Cositorto: folds 
GuigaMan: folds 
JUANS2: folds 
Uncalled bet ($5) returned to michasia
michasia collected $6.50 from pot
michasia: doesn't show hand 
*** SUMMARY ***
Total pot $6.50 | Rake $0 
Seat 1: sta$igk folded before Flop (didn't bet)
Seat 2: JUANS2 folded before Flop
Seat 3: michasia collected ($6.50)
Seat 4: ollyb910 (button) folded before Flop (didn't bet)
Seat 5: Cositorto (small blind) folded before Flop
Seat 6: GuigaMan (big blind) folded before Flop



PokerStars Hand #254534879331:  Hold'em No Limit ($0.50/$1.00 USD) - 2025/01/24 20:51:52 WET [2025/01/24 15:51:52 ET]
Table 'Merapi IV' 6-max Seat #5 is the button
Seat 1: sta$igk ($163.78 in chips) 
Seat 2: JUANS2 ($119.50 in chips) 
Seat 3: michasia ($104 in chips) 
Seat 4: ollyb910 ($32.03 in chips) 
Seat 5: Cositorto ($127.74 in chips) 
Seat 6: GuigaMan ($140.83 in chips) 
GuigaMan: posts small blind $0.50
sta$igk: posts big blind $1
*** HOLE CARDS ***
JUANS2: folds 
michasia: folds 
ollyb910: folds 
Cositorto: folds 
GuigaMan: folds 
Uncalled bet ($0.50) returned to sta$igk
sta$igk collected $1 from pot
sta$igk: doesn't show hand 
*** SUMMARY ***
Total pot $1 | Rake $0 
Seat 1: sta$igk (big blind) collected ($1)
Seat 2: JUANS2 folded before Flop (didn't bet)
Seat 3: michasia folded before Flop (didn't bet)
Seat 4: ollyb910 folded before Flop (didn't bet)
Seat 5: Cositorto (button) folded before Flop (didn't bet)
Seat 6: GuigaMan (small blind) folded before Flop



PokerStars Hand #254534882808:  Hold'em No Limit ($0.50/$1.00 USD) - 2025/01/24 20:52:03 WET [2025/01/24 15:52:03 ET]
Table 'Merapi IV' 6-max Seat #6 is the button
Seat 1: sta$igk ($164.28 in chips) 
Seat 2: JUANS2 ($119.50 in chips) 
Seat 3: michasia ($104 in chips) 
Seat 4: ollyb910 ($32.03 in chips) 
Seat 5: Cositorto ($127.74 in chips) 
Seat 6: GuigaMan ($140.33 in chips) 
sta$igk: posts small blind $0.50
JUANS2: posts big blind $1
*** HOLE CARDS ***
michasia: raises $1.60 to $2.60
ollyb910: calls $2.60
Cositorto: folds 
GuigaMan: folds 
sta$igk: folds 
JUANS2: folds 
*** FLOP *** [8c Kh Kd]
michasia: checks 
ollyb910: bets $1
michasia: calls $1
*** TURN *** [8c Kh Kd] [7h]
michasia: checks 
ollyb910: checks 
*** RIVER *** [8c Kh Kd 7h] [9s]
michasia: checks 
ollyb910: checks 
*** SHOW DOWN ***
michasia: shows [2c 2h] (two pair, Kings and Deuces)
ollyb910: mucks hand 
michasia collected $8.26 from pot
*** SUMMARY ***
Total pot $8.70 | Rake $0.44 
Board [8c Kh Kd 7h 9s]
Seat 1: sta$igk (small blind) folded before Flop
Seat 2: JUANS2 (big blind) folded before Flop
Seat 3: michasia showed [2c 2h] and won ($8.26) with two pair, Kings and Deuces
Seat 4: ollyb910 mucked
Seat 5: Cositorto folded before Flop (didn't bet)
Seat 6: GuigaMan (button) folded before Flop (didn't bet)



PokerStars Hand #254534893306:  Hold'em No Limit ($0.50/$1.00 USD) - 2025/01/24 20:52:39 WET [2025/01/24 15:52:39 ET]
Table 'Merapi IV' 6-max Seat #1 is the button
Seat 1: sta$igk ($163.78 in chips) 
Seat 2: JUANS2 ($118.50 in chips) 
Seat 3: michasia ($108.66 in chips) 
Seat 4: ollyb910 ($28.43 in chips) 
Seat 5: Cositorto ($127.74 in chips) 
Seat 6: GuigaMan ($140.33 in chips) 
JUANS2: posts small blind $0.50
michasia: posts big blind $1
*** HOLE CARDS ***
ollyb910: folds 
Cositorto: folds 
GuigaMan: folds 
sta$igk: folds 
JUANS2: raises $2 to $3
michasia: calls $2
*** FLOP *** [4c Ah 8h]
JUANS2: checks 
michasia: checks 
*** TURN *** [4c Ah 8h] [7s]
JUANS2: bets $4
michasia: folds 
Uncalled bet ($4) returned to JUANS2
JUANS2 collected $5.70 from pot
JUANS2: doesn't show hand 
*** SUMMARY ***
Total pot $6 | Rake $0.30 
Board [4c Ah 8h 7s]
Seat 1: sta$igk (button) folded before Flop (didn't bet)
Seat 2: JUANS2 (small blind) collected ($5.70)
Seat 3: michasia (big blind) folded on the Turn
Seat 4: ollyb910 folded before Flop (didn't bet)
Seat 5: Cositorto folded before Flop (didn't bet)
Seat 6: GuigaMan folded before Flop (didn't bet)



PokerStars Hand #254534905546:  Hold'em No Limit ($0.50/$1.00 USD) - 2025/01/24 20:53:19 WET [2025/01/24 15:53:19 ET]
Table 'Merapi IV' 6-max Seat #2 is the button
Seat 1: sta$igk ($163.78 in chips) 
Seat 2: JUANS2 ($121.20 in chips) 
Seat 3: michasia ($105.66 in chips) 
Seat 4: ollyb910 ($28.43 in chips) 
Seat 5: Cositorto ($127.74 in chips) 
Seat 6: GuigaMan ($140.33 in chips) 
michasia: posts small blind $0.50
ollyb910: posts big blind $1
*** HOLE CARDS ***
Cositorto: folds 
GuigaMan: raises $1.20 to $2.20
sta$igk: folds 
JUANS2: folds 
michasia: folds 
ollyb910: folds 
Uncalled bet ($1.20) returned to GuigaMan
GuigaMan collected $2.50 from pot
GuigaMan: doesn't show hand 
*** SUMMARY ***
Total pot $2.50 | Rake $0 
Seat 1: sta$igk folded before Flop (didn't bet)
Seat 2: JUANS2 (button) folded before Flop (didn't bet)
Seat 3: michasia (small blind) folded before Flop
Seat 4: ollyb910 (big blind) folded before Flop
Seat 5: Cositorto folded before Flop (didn't bet)
Seat 6: GuigaMan collected ($2.50)



PokerStars Hand #254534912647:  Hold'em No Limit ($0.50/$1.00 USD) - 2025/01/24 20:53:43 WET [2025/01/24 15:53:43 ET]
Table 'Merapi IV' 6-max Seat #3 is the button
Seat 1: sta$igk ($163.78 in chips) 
Seat 2: JUANS2 ($121.20 in chips) 
Seat 3: michasia ($105.16 in chips) 
Seat 4: ollyb910 ($27.43 in chips) 
Seat 5: Cositorto ($127.74 in chips) 
Seat 6: GuigaMan ($141.83 in chips) 
ollyb910: posts small blind $0.50
Cositorto: posts big blind $1
*** HOLE CARDS ***
GuigaMan: folds 
sta$igk: folds 
JUANS2: folds 
michasia: raises $1.80 to $2.80
ollyb910: calls $2.30
Cositorto: folds 
*** FLOP *** [4h 2d 9h]
ollyb910: checks 
michasia: bets $2.07
ollyb910: raises $2.07 to $4.14
michasia: folds 
Uncalled bet ($2.07) returned to ollyb910
ollyb910 collected $10.20 from pot
*** SUMMARY ***
Total pot $10.74 | Rake $0.54 
Board [4h 2d 9h]
Seat 1: sta$igk folded before Flop (didn't bet)
Seat 2: JUANS2 folded before Flop (didn't bet)
Seat 3: michasia (button) folded on the Flop
Seat 4: ollyb910 (small blind) collected ($10.20)
Seat 5: Cositorto (big blind) folded before Flop
Seat 6: GuigaMan folded before Flop (didn't bet)



PokerStars Hand #254534925206:  Hold'em No Limit ($0.50/$1.00 USD) - 2025/01/24 20:54:25 WET [2025/01/24 15:54:25 ET]
Table 'Merapi IV' 6-max Seat #4 is the button
Seat 1: sta$igk ($163.78 in chips) 
Seat 2: JUANS2 ($121.20 in chips) 
Seat 3: michasia ($100.29 in chips) 
Seat 4: ollyb910 ($32.76 in chips) 
Seat 5: Cositorto ($126.74 in chips) 
Seat 6: GuigaMan ($141.83 in chips) 
Cositorto: posts small blind $0.50
GuigaMan: posts big blind $1
*** HOLE CARDS ***
sta$igk: folds 
JUANS2: folds 
michasia: folds 
ollyb910: folds 
Cositorto: raises $2 to $3
GuigaMan: folds 
Uncalled bet ($2) returned to Cositorto
Cositorto collected $2 from pot
Cositorto: doesn't show hand 
*** SUMMARY ***
Total pot $2 | Rake $0 
Seat 1: sta$igk folded before Flop (didn't bet)
Seat 2: JUANS2 folded before Flop (didn't bet)
Seat 3: michasia folded before Flop (didn't bet)
Seat 4: ollyb910 (button) folded before Flop (didn't bet)
Seat 5: Cositorto (small blind) collected ($2)
Seat 6: GuigaMan (big blind) folded before Flop



PokerStars Hand #254534934283:  Hold'em No Limit ($0.50/$1.00 USD) - 2025/01/24 20:54:55 WET [2025/01/24 15:54:55 ET]
Table 'Merapi IV' 6-max Seat #5 is the button
Seat 1: sta$igk ($163.78 in chips) 
Seat 2: JUANS2 ($121.20 in chips) 
Seat 3: michasia ($100.29 in chips) 
Seat 4: ollyb910 ($32.76 in chips) 
Seat 5: Cositorto ($127.74 in chips) 
Seat 6: GuigaMan ($140.83 in chips) 
GuigaMan: posts small blind $0.50
sta$igk: posts big blind $1
*** HOLE CARDS ***
JUANS2: folds 
michasia: folds 
ollyb910: calls $1
Cositorto: folds 
GuigaMan: raises $3 to $4
sta$igk: calls $3
ollyb910: calls $3
*** FLOP *** [Td 7d 5c]
GuigaMan: checks 
sta$igk: checks 
ollyb910: checks 
*** TURN *** [Td 7d 5c] [3c]
GuigaMan: checks 
sta$igk: bets $7.64
ollyb910: calls $7.64
GuigaMan: folds 
*** RIVER *** [Td 7d 5c 3c] [4c]
sta$igk: checks 
ollyb910: checks 
*** SHOW DOWN ***
sta$igk: shows [8h 8s] (a pair of Eights)
ollyb910: mucks hand 
sta$igk collected $25.92 from pot
*** SUMMARY ***
Total pot $27.28 | Rake $1.36 
Board [Td 7d 5c 3c 4c]
Seat 1: sta$igk (big blind) showed [8h 8s] and won ($25.92) with a pair of Eights
Seat 2: JUANS2 folded before Flop (didn't bet)
Seat 3: michasia folded before Flop (didn't bet)
Seat 4: ollyb910 mucked
Seat 5: Cositorto (button) folded before Flop (didn't bet)
Seat 6: GuigaMan (small blind) folded on the Turn



PokerStars Hand #254534947826:  Hold'em No Limit ($0.50/$1.00 USD) - 2025/01/24 20:55:53 WET [2025/01/24 15:55:53 ET]
Table 'Merapi IV' 6-max Seat #6 is the button
Seat 1: sta$igk ($178.06 in chips) 
Seat 2: JUANS2 ($121.20 in chips) 
Seat 3: michasia ($100.29 in chips) 
Seat 4: ollyb910 ($21.12 in chips) 
Seat 5: Cositorto ($127.74 in chips) 
Seat 6: GuigaMan ($136.83 in chips) 
sta$igk: posts small blind $0.50
JUANS2: posts big blind $1
*** HOLE CARDS ***
michasia: folds 
ollyb910: folds 
Cositorto: folds 
GuigaMan: folds 
sta$igk: folds 
Uncalled bet ($0.50) returned to JUANS2
JUANS2 collected $1 from pot
JUANS2: doesn't show hand 
*** SUMMARY ***
Total pot $1 | Rake $0 
Seat 1: sta$igk (small blind) folded before Flop
Seat 2: JUANS2 (big blind) collected ($1)
Seat 3: michasia folded before Flop (didn't bet)
Seat 4: ollyb910 folded before Flop (didn't bet)
Seat 5: Cositorto folded before Flop (didn't bet)
Seat 6: GuigaMan (button) folded before Flop (didn't bet)



PokerStars Hand #254534949624:  Hold'em No Limit ($0.50/$1.00 USD) - 2025/01/24 20:56:02 WET [2025/01/24 15:56:02 ET]
Table 'Merapi IV' 6-max Seat #1 is the button
Seat 1: sta$igk ($177.56 in chips) 
Seat 2: JUANS2 ($121.70 in chips) 
Seat 3: michasia ($100.29 in chips) 
Seat 4: ollyb910 ($21.12 in chips) 
Seat 5: Cositorto ($127.74 in chips) 
Seat 6: GuigaMan ($136.83 in chips) 
JUANS2: posts small blind $0.50
michasia: posts big blind $1
*** HOLE CARDS ***
ollyb910: raises $1 to $2
Cositorto: calls $2
GuigaMan: folds 
sta$igk: folds 
JUANS2: folds 
michasia: folds 
*** FLOP *** [9c 6h Tc]
ollyb910: bets $4
Cositorto: calls $4
*** TURN *** [9c 6h Tc] [Qc]
ollyb910: bets $7
Cositorto: calls $7
*** RIVER *** [9c 6h Tc Qc] [3h]
ollyb910: bets $8.12 and is all-in
Cositorto: calls $8.12
*** SHOW DOWN ***
ollyb910: shows [8h 8s] (a pair of Eights)
Cositorto: shows [Th Kh] (a pair of Tens)
Cositorto collected $41.55 from pot
*** SUMMARY ***
Total pot $43.74 | Rake $2.19 
Board [9c 6h Tc Qc 3h]
Seat 1: sta$igk (button) folded before Flop (didn't bet)
Seat 2: JUANS2 (small blind) folded before Flop
Seat 3: michasia (big blind) folded before Flop
Seat 4: ollyb910 showed [8h 8s] and lost with a pair of Eights
Seat 5: Cositorto showed [Th Kh] and won ($41.55) with a pair of Tens
Seat 6: GuigaMan folded before Flop (didn't bet)



PokerStars Hand #254534959209:  Hold'em No Limit ($0.50/$1.00 USD) - 2025/01/24 20:56:47 WET [2025/01/24 15:56:47 ET]
Table 'Merapi IV' 6-max Seat #2 is the button
Seat 4: ollyb910 ($0 in chips) is sitting out
Seat 1: sta$igk ($177.56 in chips) 
Seat 2: JUANS2 ($121.20 in chips) 
Seat 3: michasia ($100 in chips) 
Seat 5: Cositorto ($148.17 in chips) 
Seat 6: GuigaMan ($136.83 in chips) 
michasia: posts small blind $0.50
Cositorto: posts big blind $1
*** HOLE CARDS ***
GuigaMan: folds 
sta$igk: folds 
JUANS2: raises $1.50 to $2.50
michasia: raises $9.50 to $12
Cositorto: raises $14 to $26
JUANS2: folds 
michasia: calls $14
*** FLOP *** [6d 6s 9h]
michasia: checks 
Cositorto: bets $11
michasia: raises $22 to $33
Cositorto: folds 
Uncalled bet ($22) returned to michasia
michasia collected $74 from pot
michasia: doesn't show hand 
*** SUMMARY ***
Total pot $76.50 | Rake $2.50 
Board [6d 6s 9h]
Seat 4: ollyb910
Seat 1: sta$igk folded before Flop (didn't bet)
Seat 2: JUANS2 (button) folded before Flop
Seat 3: michasia (small blind) collected ($74)
Seat 5: Cositorto (big blind) folded on the Flop
Seat 6: GuigaMan folded before Flop (didn't bet)



PokerStars Hand #254534972397:  Hold'em No Limit ($0.50/$1.00 USD) - 2025/01/24 20:57:49 WET [2025/01/24 15:57:49 ET]
Table 'Merapi IV' 6-max Seat #3 is the button
Seat 4: ollyb910 ($12.47 in chips) is sitting out
Seat 1: sta$igk ($177.56 in chips) 
Seat 2: JUANS2 ($118.70 in chips) 
Seat 3: michasia ($137 in chips) 
Seat 5: Cositorto ($111.17 in chips) 
Seat 6: GuigaMan ($136.83 in chips) 
Cositorto: posts small blind $0.50
GuigaMan: posts big blind $1
*** HOLE CARDS ***
sta$igk: folds 
JUANS2: raises $1.50 to $2.50
michasia: folds 
Cositorto: folds 
GuigaMan: folds 
Uncalled bet ($1.50) returned to JUANS2
JUANS2 collected $2.50 from pot
JUANS2: doesn't show hand 
*** SUMMARY ***
Total pot $2.50 | Rake $0 
Seat 4: ollyb910
Seat 1: sta$igk folded before Flop (didn't bet)
Seat 2: JUANS2 collected ($2.50)
Seat 3: michasia (button) folded before Flop (didn't bet)
Seat 5: Cositorto (small blind) folded before Flop
Seat 6: GuigaMan (big blind) folded before Flop



PokerStars Hand #254534977146:  Hold'em No Limit ($0.50/$1.00 USD) - 2025/01/24 20:58:11 WET [2025/01/24 15:58:11 ET]
Table 'Merapi IV' 6-max Seat #5 is the button
Seat 1: sta$igk ($177.56 in chips) 
Seat 2: JUANS2 ($120.20 in chips) 
Seat 3: michasia ($137 in chips) 
Seat 4: ollyb910 ($12.47 in chips) 
Seat 5: Cositorto ($110.67 in chips) 
Seat 6: GuigaMan ($135.83 in chips) 
GuigaMan: posts small blind $0.50
sta$igk: posts big blind $1
ollyb910: posts small & big blinds $1.50
*** HOLE CARDS ***
JUANS2: folds 
michasia: folds 
ollyb910: checks 
Cositorto: folds 
GuigaMan: calls $0.50
sta$igk: checks 
*** FLOP *** [2d Qc Kd]
GuigaMan: checks 
sta$igk: checks 
ollyb910: checks 
*** TURN *** [2d Qc Kd] [Ts]
GuigaMan: checks 
sta$igk: checks 
ollyb910: checks 
*** RIVER *** [2d Qc Kd Ts] [Ad]
GuigaMan: checks 
sta$igk: bets $1.66
ollyb910: folds 
GuigaMan: folds 
Uncalled bet ($1.66) returned to sta$igk
sta$igk collected $3.32 from pot
sta$igk: doesn't show hand 
*** SUMMARY ***
Total pot $3.50 | Rake $0.18 
Board [2d Qc Kd Ts Ad]
Seat 1: sta$igk (big blind) collected ($3.32)
Seat 2: JUANS2 folded before Flop (didn't bet)
Seat 3: michasia folded before Flop (didn't bet)
Seat 4: ollyb910 folded on the River (didn't bet)
Seat 5: Cositorto (button) folded before Flop (didn't bet)
Seat 6: GuigaMan (small blind) folded on the River



PokerStars Hand #254534991493:  Hold'em No Limit ($0.50/$1.00 USD) - 2025/01/24 20:59:17 WET [2025/01/24 15:59:17 ET]
Table 'Merapi IV' 6-max Seat #6 is the button
Seat 1: sta$igk ($179.88 in chips) 
Seat 2: JUANS2 ($120.20 in chips) 
Seat 3: michasia ($137 in chips) 
Seat 4: ollyb910 ($10.97 in chips) 
Seat 5: Cositorto ($110.67 in chips) 
Seat 6: GuigaMan ($134.83 in chips) 
sta$igk: posts small blind $0.50
JUANS2: posts big blind $1
*** HOLE CARDS ***
michasia: folds 
ollyb910: calls $1
Cositorto: folds 
GuigaMan: folds 
sta$igk: folds 
JUANS2: raises $2.50 to $3.50
ollyb910: calls $2.50
*** FLOP *** [Qh 3d 5h]
JUANS2: bets $1
ollyb910: calls $1
*** TURN *** [Qh 3d 5h] [8c]
JUANS2: checks 
ollyb910: bets $2
JUANS2: raises $6.51 to $8.51
ollyb910: calls $4.47 and is all-in
Uncalled bet ($2.04) returned to JUANS2
*** RIVER *** [Qh 3d 5h 8c] [Ad]
*** SHOW DOWN ***
JUANS2: shows [Ks Kh] (a pair of Kings)
ollyb910: shows [2s Jh] (high card Ace)
JUANS2 collected $21.32 from pot
*** SUMMARY ***
Total pot $22.44 | Rake $1.12 
Board [Qh 3d 5h 8c Ad]
Seat 1: sta$igk (small blind) folded before Flop
Seat 2: JUANS2 (big blind) showed [Ks Kh] and won ($21.32) with a pair of Kings
Seat 3: michasia folded before Flop (didn't bet)
Seat 4: ollyb910 showed [2s Jh] and lost with high card Ace
Seat 5: Cositorto folded before Flop (didn't bet)
Seat 6: GuigaMan (button) folded before Flop (didn't bet)



PokerStars Hand #254535002753:  Hold'em No Limit ($0.50/$1.00 USD) - 2025/01/24 21:00:10 WET [2025/01/24 16:00:10 ET]
Table 'Merapi IV' 6-max Seat #1 is the button
Seat 3: michasia ($137 in chips) is sitting out
Seat 4: ollyb910 ($0 in chips) is sitting out
Seat 1: sta$igk ($179.38 in chips) 
Seat 2: JUANS2 ($130.55 in chips) 
Seat 5: Cositorto ($110.67 in chips) 
Seat 6: GuigaMan ($134.83 in chips) 
JUANS2: posts small blind $0.50
michasia: is sitting out 
Cositorto: posts big blind $1
*** HOLE CARDS ***
GuigaMan: folds 
sta$igk: folds 
JUANS2: folds 
Uncalled bet ($0.50) returned to Cositorto
ollyb910 is disconnected 
Cositorto collected $1 from pot
Cositorto: doesn't show hand 
*** SUMMARY ***
Total pot $1 | Rake $0 
Seat 3: michasia
Seat 4: ollyb910
Seat 1: sta$igk (button) folded before Flop (didn't bet)
Seat 2: JUANS2 (small blind) folded before Flop
Seat 5: Cositorto (big blind) collected ($1)
Seat 6: GuigaMan folded before Flop (didn't bet)



PokerStars Hand #254535004744:  Hold'em No Limit ($0.50/$1.00 USD) - 2025/01/24 21:00:19 WET [2025/01/24 16:00:19 ET]
Table 'Merapi IV' 6-max Seat #2 is the button
Seat 3: michasia ($137 in chips) is sitting out
Seat 4: ollyb910 ($0 in chips) is sitting out
Seat 1: sta$igk ($179.38 in chips) 
Seat 2: JUANS2 ($130.05 in chips) 
Seat 5: Cositorto ($111.17 in chips) 
Seat 6: GuigaMan ($134.83 in chips) 
Cositorto: posts small blind $0.50
GuigaMan: posts big blind $1
*** HOLE CARDS ***
sta$igk: folds 
JUANS2: raises $1.50 to $2.50
Cositorto: folds 
GuigaMan: folds 
Uncalled bet ($1.50) returned to JUANS2
JUANS2 collected $2.50 from pot
JUANS2: doesn't show hand 
*** SUMMARY ***
Total pot $2.50 | Rake $0 
Seat 3: michasia
Seat 4: ollyb910
Seat 1: sta$igk folded before Flop (didn't bet)
Seat 2: JUANS2 (button) collected ($2.50)
Seat 5: Cositorto (small blind) folded before Flop
Seat 6: GuigaMan (big blind) folded before Flop



PokerStars Hand #254535009454:  Hold'em No Limit ($0.50/$1.00 USD) - 2025/01/24 21:00:39 WET [2025/01/24 16:00:39 ET]
Table 'Merapi IV' 6-max Seat #5 is the button
Seat 3: michasia ($137 in chips) is sitting out
Seat 4: ollyb910 ($0 in chips) is sitting out
Seat 1: sta$igk ($179.38 in chips) 
Seat 2: JUANS2 ($131.55 in chips) 
Seat 5: Cositorto ($110.67 in chips) 
Seat 6: GuigaMan ($133.83 in chips) 
GuigaMan: posts small blind $0.50
sta$igk: posts big blind $1
michasia: sits out 
*** HOLE CARDS ***
JUANS2: folds 
Cositorto: folds 
GuigaMan: raises $2 to $3
sta$igk: calls $2
*** FLOP *** [7s 7c Td]
GuigaMan: checks 
sta$igk: checks 
*** TURN *** [7s 7c Td] [Kh]
GuigaMan: bets $4.28
sta$igk: folds 
Uncalled bet ($4.28) returned to GuigaMan
GuigaMan collected $5.70 from pot
GuigaMan: doesn't show hand 
*** SUMMARY ***
Total pot $6 | Rake $0.30 
Board [7s 7c Td Kh]
Seat 3: michasia
Seat 4: ollyb910
Seat 1: sta$igk (big blind) folded on the Turn
Seat 2: JUANS2 folded before Flop (didn't bet)
Seat 5: Cositorto (button) folded before Flop (didn't bet)
Seat 6: GuigaMan (small blind) collected ($5.70)



PokerStars Hand #254535022630:  Hold'em No Limit ($0.50/$1.00 USD) - 2025/01/24 21:01:31 WET [2025/01/24 16:01:31 ET]
Table 'Merapi IV' 6-max Seat #6 is the button
Seat 2: JUANS2 ($131.55 in chips) is sitting out
Seat 4: ollyb910 ($0 in chips) is sitting out
Seat 1: sta$igk ($176.38 in chips) 
Seat 3: michasia ($137 in chips) 
Seat 5: Cositorto ($110.67 in chips) 
Seat 6: GuigaMan ($136.53 in chips) 
sta$igk: posts small blind $0.50
JUANS2: is sitting out 
michasia: posts big blind $1
*** HOLE CARDS ***
Cositorto: folds 
JUANS2 leaves the table
GuigaMan: folds 
sta$igk: folds 
Uncalled bet ($0.50) returned to michasia
michasia collected $1 from pot
michasia: doesn't show hand 
*** SUMMARY ***
Total pot $1 | Rake $0 
Seat 2: JUANS2
Seat 4: ollyb910
Seat 1: sta$igk (small blind) folded before Flop
Seat 3: michasia (big blind) collected ($1)
Seat 5: Cositorto folded before Flop (didn't bet)
Seat 6: GuigaMan (button) folded before Flop (didn't bet)



PokerStars Hand #254535025209:  Hold'em No Limit ($0.50/$1.00 USD) - 2025/01/24 21:01:41 WET [2025/01/24 16:01:41 ET]
Table 'Merapi IV' 6-max Seat #1 is the button
Seat 4: ollyb910 ($0 in chips) is sitting out
Seat 1: sta$igk ($175.88 in chips) 
Seat 3: michasia ($137.50 in chips) 
Seat 5: Cositorto ($110.67 in chips) 
Seat 6: GuigaMan ($136.53 in chips) 
michasia: posts small blind $0.50
Cositorto: posts big blind $1
*** HOLE CARDS ***
GuigaMan: folds 
sta$igk: folds 
michasia: raises $2 to $3
Cositorto: folds 
Uncalled bet ($2) returned to michasia
michasia collected $2 from pot
michasia: doesn't show hand 
*** SUMMARY ***
Total pot $2 | Rake $0 
Seat 4: ollyb910
Seat 1: sta$igk (button) folded before Flop (didn't bet)
Seat 3: michasia (small blind) collected ($2)
Seat 5: Cositorto (big blind) folded before Flop
Seat 6: GuigaMan folded before Flop (didn't bet)



PokerStars Hand #254535028552:  Hold'em No Limit ($0.50/$1.00 USD) - 2025/01/24 21:01:52 WET [2025/01/24 16:01:52 ET]
Table 'Merapi IV' 6-max Seat #3 is the button
Seat 4: ollyb910 ($0 in chips) is sitting out
Seat 1: sta$igk ($175.88 in chips) 
Seat 3: michasia ($138.50 in chips) 
Seat 5: Cositorto ($109.67 in chips) 
Seat 6: GuigaMan ($136.53 in chips) 
Cositorto: posts small blind $0.50
GuigaMan: posts big blind $1
*** HOLE CARDS ***
sta$igk: raises $1.50 to $2.50
michasia: folds 
Cositorto: folds 
GuigaMan: calls $1.50
*** FLOP *** [2h As Ah]
GuigaMan: checks 
sta$igk: bets $1.72
GuigaMan: folds 
Uncalled bet ($1.72) returned to sta$igk
sta$igk collected $5.22 from pot
sta$igk: doesn't show hand 
*** SUMMARY ***
Total pot $5.50 | Rake $0.28 
Board [2h As Ah]
Seat 4: ollyb910
Seat 1: sta$igk collected ($5.22)
Seat 3: michasia (button) folded before Flop (didn't bet)
Seat 5: Cositorto (small blind) folded before Flop
Seat 6: GuigaMan (big blind) folded on the Flop



PokerStars Hand #254535035039:  Hold'em No Limit ($0.50/$1.00 USD) - 2025/01/24 21:02:14 WET [2025/01/24 16:02:14 ET]
Table 'Merapi IV' 6-max Seat #5 is the button
Seat 1: sta$igk ($178.60 in chips) is sitting out
Seat 4: ollyb910 ($0 in chips) is sitting out
Seat 3: michasia ($138.50 in chips) 
Seat 5: Cositorto ($109.17 in chips) 
Seat 6: GuigaMan ($134.03 in chips) 
GuigaMan: posts small blind $0.50
sta$igk: is sitting out 
michasia: posts big blind $1
*** HOLE CARDS ***
Cositorto: raises $1.50 to $2.50
sta$igk leaves the table
GuigaMan: folds 
michasia: folds 
Uncalled bet ($1.50) returned to Cositorto
Cositorto collected $2.50 from pot
Cositorto: doesn't show hand 
*** SUMMARY ***
Total pot $2.50 | Rake $0 
Seat 1: sta$igk
Seat 4: ollyb910
Seat 3: michasia (big blind) folded before Flop
Seat 5: Cositorto (button) collected ($2.50)
Seat 6: GuigaMan (small blind) folded before Flop



PokerStars Hand #254535038620:  Hold'em No Limit ($0.50/$1.00 USD) - 2025/01/24 21:02:27 WET [2025/01/24 16:02:27 ET]
Table 'Merapi IV' 6-max Seat #6 is the button
Seat 4: ollyb910 ($0 in chips) is sitting out
Seat 3: michasia ($137.50 in chips) 
Seat 5: Cositorto ($110.67 in chips) 
Seat 6: GuigaMan ($133.53 in chips) 
michasia: posts small blind $0.50
Cositorto: posts big blind $1
*** HOLE CARDS ***
GuigaMan: raises $1.50 to $2.50
itaba joins the table at seat #2 
michasia: folds 
Cositorto: raises $8.75 to $11.25
GuigaMan: calls $8.75
*** FLOP *** [7h 8c 3d]
Cositorto: checks 
GuigaMan: bets $6.60
Cositorto: calls $6.60
*** TURN *** [7h 8c 3d] [5s]
Cositorto: checks 
GuigaMan: checks 
*** RIVER *** [7h 8c 3d 5s] [Ts]
Cositorto: checks 
GuigaMan: bets $26.40
Cositorto: calls $26.40
*** SHOW DOWN ***
GuigaMan: shows [Ah 4h] (high card Ace)
Cositorto: shows [Tc Ac] (a pair of Tens)
Cositorto collected $88 from pot
*** SUMMARY ***
Total pot $89 | Rake $1 
Board [7h 8c 3d 5s Ts]
Seat 4: ollyb910
Seat 3: michasia (small blind) folded before Flop
Seat 5: Cositorto (big blind) showed [Tc Ac] and won ($88) with a pair of Tens
Seat 6: GuigaMan (button) showed [Ah 4h] and lost with high card Ace



PokerStars Hand #254535057696:  Hold'em No Limit ($0.50/$1.00 USD) - 2025/01/24 21:03:31 WET [2025/01/24 16:03:31 ET]
Table 'Merapi IV' 6-max Seat #3 is the button
Seat 2: itaba ($10 in chips) is sitting out
Seat 4: ollyb910 ($0 in chips) is sitting out
Seat 3: michasia ($137 in chips) 
Seat 5: Cositorto ($154.42 in chips) 
Seat 6: GuigaMan ($100 in chips) 
Cositorto: posts small blind $0.50
GuigaMan: posts big blind $1
itaba: sits out 
*** HOLE CARDS ***
michasia: raises $1.80 to $2.80
Cositorto: folds 
GuigaMan: folds 
Uncalled bet ($1.80) returned to michasia
michasia collected $2.50 from pot
michasia: doesn't show hand 
*** SUMMARY ***
Total pot $2.50 | Rake $0 
Seat 2: itaba
Seat 4: ollyb910
Seat 3: michasia (button) collected ($2.50)
Seat 5: Cositorto (small blind) folded before Flop
Seat 6: GuigaMan (big blind) folded before Flop



PokerStars Hand #254535061915:  Hold'em No Limit ($0.50/$1.00 USD) - 2025/01/24 21:03:45 WET [2025/01/24 16:03:45 ET]
Table 'Merapi IV' 6-max Seat #5 is the button
Seat 4: ollyb910 ($0 in chips) is sitting out
Seat 2: itaba ($10 in chips) 
Seat 3: michasia ($138.50 in chips) 
Seat 5: Cositorto ($153.92 in chips) 
Seat 6: GuigaMan ($100 in chips) 
GuigaMan: posts small blind $0.50
itaba: posts big blind $1
*** HOLE CARDS ***
michasia: folds 
Cositorto: folds 
GuigaMan: folds 
Uncalled bet ($0.50) returned to itaba
itaba collected $1 from pot
itaba: doesn't show hand 
*** SUMMARY ***
Total pot $1 | Rake $0 
Seat 4: ollyb910
Seat 2: itaba (big blind) collected ($1)
Seat 3: michasia folded before Flop (didn't bet)
Seat 5: Cositorto (button) folded before Flop (didn't bet)
Seat 6: GuigaMan (small blind) folded before Flop



PokerStars Hand #254535064719:  Hold'em No Limit ($0.50/$1.00 USD) - 2025/01/24 21:03:54 WET [2025/01/24 16:03:54 ET]
Table 'Merapi IV' 6-max Seat #6 is the button
Seat 4: ollyb910 ($0 in chips) is sitting out
Seat 2: itaba ($10.50 in chips) 
Seat 3: michasia ($138.50 in chips) 
Seat 5: Cositorto ($153.92 in chips) 
Seat 6: GuigaMan ($100 in chips) 
itaba: posts small blind $0.50
michasia: posts big blind $1
*** HOLE CARDS ***
Cositorto: folds 
GuigaMan: folds 
itaba: raises $9.50 to $10.50 and is all-in
michasia: calls $9.50
*** FLOP *** [3c 7c 6c]
*** TURN *** [3c 7c 6c] [Ah]
*** RIVER *** [3c 7c 6c Ah] [Th]
*** SHOW DOWN ***
itaba: shows [5h 5c] (a pair of Fives)
michasia: shows [As 4h] (a pair of Aces)
michasia collected $20 from pot
*** SUMMARY ***
Total pot $21 | Rake $1 
Board [3c 7c 6c Ah Th]
Seat 4: ollyb910
Seat 2: itaba (small blind) showed [5h 5c] and lost with a pair of Fives
Seat 3: michasia (big blind) showed [As 4h] and won ($20) with a pair of Aces
Seat 5: Cositorto folded before Flop (didn't bet)
Seat 6: GuigaMan (button) folded before Flop (didn't bet)



PokerStars Hand #254535070616:  Hold'em No Limit ($0.50/$1.00 USD) - 2025/01/24 21:04:14 WET [2025/01/24 16:04:14 ET]
Table 'Merapi IV' 6-max Seat #2 is the button
Seat 4: ollyb910 ($0 in chips) is sitting out
Seat 2: itaba ($10 in chips) 
Seat 3: michasia ($148 in chips) 
Seat 5: Cositorto ($153.92 in chips) 
Seat 6: GuigaMan ($100 in chips) 
michasia: posts small blind $0.50
Cositorto: posts big blind $1
*** HOLE CARDS ***
GuigaMan: folds 
itaba: raises $9 to $10 and is all-in
michasia: folds 
Cositorto: folds 
Uncalled bet ($9) returned to itaba
itaba collected $2.50 from pot
ollyb910 leaves the table
itaba: doesn't show hand 
*** SUMMARY ***
Total pot $2.50 | Rake $0 
Seat 4: ollyb910
Seat 2: itaba (button) collected ($2.50)
Seat 3: michasia (small blind) folded before Flop
Seat 5: Cositorto (big blind) folded before Flop
Seat 6: GuigaMan folded before Flop (didn't bet)



PokerStars Hand #254535074196:  Hold'em No Limit ($0.50/$1.00 USD) - 2025/01/24 21:04:25 WET [2025/01/24 16:04:25 ET]
Table 'Merapi IV' 6-max Seat #3 is the button
Seat 2: itaba ($11.50 in chips) 
Seat 3: michasia ($147.50 in chips) 
Seat 5: Cositorto ($152.92 in chips) 
Seat 6: GuigaMan ($100 in chips) 
Cositorto: posts small blind $0.50
GuigaMan: posts big blind $1
*** HOLE CARDS ***
itaba: folds 
michasia: raises $1.80 to $2.80
Cositorto: folds 
GuigaMan: folds 
Uncalled bet ($1.80) returned to michasia
michasia collected $2.50 from pot
michasia: doesn't show hand 
*** SUMMARY ***
Total pot $2.50 | Rake $0 
Seat 2: itaba folded before Flop (didn't bet)
Seat 3: michasia (button) collected ($2.50)
Seat 5: Cositorto (small blind) folded before Flop
Seat 6: GuigaMan (big blind) folded before Flop



PokerStars Hand #254535080671:  Hold'em No Limit ($0.50/$1.00 USD) - 2025/01/24 21:04:46 WET [2025/01/24 16:04:46 ET]
Table 'Merapi IV' 6-max Seat #5 is the button
Seat 2: itaba ($11.50 in chips) 
Seat 3: michasia ($149 in chips) 
Seat 5: Cositorto ($152.42 in chips) 
Seat 6: GuigaMan ($100 in chips) 
GuigaMan: posts small blind $0.50
itaba: posts big blind $1
*** HOLE CARDS ***
michasia: raises $1.80 to $2.80
Cositorto: folds 
GuigaMan: folds 
itaba: folds 
Uncalled bet ($1.80) returned to michasia
michasia collected $2.50 from pot
michasia: doesn't show hand 
*** SUMMARY ***
Total pot $2.50 | Rake $0 
Seat 2: itaba (big blind) folded before Flop
Seat 3: michasia collected ($2.50)
Seat 5: Cositorto (button) folded before Flop (didn't bet)
Seat 6: GuigaMan (small blind) folded before Flop



PokerStars Hand #254535084981:  Hold'em No Limit ($0.50/$1.00 USD) - 2025/01/24 21:05:00 WET [2025/01/24 16:05:00 ET]
Table 'Merapi IV' 6-max Seat #6 is the button
Seat 3: michasia ($150.50 in chips) is sitting out
Seat 2: itaba ($10.50 in chips) 
Seat 5: Cositorto ($152.42 in chips) 
Seat 6: GuigaMan ($100 in chips) 
itaba: posts small blind $0.50
michasia: is sitting out 
Cositorto: posts big blind $1
*** HOLE CARDS ***
michasia leaves the table
GuigaMan: raises $1.50 to $2.50
itaba: folds 
Cositorto: folds 
Uncalled bet ($1.50) returned to GuigaMan
GuigaMan collected $2.50 from pot
GuigaMan: doesn't show hand 
michasia joins the table at seat #3 
*** SUMMARY ***
Total pot $2.50 | Rake $0 
Seat 3: michasia
Seat 2: itaba (small blind) folded before Flop
Seat 5: Cositorto (big blind) folded before Flop
Seat 6: GuigaMan (button) collected ($2.50)



PokerStars Hand #254535088605:  Hold'em No Limit ($0.50/$1.00 USD) - 2025/01/24 21:05:12 WET [2025/01/24 16:05:12 ET]
Table 'Merapi IV' 6-max Seat #5 is the button
Seat 3: michasia ($150.50 in chips) is sitting out
Seat 6: GuigaMan ($101.50 in chips) is sitting out
Seat 2: itaba ($10 in chips) 
Seat 5: Cositorto ($151.42 in chips) 
Cositorto: posts small blind $0.50
GuigaMan: is sitting out 
itaba: posts big blind $1
*** HOLE CARDS ***
GuigaMan leaves the table
Cositorto: folds 
Uncalled bet ($0.50) returned to itaba
itaba collected $1 from pot
itaba: doesn't show hand 
*** SUMMARY ***
Total pot $1 | Rake $0 
Seat 3: michasia
Seat 6: GuigaMan
Seat 2: itaba (big blind) collected ($1)
Seat 5: Cositorto (button) (small blind) folded before Flop



PokerStars Hand #254535091114:  Hold'em No Limit ($0.50/$1.00 USD) - 2025/01/24 21:05:21 WET [2025/01/24 16:05:21 ET]
Table 'Merapi IV' 6-max Seat #5 is the button
Seat 2: itaba ($10.50 in chips) 
Seat 3: michasia ($150.50 in chips) 
Seat 5: Cositorto ($150.92 in chips) 
itaba: posts small blind $0.50
michasia: posts big blind $1
*** HOLE CARDS ***
Cositorto: raises $1.50 to $2.50
itaba: folds 
michasia: calls $1.50
*** FLOP *** [4c 3c Td]
michasia: checks 
Cositorto: bets $1.41
michasia: calls $1.41
*** TURN *** [4c 3c Td] [3h]
michasia: checks 
Cositorto: checks 
*** RIVER *** [4c 3c Td 3h] [2h]
michasia: checks 
Cositorto: checks 
*** SHOW DOWN ***
michasia: shows [2d Qd] (two pair, Threes and Deuces)
Cositorto: mucks hand 
michasia collected $7.90 from pot
*** SUMMARY ***
Total pot $8.32 | Rake $0.42 
Board [4c 3c Td 3h 2h]
Seat 2: itaba (small blind) folded before Flop
Seat 3: michasia (big blind) showed [2d Qd] and won ($7.90) with two pair, Threes and Deuces
Seat 5: Cositorto (button) mucked



PokerStars Hand #254535105281:  Hold'em No Limit ($0.50/$1.00 USD) - 2025/01/24 21:06:07 WET [2025/01/24 16:06:07 ET]
Table 'Merapi IV' 6-max Seat #2 is the button
Seat 2: itaba ($10 in chips) 
Seat 3: michasia ($154.49 in chips) 
Seat 5: Cositorto ($147.01 in chips) 
michasia: posts small blind $0.50
Cositorto: posts big blind $1
*** HOLE CARDS ***
itaba: folds 
michasia: raises $2 to $3
Cositorto: calls $2
*** FLOP *** [9d Td 7d]
michasia: checks 
Cositorto: bets $1.54
michasia: calls $1.54
*** TURN *** [9d Td 7d] [8h]
michasia: checks 
Cositorto: bets $2.85
michasia: calls $2.85
*** RIVER *** [9d Td 7d 8h] [6c]
michasia: checks 
Cositorto: bets $24.50
michasia: folds 
Uncalled bet ($24.50) returned to Cositorto
Cositorto collected $14.04 from pot
Cositorto: doesn't show hand 
*** SUMMARY ***
Total pot $14.78 | Rake $0.74 
Board [9d Td 7d 8h 6c]
Seat 2: itaba (button) folded before Flop (didn't bet)
Seat 3: michasia (small blind) folded on the River
Seat 5: Cositorto (big blind) collected ($14.04)



PokerStars Hand #254535125534:  Hold'em No Limit ($0.50/$1.00 USD) - 2025/01/24 21:07:13 WET [2025/01/24 16:07:13 ET]
Table 'Merapi IV' 6-max Seat #3 is the button
Seat 2: itaba ($10 in chips) 
Seat 3: michasia ($147.10 in chips) 
Seat 5: Cositorto ($153.66 in chips) 
Cositorto: posts small blind $0.50
itaba: posts big blind $1
*** HOLE CARDS ***
michasia: folds 
Cositorto: raises $2 to $3
michasia leaves the table
itaba: folds 
Uncalled bet ($2) returned to Cositorto
Cositorto collected $2 from pot
Cositorto: doesn't show hand 
beauté815 joins the table at seat #1 
*** SUMMARY ***
Total pot $2 | Rake $0 
Seat 2: itaba (big blind) folded before Flop
Seat 3: michasia (button) folded before Flop (didn't bet)
Seat 5: Cositorto (small blind) collected ($2)



PokerStars Hand #254535133562:  Hold'em No Limit ($0.50/$1.00 USD) - 2025/01/24 21:07:39 WET [2025/01/24 16:07:39 ET]
Table 'Merapi IV' 6-max Seat #2 is the button
Seat 1: beauté815 ($10 in chips) is sitting out
Seat 2: itaba ($9 in chips) 
Seat 5: Cositorto ($154.66 in chips) 
itaba: posts small blind $0.50
Cositorto: posts big blind $1
*** HOLE CARDS ***
sta$igk joins the table at seat #3 
itaba: calls $0.50
Cositorto: raises $2 to $3
YeeesMan joins the table at seat #6 
itaba: calls $2
*** FLOP *** [Jh 5h 4c]
Cositorto: bets $1.54
p0pa4poker joins the table at seat #4 
itaba: calls $1.54
*** TURN *** [Jh 5h 4c] [9s]
Cositorto: bets $8.63
itaba: calls $4.46 and is all-in
Uncalled bet ($4.17) returned to Cositorto
*** RIVER *** [Jh 5h 4c 9s] [7c]
*** SHOW DOWN ***
Cositorto: shows [Ac As] (a pair of Aces)
itaba: shows [Qd 5s] (a pair of Fives)
Cositorto collected $17.10 from pot
*** SUMMARY ***
Total pot $18 | Rake $0.90 
Board [Jh 5h 4c 9s 7c]
Seat 1: beauté815
Seat 2: itaba (button) (small blind) showed [Qd 5s] and lost with a pair of Fives
Seat 5: Cositorto (big blind) showed [Ac As] and won ($17.10) with a pair of Aces



PokerStars Hand #254535148393:  Hold'em No Limit ($0.50/$1.00 USD) - 2025/01/24 21:08:28 WET [2025/01/24 16:08:28 ET]
Table 'Merapi IV' 6-max Seat #5 is the button
Seat 1: beauté815 ($35.43 in chips) is sitting out
Seat 4: p0pa4poker ($100 in chips) is sitting out
Seat 6: YeeesMan ($100 in chips) is sitting out
Seat 2: itaba ($10 in chips) 
Seat 3: sta$igk ($178.60 in chips) 
Seat 5: Cositorto ($162.76 in chips) 
itaba: posts small blind $0.50
sta$igk: posts big blind $1
p0pa4poker: sits out 
*** HOLE CARDS ***
Cositorto: raises $1.50 to $2.50
itaba: folds 
sta$igk: calls $1.50
*** FLOP *** [8h Qh 6h]
sta$igk: checks 
Cositorto: bets $1.41
sta$igk: folds 
Uncalled bet ($1.41) returned to Cositorto
Cositorto collected $5.22 from pot
Cositorto: doesn't show hand 
*** SUMMARY ***
Total pot $5.50 | Rake $0.28 
Board [8h Qh 6h]
Seat 1: beauté815
Seat 4: p0pa4poker
Seat 6: YeeesMan
Seat 2: itaba (small blind) folded before Flop
Seat 3: sta$igk (big blind) folded on the Flop
Seat 5: Cositorto (button) collected ($5.22)



PokerStars Hand #254535156984:  Hold'em No Limit ($0.50/$1.00 USD) - 2025/01/24 21:08:56 WET [2025/01/24 16:08:56 ET]
Table 'Merapi IV' 6-max Seat #2 is the button
Seat 6: YeeesMan ($100 in chips) is sitting out
Seat 1: beauté815 ($35.43 in chips) 
Seat 2: itaba ($9.50 in chips) 
Seat 3: sta$igk ($176.10 in chips) 
Seat 4: p0pa4poker ($100 in chips) 
Seat 5: Cositorto ($165.48 in chips) 
sta$igk: posts small blind $0.50
p0pa4poker: posts big blind $1
YeeesMan: sits out 
beauté815: posts small & big blinds $1.50
*** HOLE CARDS ***
Cositorto: folds 
beauté815: checks 
itaba: folds 
sta$igk: folds 
p0pa4poker: checks 
*** FLOP *** [9s Kd 6s]
p0pa4poker: checks 
beauté815: bets $1
p0pa4poker: folds 
Uncalled bet ($1) returned to beauté815
beauté815 collected $2.85 from pot
beauté815: doesn't show hand 
*** SUMMARY ***
Total pot $3 | Rake $0.15 
Board [9s Kd 6s]
Seat 6: YeeesMan
Seat 1: beauté815 collected ($2.85)
Seat 2: itaba (button) folded before Flop (didn't bet)
Seat 3: sta$igk (small blind) folded before Flop
Seat 4: p0pa4poker (big blind) folded on the Flop
Seat 5: Cositorto folded before Flop (didn't bet)



PokerStars Hand #254535165242:  Hold'em No Limit ($0.50/$1.00 USD) - 2025/01/24 21:09:24 WET [2025/01/24 16:09:24 ET]
Table 'Merapi IV' 6-max Seat #3 is the button
Seat 6: YeeesMan ($100 in chips) is sitting out
Seat 1: beauté815 ($36.78 in chips) 
Seat 2: itaba ($9.50 in chips) 
Seat 3: sta$igk ($175.60 in chips) 
Seat 4: p0pa4poker ($100 in chips) 
Seat 5: Cositorto ($165.48 in chips) 
p0pa4poker: posts small blind $0.50
Cositorto: posts big blind $1
YeeesMan: sits out 
*** HOLE CARDS ***
beauté815: folds 
itaba: raises $8.50 to $9.50 and is all-in
sta$igk: folds 
p0pa4poker: folds 
Cositorto: folds 
Uncalled bet ($8.50) returned to itaba
itaba collected $2.50 from pot
itaba: doesn't show hand 
*** SUMMARY ***
Total pot $2.50 | Rake $0 
Seat 6: YeeesMan
Seat 1: beauté815 folded before Flop (didn't bet)
Seat 2: itaba collected ($2.50)
Seat 3: sta$igk (button) folded before Flop (didn't bet)
Seat 4: p0pa4poker (small blind) folded before Flop
Seat 5: Cositorto (big blind) folded before Flop



PokerStars Hand #254535170891:  Hold'em No Limit ($0.50/$1.00 USD) - 2025/01/24 21:09:42 WET [2025/01/24 16:09:42 ET]
Table 'Merapi IV' 6-max Seat #4 is the button
Seat 1: beauté815 ($36.78 in chips) 
Seat 2: itaba ($11 in chips) 
Seat 3: sta$igk ($175.60 in chips) 
Seat 4: p0pa4poker ($99.50 in chips) 
Seat 5: Cositorto ($164.48 in chips) 
Seat 6: YeeesMan ($100 in chips) 
Cositorto: posts small blind $0.50
YeeesMan: posts big blind $1
*** HOLE CARDS ***
beauté815: folds 
itaba: folds 
sta$igk: folds 
p0pa4poker: folds 
Cositorto: folds 
Uncalled bet ($0.50) returned to YeeesMan
YeeesMan collected $1 from pot
YeeesMan: doesn't show hand 
*** SUMMARY ***
Total pot $1 | Rake $0 
Seat 1: beauté815 folded before Flop (didn't bet)
Seat 2: itaba folded before Flop (didn't bet)
Seat 3: sta$igk folded before Flop (didn't bet)
Seat 4: p0pa4poker (button) folded before Flop (didn't bet)
Seat 5: Cositorto (small blind) folded before Flop
Seat 6: YeeesMan (big blind) collected ($1)



PokerStars Hand #254535174311:  Hold'em No Limit ($0.50/$1.00 USD) - 2025/01/24 21:09:54 WET [2025/01/24 16:09:54 ET]
Table 'Merapi IV' 6-max Seat #5 is the button
Seat 1: beauté815 ($36.78 in chips) 
Seat 2: itaba ($11 in chips) 
Seat 3: sta$igk ($175.60 in chips) 
Seat 4: p0pa4poker ($99.50 in chips) 
Seat 5: Cositorto ($163.98 in chips) 
Seat 6: YeeesMan ($100.50 in chips) 
YeeesMan: posts small blind $0.50
beauté815: posts big blind $1
*** HOLE CARDS ***
itaba: folds 
sta$igk: folds 
p0pa4poker: folds 
Cositorto: folds 
YeeesMan: raises $1 to $2
beauté815: raises $3 to $5
YeeesMan: folds 
Uncalled bet ($3) returned to beauté815
beauté815 collected $4 from pot
beauté815: doesn't show hand 
*** SUMMARY ***
Total pot $4 | Rake $0 
Seat 1: beauté815 (big blind) collected ($4)
Seat 2: itaba folded before Flop (didn't bet)
Seat 3: sta$igk folded before Flop (didn't bet)
Seat 4: p0pa4poker folded before Flop (didn't bet)
Seat 5: Cositorto (button) folded before Flop (didn't bet)
Seat 6: YeeesMan (small blind) folded before Flop



PokerStars Hand #254535181544:  Hold'em No Limit ($0.50/$1.00 USD) - 2025/01/24 21:10:18 WET [2025/01/24 16:10:18 ET]
Table 'Merapi IV' 6-max Seat #6 is the button
Seat 1: beauté815 ($38.78 in chips) 
Seat 2: itaba ($11 in chips) 
Seat 3: sta$igk ($175.60 in chips) 
Seat 4: p0pa4poker ($99.50 in chips) 
Seat 5: Cositorto ($163.98 in chips) 
Seat 6: YeeesMan ($100 in chips) 
beauté815: posts small blind $0.50
itaba: posts big blind $1
*** HOLE CARDS ***
sta$igk: folds 
p0pa4poker: raises $2 to $3
Cositorto: folds 
YeeesMan: folds 
beauté815: calls $2.50
itaba: folds 
*** FLOP *** [4c Js 7h]
beauté815: checks 
p0pa4poker: bets $1.73
beauté815: calls $1.73
*** TURN *** [4c Js 7h] [6c]
beauté815: checks 
p0pa4poker: bets $3.28
beauté815: calls $3.28
*** RIVER *** [4c Js 7h 6c] [5s]
beauté815: checks 
p0pa4poker: checks 
*** SHOW DOWN ***
beauté815: shows [Jh Jc] (three of a kind, Jacks)
p0pa4poker: mucks hand 
beauté815 collected $16.17 from pot
*** SUMMARY ***
Total pot $17.02 | Rake $0.85 
Board [4c Js 7h 6c 5s]
Seat 1: beauté815 (small blind) showed [Jh Jc] and won ($16.17) with three of a kind, Jacks
Seat 2: itaba (big blind) folded before Flop
Seat 3: sta$igk folded before Flop (didn't bet)
Seat 4: p0pa4poker mucked
Seat 5: Cositorto folded before Flop (didn't bet)
Seat 6: YeeesMan (button) folded before Flop (didn't bet)



PokerStars Hand #254535196877:  Hold'em No Limit ($0.50/$1.00 USD) - 2025/01/24 21:11:08 WET [2025/01/24 16:11:08 ET]
Table 'Merapi IV' 6-max Seat #1 is the button
Seat 1: beauté815 ($46.94 in chips) 
Seat 2: itaba ($10 in chips) 
Seat 3: sta$igk ($175.60 in chips) 
Seat 4: p0pa4poker ($96.72 in chips) 
Seat 5: Cositorto ($163.98 in chips) 
Seat 6: YeeesMan ($100 in chips) 
itaba: posts small blind $0.50
sta$igk: posts big blind $1
*** HOLE CARDS ***
p0pa4poker: raises $1 to $2
Cositorto: folds 
YeeesMan: folds 
beauté815: folds 
itaba: folds 
sta$igk: folds 
Uncalled bet ($1) returned to p0pa4poker
p0pa4poker collected $2.50 from pot
p0pa4poker: doesn't show hand 
*** SUMMARY ***
Total pot $2.50 | Rake $0 
Seat 1: beauté815 (button) folded before Flop (didn't bet)
Seat 2: itaba (small blind) folded before Flop
Seat 3: sta$igk (big blind) folded before Flop
Seat 4: p0pa4poker collected ($2.50)
Seat 5: Cositorto folded before Flop (didn't bet)
Seat 6: YeeesMan folded before Flop (didn't bet)



PokerStars Hand #254535204448:  Hold'em No Limit ($0.50/$1.00 USD) - 2025/01/24 21:11:32 WET [2025/01/24 16:11:32 ET]
Table 'Merapi IV' 6-max Seat #2 is the button
Seat 1: beauté815 ($46.94 in chips) 
Seat 2: itaba ($9.50 in chips) 
Seat 3: sta$igk ($174.60 in chips) 
Seat 4: p0pa4poker ($98.22 in chips) 
Seat 5: Cositorto ($163.98 in chips) 
Seat 6: YeeesMan ($100 in chips) 
sta$igk: posts small blind $0.50
p0pa4poker: posts big blind $1
*** HOLE CARDS ***
Cositorto: folds 
YeeesMan: folds 
beauté815: folds 
itaba: folds 
sta$igk: raises $2 to $3
p0pa4poker: calls $2
*** FLOP *** [9d Qc As]
sta$igk: checks 
p0pa4poker: checks 
*** TURN *** [9d Qc As] [3c]
sta$igk: checks 
p0pa4poker: checks 
*** RIVER *** [9d Qc As 3c] [Td]
sta$igk: checks 
p0pa4poker: checks 
*** SHOW DOWN ***
sta$igk: shows [Ad 7d] (a pair of Aces)
p0pa4poker: mucks hand 
sta$igk collected $5.70 from pot
*** SUMMARY ***
Total pot $6 | Rake $0.30 
Board [9d Qc As 3c Td]
Seat 1: beauté815 folded before Flop (didn't bet)
Seat 2: itaba (button) folded before Flop (didn't bet)
Seat 3: sta$igk (small blind) showed [Ad 7d] and won ($5.70) with a pair of Aces
Seat 4: p0pa4poker (big blind) mucked
Seat 5: Cositorto folded before Flop (didn't bet)
Seat 6: YeeesMan folded before Flop (didn't bet)



PokerStars Hand #254535237736:  Hold'em No Limit ($0.50/$1.00 USD) - 2025/01/24 21:13:19 WET [2025/01/24 16:13:19 ET]
Table 'Merapi IV' 6-max Seat #3 is the button
Seat 1: beauté815 ($46.94 in chips) 
Seat 2: itaba ($18.50 in chips) 
Seat 3: sta$igk ($177.30 in chips) 
Seat 4: p0pa4poker ($100 in chips) 
Seat 5: Cositorto ($163.98 in chips) 
Seat 6: YeeesMan ($100 in chips) 
p0pa4poker: posts small blind $0.50
Cositorto: posts big blind $1
*** HOLE CARDS ***
YeeesMan: raises $1.50 to $2.50
beauté815: folds 
itaba: folds 
sta$igk: raises $5.50 to $8
p0pa4poker: folds 
Cositorto: folds 
YeeesMan: raises $16 to $24
sta$igk: raises $153.30 to $177.30 and is all-in
YeeesMan: calls $76 and is all-in
Uncalled bet ($77.30) returned to sta$igk
*** FIRST FLOP *** [Qh 8s 3c]
*** FIRST TURN *** [Qh 8s 3c] [Ks]
*** FIRST RIVER *** [Qh 8s 3c Ks] [3h]
*** SECOND FLOP *** [9s 8h 2h]
*** SECOND TURN *** [9s 8h 2h] [5h]
*** SECOND RIVER *** [9s 8h 2h 5h] [6s]
*** FIRST SHOW DOWN ***
YeeesMan: shows [Kd Ac] (two pair, Kings and Threes)
sta$igk: shows [Kh Ah] (two pair, Kings and Threes)
YeeesMan collected $49.75 from pot
sta$igk collected $49.75 from pot
*** SECOND SHOW DOWN ***
YeeesMan: shows [Kd Ac] (high card Ace)
sta$igk: shows [Kh Ah] (a flush, Ace high)
sta$igk collected $99.50 from pot
*** SUMMARY ***
Total pot $201.50 | Rake $2.50 
Hand was run twice
FIRST Board [Qh 8s 3c Ks 3h]
SECOND Board [9s 8h 2h 5h 6s]
Seat 1: beauté815 folded before Flop (didn't bet)
Seat 2: itaba folded before Flop (didn't bet)
Seat 3: sta$igk (button) showed [Kh Ah] and won ($49.75) with two pair, Kings and Threes, and won ($99.50) with a flush, Ace high
Seat 4: p0pa4poker (small blind) folded before Flop
Seat 5: Cositorto (big blind) folded before Flop
Seat 6: YeeesMan showed [Kd Ac] and won ($49.75) with two pair, Kings and Threes, and lost with high card Ace



PokerStars Hand #254535257810:  Hold'em No Limit ($0.50/$1.00 USD) - 2025/01/24 21:14:24 WET [2025/01/24 16:14:24 ET]
Table 'Merapi IV' 6-max Seat #4 is the button
Seat 1: beauté815 ($46.94 in chips) 
Seat 2: itaba ($18.50 in chips) 
Seat 3: sta$igk ($226.55 in chips) 
Seat 4: p0pa4poker ($99.50 in chips) 
Seat 5: Cositorto ($162.98 in chips) 
Seat 6: YeeesMan ($100 in chips) 
Cositorto: posts small blind $0.50
YeeesMan: posts big blind $1
*** HOLE CARDS ***
beauté815: folds 
itaba: raises $1 to $2
sta$igk: folds 
p0pa4poker: folds 
Cositorto: folds 
YeeesMan: folds 
Uncalled bet ($1) returned to itaba
itaba collected $2.50 from pot
itaba: doesn't show hand 
*** SUMMARY ***
Total pot $2.50 | Rake $0 
Seat 1: beauté815 folded before Flop (didn't bet)
Seat 2: itaba collected ($2.50)
Seat 3: sta$igk folded before Flop (didn't bet)
Seat 4: p0pa4poker (button) folded before Flop (didn't bet)
Seat 5: Cositorto (small blind) folded before Flop
Seat 6: YeeesMan (big blind) folded before Flop



PokerStars Hand #254535269766:  Hold'em No Limit ($0.50/$1.00 USD) - 2025/01/24 21:15:01 WET [2025/01/24 16:15:01 ET]
Table 'Merapi IV' 6-max Seat #5 is the button
Seat 1: beauté815 ($46.94 in chips) 
Seat 2: itaba ($20 in chips) 
Seat 3: sta$igk ($226.55 in chips) 
Seat 4: p0pa4poker ($99.50 in chips) 
Seat 5: Cositorto ($162.48 in chips) 
Seat 6: YeeesMan ($100 in chips) 
YeeesMan: posts small blind $0.50
beauté815: posts big blind $1
*** HOLE CARDS ***
itaba: raises $1 to $2
sta$igk: folds 
p0pa4poker: folds 
Cositorto: folds 
YeeesMan: raises $9 to $11
beauté815: folds 
itaba: folds 
Uncalled bet ($9) returned to YeeesMan
YeeesMan collected $5 from pot
YeeesMan: doesn't show hand 
*** SUMMARY ***
Total pot $5 | Rake $0 
Seat 1: beauté815 (big blind) folded before Flop
Seat 2: itaba folded before Flop
Seat 3: sta$igk folded before Flop (didn't bet)
Seat 4: p0pa4poker folded before Flop (didn't bet)
Seat 5: Cositorto (button) folded before Flop (didn't bet)
Seat 6: YeeesMan (small blind) collected ($5)



PokerStars Hand #254535278713:  Hold'em No Limit ($0.50/$1.00 USD) - 2025/01/24 21:15:30 WET [2025/01/24 16:15:30 ET]
Table 'Merapi IV' 6-max Seat #6 is the button
Seat 2: itaba ($18 in chips) is sitting out
Seat 1: beauté815 ($45.94 in chips) 
Seat 3: sta$igk ($226.55 in chips) 
Seat 4: p0pa4poker ($100 in chips) 
Seat 5: Cositorto ($162.48 in chips) 
Seat 6: YeeesMan ($103 in chips) 
beauté815: posts small blind $0.50
itaba: is sitting out 
sta$igk: posts big blind $1
*** HOLE CARDS ***
itaba leaves the table
p0pa4poker: folds 
BoyLoc0 joins the table at seat #2 
Cositorto: folds 
YeeesMan: raises $1.50 to $2.50
beauté815: calls $2
sta$igk: folds 
*** FLOP *** [As Qh Ah]
beauté815: checks 
YeeesMan: bets $1.88
beauté815: folds 
Uncalled bet ($1.88) returned to YeeesMan
YeeesMan collected $5.70 from pot
YeeesMan: doesn't show hand 
*** SUMMARY ***
Total pot $6 | Rake $0.30 
Board [As Qh Ah]
Seat 2: itaba
Seat 1: beauté815 (small blind) folded on the Flop
Seat 3: sta$igk (big blind) folded before Flop
Seat 4: p0pa4poker folded before Flop (didn't bet)
Seat 5: Cositorto folded before Flop (didn't bet)
Seat 6: YeeesMan (button) collected ($5.70)



PokerStars Hand #254535294937:  Hold'em No Limit ($0.50/$1.00 USD) - 2025/01/24 21:16:20 WET [2025/01/24 16:16:20 ET]
Table 'Merapi IV' 6-max Seat #1 is the button
Seat 2: BoyLoc0 ($100 in chips) is sitting out
Seat 1: beauté815 ($43.44 in chips) 
Seat 3: sta$igk ($225.55 in chips) 
Seat 4: p0pa4poker ($100 in chips) 
Seat 5: Cositorto ($162.48 in chips) 
Seat 6: YeeesMan ($106.20 in chips) 
sta$igk: posts small blind $0.50
p0pa4poker: posts big blind $1
*** HOLE CARDS ***
Cositorto: folds 
YeeesMan: folds 
beauté815: calls $1
sta$igk: calls $0.50
p0pa4poker: checks 
*** FLOP *** [4d 3c Tc]
sta$igk: checks 
p0pa4poker: checks 
beauté815: checks 
*** TURN *** [4d 3c Tc] [Ah]
sta$igk: checks 
p0pa4poker: checks 
beauté815: bets $2.85
sta$igk: folds 
p0pa4poker: folds 
Uncalled bet ($2.85) returned to beauté815
beauté815 collected $2.85 from pot
beauté815: doesn't show hand 
*** SUMMARY ***
Total pot $3 | Rake $0.15 
Board [4d 3c Tc Ah]
Seat 2: BoyLoc0
Seat 1: beauté815 (button) collected ($2.85)
Seat 3: sta$igk (small blind) folded on the Turn
Seat 4: p0pa4poker (big blind) folded on the Turn
Seat 5: Cositorto folded before Flop (didn't bet)
Seat 6: YeeesMan folded before Flop (didn't bet)



PokerStars Hand #254535309462:  Hold'em No Limit ($0.50/$1.00 USD) - 2025/01/24 21:17:06 WET [2025/01/24 16:17:06 ET]
Table 'Merapi IV' 6-max Seat #3 is the button
Seat 2: BoyLoc0 ($100 in chips) is sitting out
Seat 1: beauté815 ($45.29 in chips) 
Seat 3: sta$igk ($224.55 in chips) 
Seat 4: p0pa4poker ($100 in chips) 
Seat 5: Cositorto ($162.48 in chips) 
Seat 6: YeeesMan ($106.20 in chips) 
p0pa4poker: posts small blind $0.50
Cositorto: posts big blind $1
BoyLoc0: sits out 
*** HOLE CARDS ***
YeeesMan: folds 
beauté815: raises $1 to $2
sta$igk: folds 
p0pa4poker: folds 
Cositorto: calls $1
*** FLOP *** [As 6h Kh]
Cositorto: checks 
beauté815: bets $3
Cositorto: raises $5.14 to $8.14
beauté815: folds 
Uncalled bet ($5.14) returned to Cositorto
Cositorto collected $9.98 from pot
Cositorto: doesn't show hand 
*** SUMMARY ***
Total pot $10.50 | Rake $0.52 
Board [As 6h Kh]
Seat 2: BoyLoc0
Seat 1: beauté815 folded on the Flop
Seat 3: sta$igk (button) folded before Flop (didn't bet)
Seat 4: p0pa4poker (small blind) folded before Flop
Seat 5: Cositorto (big blind) collected ($9.98)
Seat 6: YeeesMan folded before Flop (didn't bet)



PokerStars Hand #254535320196:  Hold'em No Limit ($0.50/$1.00 USD) - 2025/01/24 21:17:40 WET [2025/01/24 16:17:40 ET]
Table 'Merapi IV' 6-max Seat #4 is the button
Seat 2: BoyLoc0 ($100 in chips) is sitting out
Seat 6: YeeesMan ($106.20 in chips) is sitting out
Seat 1: beauté815 ($40.29 in chips) 
Seat 3: sta$igk ($224.55 in chips) 
Seat 4: p0pa4poker ($100 in chips) 
Seat 5: Cositorto ($167.46 in chips) 
Cositorto: posts small blind $0.50
YeeesMan: is sitting out 
beauté815: posts big blind $1
BoyLoc0: sits out 
*** HOLE CARDS ***
sta$igk: folds 
p0pa4poker: raises $1.50 to $2.50
YeeesMan leaves the table
Cositorto: folds 
beauté815: calls $1.50
*** FLOP *** [5s Jc Ts]
beauté815: checks 
p0pa4poker: checks 
*** TURN *** [5s Jc Ts] [Qs]
beauté815: bets $3
p0pa4poker: folds 
Uncalled bet ($3) returned to beauté815
beauté815 collected $5.22 from pot
beauté815: doesn't show hand 
*** SUMMARY ***
Total pot $5.50 | Rake $0.28 
Board [5s Jc Ts Qs]
Seat 2: BoyLoc0
Seat 6: YeeesMan
Seat 1: beauté815 (big blind) collected ($5.22)
Seat 3: sta$igk folded before Flop (didn't bet)
Seat 4: p0pa4poker (button) folded on the Turn
Seat 5: Cositorto (small blind) folded before Flop



PokerStars Hand #254535332059:  Hold'em No Limit ($0.50/$1.00 USD) - 2025/01/24 21:18:18 WET [2025/01/24 16:18:18 ET]
Table 'Merapi IV' 6-max Seat #5 is the button
Seat 1: beauté815 ($43.01 in chips) 
Seat 2: BoyLoc0 ($100 in chips) 
Seat 3: sta$igk ($224.55 in chips) 
Seat 4: p0pa4poker ($100 in chips) 
Seat 5: Cositorto ($166.96 in chips) 
beauté815: posts small blind $0.50
BoyLoc0: posts big blind $1
*** HOLE CARDS ***
sta$igk: folds 
vadjkeee joins the table at seat #6 
p0pa4poker: raises $1.30 to $2.30
Cositorto: raises $4.70 to $7
beauté815: calls $6.50
BoyLoc0: folds 
p0pa4poker: raises $15 to $22
Cositorto: folds 
beauté815: folds 
Uncalled bet ($15) returned to p0pa4poker
p0pa4poker collected $22 from pot
p0pa4poker: doesn't show hand 
*** SUMMARY ***
Total pot $22 | Rake $0 
Seat 1: beauté815 (small blind) folded before Flop
Seat 2: BoyLoc0 (big blind) folded before Flop
Seat 3: sta$igk folded before Flop (didn't bet)
Seat 4: p0pa4poker collected ($22)
Seat 5: Cositorto (button) folded before Flop



PokerStars Hand #254535346537:  Hold'em No Limit ($0.50/$1.00 USD) - 2025/01/24 21:19:03 WET [2025/01/24 16:19:03 ET]
Table 'Merapi IV' 6-max Seat #1 is the button
Seat 6: vadjkeee ($100 in chips) is sitting out
Seat 1: beauté815 ($36.01 in chips) 
Seat 2: BoyLoc0 ($100 in chips) 
Seat 3: sta$igk ($224.55 in chips) 
Seat 4: p0pa4poker ($115 in chips) 
Seat 5: Cositorto ($159.96 in chips) 
BoyLoc0: posts small blind $0.50
sta$igk: posts big blind $1
vadjkeee: sits out 
*** HOLE CARDS ***
p0pa4poker: raises $1 to $2
Cositorto: folds 
beauté815: folds 
BoyLoc0: folds 
sta$igk: folds 
Uncalled bet ($1) returned to p0pa4poker
p0pa4poker collected $2.50 from pot
p0pa4poker: doesn't show hand 
*** SUMMARY ***
Total pot $2.50 | Rake $0 
Seat 6: vadjkeee
Seat 1: beauté815 (button) folded before Flop (didn't bet)
Seat 2: BoyLoc0 (small blind) folded before Flop
Seat 3: sta$igk (big blind) folded before Flop
Seat 4: p0pa4poker collected ($2.50)
Seat 5: Cositorto folded before Flop (didn't bet)



PokerStars Hand #254535350930:  Hold'em No Limit ($0.50/$1.00 USD) - 2025/01/24 21:19:17 WET [2025/01/24 16:19:17 ET]
Table 'Merapi IV' 6-max Seat #2 is the button
Seat 6: vadjkeee ($100 in chips) is sitting out
Seat 1: beauté815 ($36.01 in chips) 
Seat 2: BoyLoc0 ($100 in chips) 
Seat 3: sta$igk ($223.55 in chips) 
Seat 4: p0pa4poker ($116.50 in chips) 
Seat 5: Cositorto ($159.96 in chips) 
sta$igk: posts small blind $0.50
p0pa4poker: posts big blind $1
vadjkeee: sits out 
*** HOLE CARDS ***
Cositorto: folds 
beauté815: calls $1
BoyLoc0: raises $3 to $4
sta$igk: folds 
p0pa4poker has timed out
p0pa4poker: folds 
beauté815: calls $3
*** FLOP *** [9h 5h Th]
beauté815: checks 
BoyLoc0: checks 
*** TURN *** [9h 5h Th] [3c]
beauté815: bets $5
BoyLoc0: folds 
Uncalled bet ($5) returned to beauté815
beauté815 collected $9.02 from pot
beauté815: doesn't show hand 
*** SUMMARY ***
Total pot $9.50 | Rake $0.48 
Board [9h 5h Th 3c]
Seat 6: vadjkeee
Seat 1: beauté815 collected ($9.02)
Seat 2: BoyLoc0 (button) folded on the Turn
Seat 3: sta$igk (small blind) folded before Flop
Seat 4: p0pa4poker (big blind) folded before Flop
Seat 5: Cositorto folded before Flop (didn't bet)



PokerStars Hand #254535374053:  Hold'em No Limit ($0.50/$1.00 USD) - 2025/01/24 21:20:31 WET [2025/01/24 16:20:31 ET]
Table 'Merapi IV' 6-max Seat #3 is the button
Seat 6: vadjkeee ($100 in chips) is sitting out
Seat 1: beauté815 ($41.03 in chips) 
Seat 2: BoyLoc0 ($100 in chips) 
Seat 3: sta$igk ($223.05 in chips) 
Seat 4: p0pa4poker ($115.50 in chips) 
Seat 5: Cositorto ($159.96 in chips) 
p0pa4poker: posts small blind $0.50
Cositorto: posts big blind $1
vadjkeee: sits out 
*** HOLE CARDS ***
beauté815: folds 
BoyLoc0: folds 
sta$igk: raises $1.50 to $2.50
p0pa4poker: folds 
Cositorto: raises $8.75 to $11.25
sta$igk: raises $13.75 to $25
Cositorto: calls $13.75
*** FLOP *** [6c 5s Qs]
Cositorto: checks 
sta$igk: bets $15.84
Cositorto: calls $15.84
*** TURN *** [6c 5s Qs] [7d]
Cositorto: checks 
sta$igk: checks 
*** RIVER *** [6c 5s Qs 7d] [3d]
Cositorto: checks 
sta$igk: bets $25
Cositorto: calls $25
*** SHOW DOWN ***
sta$igk: shows [As Ah] (a pair of Aces)
Cositorto: mucks hand 
sta$igk collected $129.68 from pot
*** SUMMARY ***
Total pot $132.18 | Rake $2.50 
Board [6c 5s Qs 7d 3d]
Seat 6: vadjkeee
Seat 1: beauté815 folded before Flop (didn't bet)
Seat 2: BoyLoc0 folded before Flop (didn't bet)
Seat 3: sta$igk (button) showed [As Ah] and won ($129.68) with a pair of Aces
Seat 4: p0pa4poker (small blind) folded before Flop
Seat 5: Cositorto (big blind) mucked



PokerStars Hand #254535415135:  Hold'em No Limit ($0.50/$1.00 USD) - 2025/01/24 21:22:41 WET [2025/01/24 16:22:41 ET]
Table 'Merapi IV' 6-max Seat #4 is the button
Seat 1: beauté815 ($41.03 in chips) 
Seat 2: BoyLoc0 ($100 in chips) 
Seat 3: sta$igk ($286.89 in chips) 
Seat 4: p0pa4poker ($115 in chips) 
Seat 5: Cositorto ($100 in chips) 
Seat 6: vadjkeee ($100 in chips) 
Cositorto: posts small blind $0.50
vadjkeee: posts big blind $1
*** HOLE CARDS ***
beauté815: folds 
BoyLoc0: raises $1.50 to $2.50
sta$igk: folds 
p0pa4poker: folds 
Cositorto: folds 
vadjkeee: raises $9.50 to $12
BoyLoc0: folds 
Uncalled bet ($9.50) returned to vadjkeee
sta$igk leaves the table
vadjkeee collected $5.50 from pot
vadjkeee: doesn't show hand 
michasia joins the table at seat #3 
*** SUMMARY ***
Total pot $5.50 | Rake $0 
Seat 1: beauté815 folded before Flop (didn't bet)
Seat 2: BoyLoc0 folded before Flop
Seat 3: sta$igk folded before Flop (didn't bet)
Seat 4: p0pa4poker (button) folded before Flop (didn't bet)
Seat 5: Cositorto (small blind) folded before Flop
Seat 6: vadjkeee (big blind) collected ($5.50)



PokerStars Hand #254535425974:  Hold'em No Limit ($0.50/$1.00 USD) - 2025/01/24 21:23:15 WET [2025/01/24 16:23:15 ET]
Table 'Merapi IV' 6-max Seat #5 is the button
Seat 3: michasia ($147.10 in chips) is sitting out
Seat 1: beauté815 ($41.03 in chips) 
Seat 2: BoyLoc0 ($100 in chips) 
Seat 4: p0pa4poker ($115 in chips) 
Seat 5: Cositorto ($100 in chips) 
Seat 6: vadjkeee ($103 in chips) 
vadjkeee: posts small blind $0.50
beauté815: posts big blind $1
michasia: sits out 
*** HOLE CARDS ***
BoyLoc0: folds 
p0pa4poker: raises $1.30 to $2.30
Cositorto: folds 
vadjkeee: folds 
beauté815: calls $1.30
*** FLOP *** [8s 8d Ah]
beauté815: checks 
p0pa4poker: bets $1.26
beauté815: calls $1.26
*** TURN *** [8s 8d Ah] [Qh]
beauté815: checks 
p0pa4poker: bets $1.18
beauté815: raises $4.82 to $6
p0pa4poker: folds 
Uncalled bet ($4.82) returned to beauté815
beauté815 collected $9.48 from pot
beauté815: doesn't show hand 
*** SUMMARY ***
Total pot $9.98 | Rake $0.50 
Board [8s 8d Ah Qh]
Seat 3: michasia
Seat 1: beauté815 (big blind) collected ($9.48)
Seat 2: BoyLoc0 folded before Flop (didn't bet)
Seat 4: p0pa4poker folded on the Turn
Seat 5: Cositorto (button) folded before Flop (didn't bet)
Seat 6: vadjkeee (small blind) folded before Flop



PokerStars Hand #254535438122:  Hold'em No Limit ($0.50/$1.00 USD) - 2025/01/24 21:23:54 WET [2025/01/24 16:23:54 ET]
Table 'Merapi IV' 6-max Seat #6 is the button
Seat 3: michasia ($147.10 in chips) is sitting out
Seat 1: beauté815 ($45.77 in chips) 
Seat 2: BoyLoc0 ($100 in chips) 
Seat 4: p0pa4poker ($110.26 in chips) 
Seat 5: Cositorto ($100 in chips) 
Seat 6: vadjkeee ($102.50 in chips) 
beauté815: posts small blind $0.50
BoyLoc0: posts big blind $1
michasia: sits out 
*** HOLE CARDS ***
p0pa4poker: folds 
Cositorto: folds 
vadjkeee: raises $1.50 to $2.50
beauté815: calls $2
BoyLoc0: folds 
*** FLOP *** [2c Qh 5c]
beauté815: checks 
vadjkeee: bets $1.88
beauté815: calls $1.88
*** TURN *** [2c Qh 5c] [Qd]
beauté815: bets $3
vadjkeee: calls $3
*** RIVER *** [2c Qh 5c Qd] [4h]
beauté815: bets $3
vadjkeee: folds 
Uncalled bet ($3) returned to beauté815
beauté815 collected $14.97 from pot
beauté815: doesn't show hand 
*** SUMMARY ***
Total pot $15.76 | Rake $0.79 
Board [2c Qh 5c Qd 4h]
Seat 3: michasia
Seat 1: beauté815 (small blind) collected ($14.97)
Seat 2: BoyLoc0 (big blind) folded before Flop
Seat 4: p0pa4poker folded before Flop (didn't bet)
Seat 5: Cositorto folded before Flop (didn't bet)
Seat 6: vadjkeee (button) folded on the River



PokerStars Hand #254535453168:  Hold'em No Limit ($0.50/$1.00 USD) - 2025/01/24 21:24:42 WET [2025/01/24 16:24:42 ET]
Table 'Merapi IV' 6-max Seat #1 is the button
Seat 1: beauté815 ($53.36 in chips) 
Seat 2: BoyLoc0 ($100 in chips) 
Seat 3: michasia ($147.10 in chips) 
Seat 4: p0pa4poker ($110.26 in chips) 
Seat 5: Cositorto ($100 in chips) 
Seat 6: vadjkeee ($100 in chips) 
BoyLoc0: posts small blind $0.50
michasia: posts big blind $1
*** HOLE CARDS ***
p0pa4poker: folds 
Cositorto: raises $1 to $2
vadjkeee: folds 
beauté815: calls $2
BoyLoc0: folds 
michasia: folds 
*** FLOP *** [Tc Kh 6c]
Cositorto: checks 
beauté815: bets $3
Cositorto: folds 
Uncalled bet ($3) returned to beauté815
beauté815 collected $5.22 from pot
beauté815: doesn't show hand 
*** SUMMARY ***
Total pot $5.50 | Rake $0.28 
Board [Tc Kh 6c]
Seat 1: beauté815 (button) collected ($5.22)
Seat 2: BoyLoc0 (small blind) folded before Flop
Seat 3: michasia (big blind) folded before Flop
Seat 4: p0pa4poker folded before Flop (didn't bet)
Seat 5: Cositorto folded on the Flop
Seat 6: vadjkeee folded before Flop (didn't bet)



PokerStars Hand #254535469697:  Hold'em No Limit ($0.50/$1.00 USD) - 2025/01/24 21:25:35 WET [2025/01/24 16:25:35 ET]
Table 'Merapi IV' 6-max Seat #2 is the button
Seat 1: beauté815 ($56.58 in chips) 
Seat 2: BoyLoc0 ($100 in chips) 
Seat 3: michasia ($146.10 in chips) 
Seat 4: p0pa4poker ($110.26 in chips) 
Seat 5: Cositorto ($100 in chips) 
Seat 6: vadjkeee ($100 in chips) 
michasia: posts small blind $0.50
p0pa4poker: posts big blind $1
*** HOLE CARDS ***
Cositorto: raises $1 to $2
vadjkeee: folds 
beauté815: calls $2
BoyLoc0: folds 
michasia: folds 
p0pa4poker: folds 
*** FLOP *** [7h 2s As]
Cositorto: checks 
beauté815: bets $3
Cositorto: raises $7 to $10
beauté815: folds 
Uncalled bet ($7) returned to Cositorto
Cositorto collected $10.92 from pot
Cositorto: doesn't show hand 
*** SUMMARY ***
Total pot $11.50 | Rake $0.58 
Board [7h 2s As]
Seat 1: beauté815 folded on the Flop
Seat 2: BoyLoc0 (button) folded before Flop (didn't bet)
Seat 3: michasia (small blind) folded before Flop
Seat 4: p0pa4poker (big blind) folded before Flop
Seat 5: Cositorto collected ($10.92)
Seat 6: vadjkeee folded before Flop (didn't bet)



PokerStars Hand #254535479687:  Hold'em No Limit ($0.50/$1.00 USD) - 2025/01/24 21:26:07 WET [2025/01/24 16:26:07 ET]
Table 'Merapi IV' 6-max Seat #3 is the button
Seat 1: beauté815 ($51.58 in chips) 
Seat 2: BoyLoc0 ($100 in chips) 
Seat 3: michasia ($145.60 in chips) 
Seat 4: p0pa4poker ($109.26 in chips) 
Seat 5: Cositorto ($105.92 in chips) 
Seat 6: vadjkeee ($100 in chips) 
p0pa4poker: posts small blind $0.50
Cositorto: posts big blind $1
*** HOLE CARDS ***
vadjkeee: folds 
beauté815: calls $1
BoyLoc0: raises $3 to $4
michasia: folds 
p0pa4poker: folds 
Cositorto: folds 
beauté815: calls $3
*** FLOP *** [2h 2c 8c]
beauté815: checks 
BoyLoc0: bets $2.98
beauté815: calls $2.98
*** TURN *** [2h 2c 8c] [Kd]
beauté815: checks 
BoyLoc0: bets $4.85
beauté815: calls $4.85
*** RIVER *** [2h 2c 8c Kd] [Js]
beauté815: checks 
BoyLoc0: bets $17.93
beauté815: folds 
Uncalled bet ($17.93) returned to BoyLoc0
BoyLoc0 collected $23.90 from pot
BoyLoc0: doesn't show hand 
*** SUMMARY ***
Total pot $25.16 | Rake $1.26 
Board [2h 2c 8c Kd Js]
Seat 1: beauté815 folded on the River
Seat 2: BoyLoc0 collected ($23.90)
Seat 3: michasia (button) folded before Flop (didn't bet)
Seat 4: p0pa4poker (small blind) folded before Flop
Seat 5: Cositorto (big blind) folded before Flop
Seat 6: vadjkeee folded before Flop (didn't bet)



PokerStars Hand #254535503984:  Hold'em No Limit ($0.50/$1.00 USD) - 2025/01/24 21:27:25 WET [2025/01/24 16:27:25 ET]
Table 'Merapi IV' 6-max Seat #4 is the button
Seat 1: beauté815 ($39.75 in chips) 
Seat 2: BoyLoc0 ($112.07 in chips) 
Seat 3: michasia ($145.60 in chips) 
Seat 4: p0pa4poker ($108.76 in chips) 
Seat 5: Cositorto ($104.92 in chips) 
Seat 6: vadjkeee ($100 in chips) 
Cositorto: posts small blind $0.50
vadjkeee: posts big blind $1
*** HOLE CARDS ***
beauté815: calls $1
BoyLoc0: folds 
michasia: folds 
p0pa4poker: raises $2.50 to $3.50
Cositorto: folds 
vadjkeee: raises $11 to $14.50
beauté815: folds 
p0pa4poker: folds 
Uncalled bet ($11) returned to vadjkeee
vadjkeee collected $8.50 from pot
vadjkeee: doesn't show hand 
*** SUMMARY ***
Total pot $8.50 | Rake $0 
Seat 1: beauté815 folded before Flop
Seat 2: BoyLoc0 folded before Flop (didn't bet)
Seat 3: michasia folded before Flop (didn't bet)
Seat 4: p0pa4poker (button) folded before Flop
Seat 5: Cositorto (small blind) folded before Flop
Seat 6: vadjkeee (big blind) collected ($8.50)



PokerStars Hand #254535515272:  Hold'em No Limit ($0.50/$1.00 USD) - 2025/01/24 21:28:01 WET [2025/01/24 16:28:01 ET]
Table 'Merapi IV' 6-max Seat #5 is the button
Seat 1: beauté815 ($38.75 in chips) 
Seat 2: BoyLoc0 ($112.07 in chips) 
Seat 3: michasia ($145.60 in chips) 
Seat 4: p0pa4poker ($105.26 in chips) 
Seat 5: Cositorto ($104.42 in chips) 
Seat 6: vadjkeee ($105 in chips) 
vadjkeee: posts small blind $0.50
beauté815: posts big blind $1
*** HOLE CARDS ***
BoyLoc0: folds 
michasia: folds 
p0pa4poker: folds 
Cositorto: folds 
vadjkeee: raises $2 to $3
beauté815: calls $2
*** FLOP *** [9c 3c Ah]
vadjkeee: bets $3.14
beauté815: folds 
Uncalled bet ($3.14) returned to vadjkeee
vadjkeee collected $5.70 from pot
vadjkeee: doesn't show hand 
*** SUMMARY ***
Total pot $6 | Rake $0.30 
Board [9c 3c Ah]
Seat 1: beauté815 (big blind) folded on the Flop
Seat 2: BoyLoc0 folded before Flop (didn't bet)
Seat 3: michasia folded before Flop (didn't bet)
Seat 4: p0pa4poker folded before Flop (didn't bet)
Seat 5: Cositorto (button) folded before Flop (didn't bet)
Seat 6: vadjkeee (small blind) collected ($5.70)



PokerStars Hand #254535529825:  Hold'em No Limit ($0.50/$1.00 USD) - 2025/01/24 21:28:48 WET [2025/01/24 16:28:48 ET]
Table 'Merapi IV' 6-max Seat #6 is the button
Seat 1: beauté815 ($35.75 in chips) 
Seat 2: BoyLoc0 ($112.07 in chips) 
Seat 3: michasia ($145.60 in chips) 
Seat 4: p0pa4poker ($105.26 in chips) 
Seat 5: Cositorto ($104.42 in chips) 
Seat 6: vadjkeee ($107.70 in chips) 
beauté815: posts small blind $0.50
BoyLoc0: posts big blind $1
*** HOLE CARDS ***
michasia: folds 
p0pa4poker: raises $1 to $2
Cositorto: folds 
vadjkeee: folds 
beauté815: calls $1.50
BoyLoc0: folds 
*** FLOP *** [4c 5c 7s]
beauté815: checks 
p0pa4poker: checks 
*** TURN *** [4c 5c 7s] [3s]
beauté815: bets $4
p0pa4poker: folds 
Uncalled bet ($4) returned to beauté815
beauté815 collected $4.75 from pot
beauté815: doesn't show hand 
*** SUMMARY ***
Total pot $5 | Rake $0.25 
Board [4c 5c 7s 3s]
Seat 1: beauté815 (small blind) collected ($4.75)
Seat 2: BoyLoc0 (big blind) folded before Flop
Seat 3: michasia folded before Flop (didn't bet)
Seat 4: p0pa4poker folded on the Turn
Seat 5: Cositorto folded before Flop (didn't bet)
Seat 6: vadjkeee (button) folded before Flop (didn't bet)



PokerStars Hand #254535546183:  Hold'em No Limit ($0.50/$1.00 USD) - 2025/01/24 21:29:40 WET [2025/01/24 16:29:40 ET]
Table 'Merapi IV' 6-max Seat #1 is the button
Seat 1: beauté815 ($38.50 in chips) 
Seat 2: BoyLoc0 ($111.07 in chips) 
Seat 3: michasia ($145.60 in chips) 
Seat 4: p0pa4poker ($103.26 in chips) 
Seat 5: Cositorto ($104.42 in chips) 
Seat 6: vadjkeee ($107.70 in chips) 
BoyLoc0: posts small blind $0.50
michasia: posts big blind $1
*** HOLE CARDS ***
p0pa4poker: folds 
Cositorto: folds 
vadjkeee: folds 
beauté815: calls $1
BoyLoc0: calls $0.50
michasia: raises $4 to $5
beauté815: calls $4
BoyLoc0: folds 
*** FLOP *** [Tc 8c Jd]
michasia: checks 
beauté815: checks 
*** TURN *** [Tc 8c Jd] [2h]
michasia: checks 
beauté815: bets $3
michasia: calls $3
*** RIVER *** [Tc 8c Jd 2h] [Th]
michasia: checks 
beauté815: bets $30.50 and is all-in
michasia: calls $30.50
*** SHOW DOWN ***
beauté815: shows [7s Ts] (three of a kind, Tens)
michasia: shows [Qs Td] (three of a kind, Tens - Queen kicker)
michasia collected $75.50 from pot
*** SUMMARY ***
Total pot $78 | Rake $2.50 
Board [Tc 8c Jd 2h Th]
Seat 1: beauté815 (button) showed [7s Ts] and lost with three of a kind, Tens
Seat 2: BoyLoc0 (small blind) folded before Flop
Seat 3: michasia (big blind) showed [Qs Td] and won ($75.50) with three of a kind, Tens
Seat 4: p0pa4poker folded before Flop (didn't bet)
Seat 5: Cositorto folded before Flop (didn't bet)
Seat 6: vadjkeee folded before Flop (didn't bet)



PokerStars Hand #254535559887:  Hold'em No Limit ($0.50/$1.00 USD) - 2025/01/24 21:30:23 WET [2025/01/24 16:30:23 ET]
Table 'Merapi IV' 6-max Seat #2 is the button
Seat 1: beauté815 ($0 in chips) is sitting out
Seat 2: BoyLoc0 ($110.07 in chips) 
Seat 3: michasia ($182.60 in chips) 
Seat 4: p0pa4poker ($103.26 in chips) 
Seat 5: Cositorto ($104.42 in chips) 
Seat 6: vadjkeee ($107.70 in chips) 
michasia: posts small blind $0.50
p0pa4poker: posts big blind $1
*** HOLE CARDS ***
Cositorto: folds 
vadjkeee: raises $1.50 to $2.50
BoyLoc0: folds 
michasia: folds 
beauté815 leaves the table
p0pa4poker: folds 
Uncalled bet ($1.50) returned to vadjkeee
vadjkeee collected $2.50 from pot
vadjkeee: doesn't show hand 
*** SUMMARY ***
Total pot $2.50 | Rake $0 
Seat 1: beauté815
Seat 2: BoyLoc0 (button) folded before Flop (didn't bet)
Seat 3: michasia (small blind) folded before Flop
Seat 4: p0pa4poker (big blind) folded before Flop
Seat 5: Cositorto folded before Flop (didn't bet)
Seat 6: vadjkeee collected ($2.50)



PokerStars Hand #254536197824:  Hold'em No Limit ($0.50/$1.00 USD) - 2025/01/24 21:37:41 WET [2025/01/24 16:37:41 ET]
Table 'Merapi IV' 6-max Seat #1 is the button
Seat 1: Gjeneral66 ($32.47 in chips) 
Seat 2: JoeyBaikie1 ($100 in chips) 
Seat 3: michasia ($183.60 in chips) 
Seat 4: p0pa4poker ($103.54 in chips) 
Seat 5: Cositorto ($124.20 in chips) 
Seat 6: vadjkeee ($107.20 in chips) 
JoeyBaikie1: posts small blind $0.50
michasia: posts big blind $1
*** HOLE CARDS ***
p0pa4poker: folds 
Cositorto: folds 
vadjkeee: raises $1.50 to $2.50
Gjeneral66: folds 
JoeyBaikie1: folds 
michasia: folds 
Uncalled bet ($1.50) returned to vadjkeee
vadjkeee collected $2.50 from pot
vadjkeee: doesn't show hand 
*** SUMMARY ***
Total pot $2.50 | Rake $0 
Seat 1: Gjeneral66 (button) folded before Flop (didn't bet)
Seat 2: JoeyBaikie1 (small blind) folded before Flop
Seat 3: michasia (big blind) folded before Flop
Seat 4: p0pa4poker folded before Flop (didn't bet)
Seat 5: Cositorto folded before Flop (didn't bet)
Seat 6: vadjkeee collected ($2.50)



PokerStars Hand #254536204725:  Hold'em No Limit ($0.50/$1.00 USD) - 2025/01/24 21:38:04 WET [2025/01/24 16:38:04 ET]
Table 'Merapi IV' 6-max Seat #2 is the button
Seat 1: Gjeneral66 ($32.47 in chips) 
Seat 2: JoeyBaikie1 ($100 in chips) 
Seat 3: michasia ($182.60 in chips) 
Seat 4: p0pa4poker ($103.54 in chips) 
Seat 5: Cositorto ($124.20 in chips) 
Seat 6: vadjkeee ($108.70 in chips) 
michasia: posts small blind $0.50
p0pa4poker: posts big blind $1
*** HOLE CARDS ***
Cositorto: folds 
vadjkeee: folds 
Gjeneral66: folds 
JoeyBaikie1: folds 
michasia: folds 
Uncalled bet ($0.50) returned to p0pa4poker
p0pa4poker collected $1 from pot
p0pa4poker: doesn't show hand 
*** SUMMARY ***
Total pot $1 | Rake $0 
Seat 1: Gjeneral66 folded before Flop (didn't bet)
Seat 2: JoeyBaikie1 (button) folded before Flop (didn't bet)
Seat 3: michasia (small blind) folded before Flop
Seat 4: p0pa4poker (big blind) collected ($1)
Seat 5: Cositorto folded before Flop (didn't bet)
Seat 6: vadjkeee folded before Flop (didn't bet)



PokerStars Hand #254536211182:  Hold'em No Limit ($0.50/$1.00 USD) - 2025/01/24 21:38:24 WET [2025/01/24 16:38:24 ET]
Table 'Merapi IV' 6-max Seat #3 is the button
Seat 1: Gjeneral66 ($32.47 in chips) 
Seat 2: JoeyBaikie1 ($100 in chips) 
Seat 3: michasia ($182.10 in chips) 
Seat 4: p0pa4poker ($104.04 in chips) 
Seat 5: Cositorto ($124.20 in chips) 
Seat 6: vadjkeee ($108.70 in chips) 
p0pa4poker: posts small blind $0.50
Cositorto: posts big blind $1
*** HOLE CARDS ***
vadjkeee: folds 
Gjeneral66: folds 
JoeyBaikie1: folds 
michasia: folds 
p0pa4poker: folds 
Uncalled bet ($0.50) returned to Cositorto
Cositorto collected $1 from pot
Cositorto: doesn't show hand 
*** SUMMARY ***
Total pot $1 | Rake $0 
Seat 1: Gjeneral66 folded before Flop (didn't bet)
Seat 2: JoeyBaikie1 folded before Flop (didn't bet)
Seat 3: michasia (button) folded before Flop (didn't bet)
Seat 4: p0pa4poker (small blind) folded before Flop
Seat 5: Cositorto (big blind) collected ($1)
Seat 6: vadjkeee folded before Flop (didn't bet)



PokerStars Hand #254536216781:  Hold'em No Limit ($0.50/$1.00 USD) - 2025/01/24 21:38:42 WET [2025/01/24 16:38:42 ET]
Table 'Merapi IV' 6-max Seat #4 is the button
Seat 1: Gjeneral66 ($32.47 in chips) 
Seat 2: JoeyBaikie1 ($100 in chips) 
Seat 3: michasia ($182.10 in chips) 
Seat 4: p0pa4poker ($103.54 in chips) 
Seat 5: Cositorto ($124.70 in chips) 
Seat 6: vadjkeee ($108.70 in chips) 
Cositorto: posts small blind $0.50
vadjkeee: posts big blind $1
*** HOLE CARDS ***
Gjeneral66: folds 
JoeyBaikie1: folds 
michasia: folds 
p0pa4poker: folds 
Cositorto: folds 
Uncalled bet ($0.50) returned to vadjkeee
vadjkeee collected $1 from pot
vadjkeee: doesn't show hand 
*** SUMMARY ***
Total pot $1 | Rake $0 
Seat 1: Gjeneral66 folded before Flop (didn't bet)
Seat 2: JoeyBaikie1 folded before Flop (didn't bet)
Seat 3: michasia folded before Flop (didn't bet)
Seat 4: p0pa4poker (button) folded before Flop (didn't bet)
Seat 5: Cositorto (small blind) folded before Flop
Seat 6: vadjkeee (big blind) collected ($1)



PokerStars Hand #254536220605:  Hold'em No Limit ($0.50/$1.00 USD) - 2025/01/24 21:38:55 WET [2025/01/24 16:38:55 ET]
Table 'Merapi IV' 6-max Seat #5 is the button
Seat 1: Gjeneral66 ($32.47 in chips) 
Seat 2: JoeyBaikie1 ($100 in chips) 
Seat 3: michasia ($182.10 in chips) 
Seat 4: p0pa4poker ($103.54 in chips) 
Seat 5: Cositorto ($124.20 in chips) 
Seat 6: vadjkeee ($109.20 in chips) 
vadjkeee: posts small blind $0.50
Gjeneral66: posts big blind $1
*** HOLE CARDS ***
JoeyBaikie1: folds 
michasia: folds 
p0pa4poker: folds 
Cositorto: folds 
vadjkeee: folds 
Uncalled bet ($0.50) returned to Gjeneral66
Gjeneral66 collected $1 from pot
*** SUMMARY ***
Total pot $1 | Rake $0 
Seat 1: Gjeneral66 (big blind) collected ($1)
Seat 2: JoeyBaikie1 folded before Flop (didn't bet)
Seat 3: michasia folded before Flop (didn't bet)
Seat 4: p0pa4poker folded before Flop (didn't bet)
Seat 5: Cositorto (button) folded before Flop (didn't bet)
Seat 6: vadjkeee (small blind) folded before Flop



PokerStars Hand #254536227066:  Hold'em No Limit ($0.50/$1.00 USD) - 2025/01/24 21:39:15 WET [2025/01/24 16:39:15 ET]
Table 'Merapi IV' 6-max Seat #6 is the button
Seat 1: Gjeneral66 ($32.97 in chips) 
Seat 2: JoeyBaikie1 ($100 in chips) 
Seat 3: michasia ($182.10 in chips) 
Seat 4: p0pa4poker ($103.54 in chips) 
Seat 5: Cositorto ($124.20 in chips) 
Seat 6: vadjkeee ($108.70 in chips) 
Gjeneral66: posts small blind $0.50
JoeyBaikie1: posts big blind $1
*** HOLE CARDS ***
michasia: folds 
p0pa4poker: raises $1 to $2
Cositorto: folds 
vadjkeee: folds 
Gjeneral66: folds 
JoeyBaikie1: folds 
Uncalled bet ($1) returned to p0pa4poker
p0pa4poker collected $2.50 from pot
p0pa4poker: doesn't show hand 
*** SUMMARY ***
Total pot $2.50 | Rake $0 
Seat 1: Gjeneral66 (small blind) folded before Flop
Seat 2: JoeyBaikie1 (big blind) folded before Flop
Seat 3: michasia folded before Flop (didn't bet)
Seat 4: p0pa4poker collected ($2.50)
Seat 5: Cositorto folded before Flop (didn't bet)
Seat 6: vadjkeee (button) folded before Flop (didn't bet)



PokerStars Hand #254536234057:  Hold'em No Limit ($0.50/$1.00 USD) - 2025/01/24 21:39:38 WET [2025/01/24 16:39:38 ET]
Table 'Merapi IV' 6-max Seat #1 is the button
Seat 3: michasia ($182.10 in chips) is sitting out
Seat 1: Gjeneral66 ($32.47 in chips) 
Seat 2: JoeyBaikie1 ($100 in chips) 
Seat 4: p0pa4poker ($105.04 in chips) 
Seat 5: Cositorto ($124.20 in chips) 
Seat 6: vadjkeee ($108.70 in chips) 
JoeyBaikie1: posts small blind $0.50
michasia: is sitting out 
p0pa4poker: posts big blind $1
*** HOLE CARDS ***
Cositorto: folds 
michasia leaves the table
vadjkeee: folds 
Gjeneral66: raises $1.50 to $2.50
JoeyBaikie1: folds 
p0pa4poker: folds 
Uncalled bet ($1.50) returned to Gjeneral66
Gjeneral66 collected $2.50 from pot
*** SUMMARY ***
Total pot $2.50 | Rake $0 
Seat 3: michasia
Seat 1: Gjeneral66 (button) collected ($2.50)
Seat 2: JoeyBaikie1 (small blind) folded before Flop
Seat 4: p0pa4poker (big blind) folded before Flop
Seat 5: Cositorto folded before Flop (didn't bet)
Seat 6: vadjkeee folded before Flop (didn't bet)



PokerStars Hand #254536239306:  Hold'em No Limit ($0.50/$1.00 USD) - 2025/01/24 21:39:55 WET [2025/01/24 16:39:55 ET]
Table 'Merapi IV' 6-max Seat #2 is the button
Seat 1: Gjeneral66 ($33.97 in chips) 
Seat 2: JoeyBaikie1 ($100 in chips) 
Seat 4: p0pa4poker ($104.04 in chips) 
Seat 5: Cositorto ($124.20 in chips) 
Seat 6: vadjkeee ($108.70 in chips) 
p0pa4poker: posts small blind $0.50
Cositorto: posts big blind $1
*** HOLE CARDS ***
vadjkeee: folds 
Gjeneral66: raises $1.50 to $2.50
JoeyBaikie1: folds 
p0pa4poker: folds 
Cositorto: calls $1.50
*** FLOP *** [3d 9h Th]
Cositorto: checks 
Gjeneral66: bets $2.61
Cositorto: calls $2.61
*** TURN *** [3d 9h Th] [2d]
Cositorto: checks 
Gjeneral66: bets $5.09
Cositorto: folds 
Uncalled bet ($5.09) returned to Gjeneral66
Gjeneral66 collected $10.18 from pot
*** SUMMARY ***
Total pot $10.72 | Rake $0.54 
Board [3d 9h Th 2d]
Seat 1: Gjeneral66 collected ($10.18)
Seat 2: JoeyBaikie1 (button) folded before Flop (didn't bet)
Seat 4: p0pa4poker (small blind) folded before Flop
Seat 5: Cositorto (big blind) folded on the Turn
Seat 6: vadjkeee folded before Flop (didn't bet)



PokerStars Hand #254536253388:  Hold'em No Limit ($0.50/$1.00 USD) - 2025/01/24 21:40:39 WET [2025/01/24 16:40:39 ET]
Table 'Merapi IV' 6-max Seat #4 is the button
Seat 1: Gjeneral66 ($39.04 in chips) 
Seat 2: JoeyBaikie1 ($100 in chips) 
Seat 4: p0pa4poker ($103.54 in chips) 
Seat 5: Cositorto ($119.09 in chips) 
Seat 6: vadjkeee ($108.70 in chips) 
Cositorto: posts small blind $0.50
vadjkeee: posts big blind $1
*** HOLE CARDS ***
Spartansmike joins the table at seat #3 
Spartansmike is disconnected 
Gjeneral66: raises $1.50 to $2.50
JoeyBaikie1: folds 
p0pa4poker: folds 
Cositorto: folds 
vadjkeee: folds 
Uncalled bet ($1.50) returned to Gjeneral66
Gjeneral66 collected $2.50 from pot
*** SUMMARY ***
Total pot $2.50 | Rake $0 
Seat 1: Gjeneral66 collected ($2.50)
Seat 2: JoeyBaikie1 folded before Flop (didn't bet)
Seat 4: p0pa4poker (button) folded before Flop (didn't bet)
Seat 5: Cositorto (small blind) folded before Flop
Seat 6: vadjkeee (big blind) folded before Flop



PokerStars Hand #254536258276:  Hold'em No Limit ($0.50/$1.00 USD) - 2025/01/24 21:40:55 WET [2025/01/24 16:40:55 ET]
Table 'Merapi IV' 6-max Seat #5 is the button
Seat 3: Spartansmike ($100 in chips) is sitting out
Seat 1: Gjeneral66 ($40.54 in chips) 
Seat 2: JoeyBaikie1 ($100 in chips) 
Seat 4: p0pa4poker ($103.54 in chips) 
Seat 5: Cositorto ($118.59 in chips) 
Seat 6: vadjkeee ($107.70 in chips) 
vadjkeee: posts small blind $0.50
Gjeneral66: posts big blind $1
Spartansmike: sits out 
*** HOLE CARDS ***
JoeyBaikie1: folds 
p0pa4poker: raises $1.30 to $2.30
Cositorto: folds 
vadjkeee: folds 
Gjeneral66: folds 
Uncalled bet ($1.30) returned to p0pa4poker
p0pa4poker collected $2.50 from pot
p0pa4poker: doesn't show hand 
*** SUMMARY ***
Total pot $2.50 | Rake $0 
Seat 3: Spartansmike
Seat 1: Gjeneral66 (big blind) folded before Flop
Seat 2: JoeyBaikie1 folded before Flop (didn't bet)
Seat 4: p0pa4poker collected ($2.50)
Seat 5: Cositorto (button) folded before Flop (didn't bet)
Seat 6: vadjkeee (small blind) folded before Flop



PokerStars Hand #254536267088:  Hold'em No Limit ($0.50/$1.00 USD) - 2025/01/24 21:41:24 WET [2025/01/24 16:41:24 ET]
Table 'Merapi IV' 6-max Seat #6 is the button
Seat 1: Gjeneral66 ($39.54 in chips) 
Seat 2: JoeyBaikie1 ($100 in chips) 
Seat 3: Spartansmike ($100 in chips) 
Seat 4: p0pa4poker ($105.04 in chips) 
Seat 5: Cositorto ($118.59 in chips) 
Seat 6: vadjkeee ($107.20 in chips) 
Gjeneral66: posts small blind $0.50
JoeyBaikie1: posts big blind $1
Spartansmike: posts big blind $1
*** HOLE CARDS ***
Spartansmike: checks 
p0pa4poker: raises $2.30 to $3.30
Cositorto: folds 
vadjkeee: folds 
Gjeneral66: folds 
JoeyBaikie1: folds 
Spartansmike: folds 
Uncalled bet ($2.30) returned to p0pa4poker
p0pa4poker collected $3.50 from pot
p0pa4poker: doesn't show hand 
*** SUMMARY ***
Total pot $3.50 | Rake $0 
Seat 1: Gjeneral66 (small blind) folded before Flop
Seat 2: JoeyBaikie1 (big blind) folded before Flop
Seat 3: Spartansmike folded before Flop (didn't bet)
Seat 4: p0pa4poker collected ($3.50)
Seat 5: Cositorto folded before Flop (didn't bet)
Seat 6: vadjkeee (button) folded before Flop (didn't bet)



PokerStars Hand #254536274384:  Hold'em No Limit ($0.50/$1.00 USD) - 2025/01/24 21:41:47 WET [2025/01/24 16:41:47 ET]
Table 'Merapi IV' 6-max Seat #1 is the button
Seat 1: Gjeneral66 ($39.04 in chips) 
Seat 2: JoeyBaikie1 ($100 in chips) 
Seat 3: Spartansmike ($99 in chips) 
Seat 4: p0pa4poker ($107.54 in chips) 
Seat 5: Cositorto ($118.59 in chips) 
Seat 6: vadjkeee ($107.20 in chips) 
JoeyBaikie1: posts small blind $0.50
Spartansmike: posts big blind $1
*** HOLE CARDS ***
p0pa4poker: folds 
Cositorto: folds 
vadjkeee: folds 
Gjeneral66: folds 
JoeyBaikie1: raises $2 to $3
Spartansmike: calls $2
*** FLOP *** [Ah Qc 7c]
JoeyBaikie1: checks 
Spartansmike: checks 
*** TURN *** [Ah Qc 7c] [4h]
JoeyBaikie1: checks 
Spartansmike: bets $2.85
JoeyBaikie1: calls $2.85
*** RIVER *** [Ah Qc 7c 4h] [Qh]
JoeyBaikie1: checks 
Spartansmike: checks 
*** SHOW DOWN ***
JoeyBaikie1: shows [Tc Td] (two pair, Queens and Tens)
Spartansmike: mucks hand 
JoeyBaikie1 collected $11.12 from pot
*** SUMMARY ***
Total pot $11.70 | Rake $0.58 
Board [Ah Qc 7c 4h Qh]
Seat 1: Gjeneral66 (button) folded before Flop (didn't bet)
Seat 2: JoeyBaikie1 (small blind) showed [Tc Td] and won ($11.12) with two pair, Queens and Tens
Seat 3: Spartansmike (big blind) mucked
Seat 4: p0pa4poker folded before Flop (didn't bet)
Seat 5: Cositorto folded before Flop (didn't bet)
Seat 6: vadjkeee folded before Flop (didn't bet)



PokerStars Hand #254536287647:  Hold'em No Limit ($0.50/$1.00 USD) - 2025/01/24 21:42:30 WET [2025/01/24 16:42:30 ET]
Table 'Merapi IV' 6-max Seat #2 is the button
Seat 1: Gjeneral66 ($39.04 in chips) 
Seat 2: JoeyBaikie1 ($105.27 in chips) 
Seat 3: Spartansmike ($93.15 in chips) 
Seat 4: p0pa4poker ($107.54 in chips) 
Seat 5: Cositorto ($118.59 in chips) 
Seat 6: vadjkeee ($107.20 in chips) 
Spartansmike: posts small blind $0.50
p0pa4poker: posts big blind $1
*** HOLE CARDS ***
Cositorto: folds 
vadjkeee: raises $1.50 to $2.50
Gjeneral66: folds 
JoeyBaikie1: folds 
Spartansmike: calls $2
p0pa4poker: folds 
*** FLOP *** [7d 5c Kd]
Spartansmike: checks 
vadjkeee: bets $4.28
Spartansmike: folds 
Uncalled bet ($4.28) returned to vadjkeee
vadjkeee collected $5.70 from pot
vadjkeee: doesn't show hand 
*** SUMMARY ***
Total pot $6 | Rake $0.30 
Board [7d 5c Kd]
Seat 1: Gjeneral66 folded before Flop (didn't bet)
Seat 2: JoeyBaikie1 (button) folded before Flop (didn't bet)
Seat 3: Spartansmike (small blind) folded on the Flop
Seat 4: p0pa4poker (big blind) folded before Flop
Seat 5: Cositorto folded before Flop (didn't bet)
Seat 6: vadjkeee collected ($5.70)



PokerStars Hand #254536296714:  Hold'em No Limit ($0.50/$1.00 USD) - 2025/01/24 21:42:59 WET [2025/01/24 16:42:59 ET]
Table 'Merapi IV' 6-max Seat #3 is the button
Seat 1: Gjeneral66 ($39.04 in chips) 
Seat 2: JoeyBaikie1 ($105.27 in chips) 
Seat 3: Spartansmike ($90.65 in chips) 
Seat 4: p0pa4poker ($106.54 in chips) 
Seat 5: Cositorto ($118.59 in chips) 
Seat 6: vadjkeee ($110.40 in chips) 
p0pa4poker: posts small blind $0.50
Cositorto: posts big blind $1
*** HOLE CARDS ***
vadjkeee: folds 
Gjeneral66: folds 
JoeyBaikie1: folds 
Spartansmike: raises $2 to $3
p0pa4poker: folds 
Cositorto: folds 
Uncalled bet ($2) returned to Spartansmike
Spartansmike collected $2.50 from pot
*** SUMMARY ***
Total pot $2.50 | Rake $0 
Seat 1: Gjeneral66 folded before Flop (didn't bet)
Seat 2: JoeyBaikie1 folded before Flop (didn't bet)
Seat 3: Spartansmike (button) collected ($2.50)
Seat 4: p0pa4poker (small blind) folded before Flop
Seat 5: Cositorto (big blind) folded before Flop
Seat 6: vadjkeee folded before Flop (didn't bet)



PokerStars Hand #254536301679:  Hold'em No Limit ($0.50/$1.00 USD) - 2025/01/24 21:43:15 WET [2025/01/24 16:43:15 ET]
Table 'Merapi IV' 6-max Seat #4 is the button
Seat 1: Gjeneral66 ($39.04 in chips) 
Seat 2: JoeyBaikie1 ($105.27 in chips) 
Seat 3: Spartansmike ($92.15 in chips) 
Seat 4: p0pa4poker ($106.04 in chips) 
Seat 5: Cositorto ($117.59 in chips) 
Seat 6: vadjkeee ($110.40 in chips) 
Cositorto: posts small blind $0.50
vadjkeee: posts big blind $1
*** HOLE CARDS ***
Gjeneral66: folds 
JoeyBaikie1: folds 
Spartansmike: folds 
p0pa4poker: folds 
Cositorto: raises $2 to $3
vadjkeee: calls $2
*** FLOP *** [Jc 9c 4d]
Cositorto: bets $1.54
vadjkeee: folds 
Uncalled bet ($1.54) returned to Cositorto
Cositorto collected $5.70 from pot
Cositorto: doesn't show hand 
*** SUMMARY ***
Total pot $6 | Rake $0.30 
Board [Jc 9c 4d]
Seat 1: Gjeneral66 folded before Flop (didn't bet)
Seat 2: JoeyBaikie1 folded before Flop (didn't bet)
Seat 3: Spartansmike folded before Flop (didn't bet)
Seat 4: p0pa4poker (button) folded before Flop (didn't bet)
Seat 5: Cositorto (small blind) collected ($5.70)
Seat 6: vadjkeee (big blind) folded on the Flop



PokerStars Hand #254536312619:  Hold'em No Limit ($0.50/$1.00 USD) - 2025/01/24 21:43:50 WET [2025/01/24 16:43:50 ET]
Table 'Merapi IV' 6-max Seat #5 is the button
Seat 1: Gjeneral66 ($39.04 in chips) 
Seat 2: JoeyBaikie1 ($105.27 in chips) 
Seat 3: Spartansmike ($92.15 in chips) 
Seat 4: p0pa4poker ($106.04 in chips) 
Seat 5: Cositorto ($120.29 in chips) 
Seat 6: vadjkeee ($107.40 in chips) 
vadjkeee: posts small blind $0.50
Gjeneral66: posts big blind $1
*** HOLE CARDS ***
JoeyBaikie1: folds 
Spartansmike: folds 
p0pa4poker: folds 
Cositorto: folds 
vadjkeee: folds 
Uncalled bet ($0.50) returned to Gjeneral66
Gjeneral66 collected $1 from pot
*** SUMMARY ***
Total pot $1 | Rake $0 
Seat 1: Gjeneral66 (big blind) collected ($1)
Seat 2: JoeyBaikie1 folded before Flop (didn't bet)
Seat 3: Spartansmike folded before Flop (didn't bet)
Seat 4: p0pa4poker folded before Flop (didn't bet)
Seat 5: Cositorto (button) folded before Flop (didn't bet)
Seat 6: vadjkeee (small blind) folded before Flop



PokerStars Hand #254536322055:  Hold'em No Limit ($0.50/$1.00 USD) - 2025/01/24 21:44:21 WET [2025/01/24 16:44:21 ET]
Table 'Merapi IV' 6-max Seat #6 is the button
Seat 1: Gjeneral66 ($39.54 in chips) 
Seat 2: JoeyBaikie1 ($105.27 in chips) 
Seat 3: Spartansmike ($92.15 in chips) 
Seat 4: p0pa4poker ($106.04 in chips) 
Seat 5: Cositorto ($120.29 in chips) 
Seat 6: vadjkeee ($106.90 in chips) 
Gjeneral66: posts small blind $0.50
JoeyBaikie1: posts big blind $1
*** HOLE CARDS ***
Spartansmike: folds 
p0pa4poker: folds 
Cositorto: folds 
vadjkeee: folds 
Gjeneral66: folds 
Uncalled bet ($0.50) returned to JoeyBaikie1
JoeyBaikie1 collected $1 from pot
JoeyBaikie1: doesn't show hand 
*** SUMMARY ***
Total pot $1 | Rake $0 
Seat 1: Gjeneral66 (small blind) folded before Flop
Seat 2: JoeyBaikie1 (big blind) collected ($1)
Seat 3: Spartansmike folded before Flop (didn't bet)
Seat 4: p0pa4poker folded before Flop (didn't bet)
Seat 5: Cositorto folded before Flop (didn't bet)
Seat 6: vadjkeee (button) folded before Flop (didn't bet)



PokerStars Hand #254536327338:  Hold'em No Limit ($0.50/$1.00 USD) - 2025/01/24 21:44:39 WET [2025/01/24 16:44:39 ET]
Table 'Merapi IV' 6-max Seat #1 is the button
Seat 1: Gjeneral66 ($39.04 in chips) 
Seat 2: JoeyBaikie1 ($105.77 in chips) 
Seat 3: Spartansmike ($92.15 in chips) 
Seat 4: p0pa4poker ($106.04 in chips) 
Seat 5: Cositorto ($120.29 in chips) 
Seat 6: vadjkeee ($106.90 in chips) 
JoeyBaikie1: posts small blind $0.50
Spartansmike: posts big blind $1
*** HOLE CARDS ***
p0pa4poker: folds 
Cositorto: folds 
vadjkeee: folds 
Gjeneral66: folds 
JoeyBaikie1: raises $2 to $3
Spartansmike: calls $2
*** FLOP *** [9c Tc Th]
JoeyBaikie1: bets $1.88
Spartansmike: calls $1.88
*** TURN *** [9c Tc Th] [9h]
JoeyBaikie1: bets $4.64
Spartansmike: folds 
Uncalled bet ($4.64) returned to JoeyBaikie1
JoeyBaikie1 collected $9.27 from pot
JoeyBaikie1: doesn't show hand 
*** SUMMARY ***
Total pot $9.76 | Rake $0.49 
Board [9c Tc Th 9h]
Seat 1: Gjeneral66 (button) folded before Flop (didn't bet)
Seat 2: JoeyBaikie1 (small blind) collected ($9.27)
Seat 3: Spartansmike (big blind) folded on the Turn
Seat 4: p0pa4poker folded before Flop (didn't bet)
Seat 5: Cositorto folded before Flop (didn't bet)
Seat 6: vadjkeee folded before Flop (didn't bet)



PokerStars Hand #254536338031:  Hold'em No Limit ($0.50/$1.00 USD) - 2025/01/24 21:45:13 WET [2025/01/24 16:45:13 ET]
Table 'Merapi IV' 6-max Seat #2 is the button
Seat 1: Gjeneral66 ($39.04 in chips) 
Seat 2: JoeyBaikie1 ($110.16 in chips) 
Seat 3: Spartansmike ($87.27 in chips) 
Seat 4: p0pa4poker ($106.04 in chips) 
Seat 5: Cositorto ($120.29 in chips) 
Seat 6: vadjkeee ($106.90 in chips) 
Spartansmike: posts small blind $0.50
p0pa4poker: posts big blind $1
*** HOLE CARDS ***
Cositorto: raises $1 to $2
vadjkeee: folds 
Gjeneral66: folds 
JoeyBaikie1: raises $5 to $7
Spartansmike: folds 
p0pa4poker: folds 
Cositorto: folds 
Uncalled bet ($5) returned to JoeyBaikie1
JoeyBaikie1 collected $5.50 from pot
JoeyBaikie1: doesn't show hand 
*** SUMMARY ***
Total pot $5.50 | Rake $0 
Seat 1: Gjeneral66 folded before Flop (didn't bet)
Seat 2: JoeyBaikie1 (button) collected ($5.50)
Seat 3: Spartansmike (small blind) folded before Flop
Seat 4: p0pa4poker (big blind) folded before Flop
Seat 5: Cositorto folded before Flop
Seat 6: vadjkeee folded before Flop (didn't bet)



PokerStars Hand #254536346478:  Hold'em No Limit ($0.50/$1.00 USD) - 2025/01/24 21:45:40 WET [2025/01/24 16:45:40 ET]
Table 'Merapi IV' 6-max Seat #3 is the button
Seat 1: Gjeneral66 ($39.04 in chips) 
Seat 2: JoeyBaikie1 ($113.66 in chips) 
Seat 3: Spartansmike ($86.77 in chips) 
Seat 4: p0pa4poker ($105.04 in chips) 
Seat 5: Cositorto ($118.29 in chips) 
Seat 6: vadjkeee ($106.90 in chips) 
p0pa4poker: posts small blind $0.50
Cositorto: posts big blind $1
*** HOLE CARDS ***
vadjkeee: folds 
Gjeneral66: folds 
JoeyBaikie1: folds 
Spartansmike: folds 
p0pa4poker: folds 
Uncalled bet ($0.50) returned to Cositorto
Cositorto collected $1 from pot
Cositorto: doesn't show hand 
*** SUMMARY ***
Total pot $1 | Rake $0 
Seat 1: Gjeneral66 folded before Flop (didn't bet)
Seat 2: JoeyBaikie1 folded before Flop (didn't bet)
Seat 3: Spartansmike (button) folded before Flop (didn't bet)
Seat 4: p0pa4poker (small blind) folded before Flop
Seat 5: Cositorto (big blind) collected ($1)
Seat 6: vadjkeee folded before Flop (didn't bet)



PokerStars Hand #254536353531:  Hold'em No Limit ($0.50/$1.00 USD) - 2025/01/24 21:46:03 WET [2025/01/24 16:46:03 ET]
Table 'Merapi IV' 6-max Seat #4 is the button
Seat 1: Gjeneral66 ($39.04 in chips) 
Seat 2: JoeyBaikie1 ($113.66 in chips) 
Seat 3: Spartansmike ($86.77 in chips) 
Seat 4: p0pa4poker ($104.54 in chips) 
Seat 5: Cositorto ($118.79 in chips) 
Seat 6: vadjkeee ($106.90 in chips) 
Cositorto: posts small blind $0.50
vadjkeee: posts big blind $1
*** HOLE CARDS ***
Gjeneral66: raises $1.50 to $2.50
JoeyBaikie1: folds 
Spartansmike: folds 
p0pa4poker: folds 
Cositorto: folds 
vadjkeee: folds 
Uncalled bet ($1.50) returned to Gjeneral66
Gjeneral66 collected $2.50 from pot
*** SUMMARY ***
Total pot $2.50 | Rake $0 
Seat 1: Gjeneral66 collected ($2.50)
Seat 2: JoeyBaikie1 folded before Flop (didn't bet)
Seat 3: Spartansmike folded before Flop (didn't bet)
Seat 4: p0pa4poker (button) folded before Flop (didn't bet)
Seat 5: Cositorto (small blind) folded before Flop
Seat 6: vadjkeee (big blind) folded before Flop



PokerStars Hand #254536360284:  Hold'em No Limit ($0.50/$1.00 USD) - 2025/01/24 21:46:25 WET [2025/01/24 16:46:25 ET]
Table 'Merapi IV' 6-max Seat #5 is the button
Seat 1: Gjeneral66 ($40.54 in chips) 
Seat 2: JoeyBaikie1 ($113.66 in chips) 
Seat 3: Spartansmike ($86.77 in chips) 
Seat 4: p0pa4poker ($104.54 in chips) 
Seat 5: Cositorto ($118.29 in chips) 
Seat 6: vadjkeee ($105.90 in chips) 
vadjkeee: posts small blind $0.50
Gjeneral66: posts big blind $1
*** HOLE CARDS ***
JoeyBaikie1: folds 
Spartansmike: folds 
p0pa4poker: raises $1.30 to $2.30
Cositorto: folds 
vadjkeee: folds 
Gjeneral66: raises $9.70 to $12
p0pa4poker: folds 
Uncalled bet ($9.70) returned to Gjeneral66
Gjeneral66 collected $5.10 from pot
*** SUMMARY ***
Total pot $5.10 | Rake $0 
Seat 1: Gjeneral66 (big blind) collected ($5.10)
Seat 2: JoeyBaikie1 folded before Flop (didn't bet)
Seat 3: Spartansmike folded before Flop (didn't bet)
Seat 4: p0pa4poker folded before Flop
Seat 5: Cositorto (button) folded before Flop (didn't bet)
Seat 6: vadjkeee (small blind) folded before Flop



PokerStars Hand #254536369120:  Hold'em No Limit ($0.50/$1.00 USD) - 2025/01/24 21:46:54 WET [2025/01/24 16:46:54 ET]
Table 'Merapi IV' 6-max Seat #6 is the button
Seat 1: Gjeneral66 ($43.34 in chips) 
Seat 2: JoeyBaikie1 ($113.66 in chips) 
Seat 3: Spartansmike ($86.77 in chips) 
Seat 4: p0pa4poker ($102.24 in chips) 
Seat 5: Cositorto ($118.29 in chips) 
Seat 6: vadjkeee ($105.40 in chips) 
Gjeneral66: posts small blind $0.50
JoeyBaikie1: posts big blind $1
*** HOLE CARDS ***
Spartansmike has timed out
Spartansmike: folds 
p0pa4poker: folds 
Cositorto: folds 
vadjkeee: folds 
Gjeneral66: raises $2 to $3
JoeyBaikie1: folds 
Uncalled bet ($2) returned to Gjeneral66
Gjeneral66 collected $2 from pot
*** SUMMARY ***
Total pot $2 | Rake $0 
Seat 1: Gjeneral66 (small blind) collected ($2)
Seat 2: JoeyBaikie1 (big blind) folded before Flop
Seat 3: Spartansmike folded before Flop (didn't bet)
Seat 4: p0pa4poker folded before Flop (didn't bet)
Seat 5: Cositorto folded before Flop (didn't bet)
Seat 6: vadjkeee (button) folded before Flop (didn't bet)



PokerStars Hand #254536379555:  Hold'em No Limit ($0.50/$1.00 USD) - 2025/01/24 21:47:28 WET [2025/01/24 16:47:28 ET]
Table 'Merapi IV' 6-max Seat #1 is the button
Seat 3: Spartansmike ($86.77 in chips) is sitting out
Seat 1: Gjeneral66 ($44.34 in chips) 
Seat 2: JoeyBaikie1 ($112.66 in chips) 
Seat 4: p0pa4poker ($102.24 in chips) 
Seat 5: Cositorto ($118.29 in chips) 
Seat 6: vadjkeee ($105.40 in chips) 
JoeyBaikie1: posts small blind $0.50
p0pa4poker: posts big blind $1
*** HOLE CARDS ***
Cositorto: folds 
vadjkeee: folds 
Gjeneral66: raises $1.50 to $2.50
JoeyBaikie1: folds 
p0pa4poker: folds 
Uncalled bet ($1.50) returned to Gjeneral66
Gjeneral66 collected $2.50 from pot
*** SUMMARY ***
Total pot $2.50 | Rake $0 
Seat 3: Spartansmike
Seat 1: Gjeneral66 (button) collected ($2.50)
Seat 2: JoeyBaikie1 (small blind) folded before Flop
Seat 4: p0pa4poker (big blind) folded before Flop
Seat 5: Cositorto folded before Flop (didn't bet)
Seat 6: vadjkeee folded before Flop (didn't bet)



PokerStars Hand #254536390300:  Hold'em No Limit ($0.50/$1.00 USD) - 2025/01/24 21:48:03 WET [2025/01/24 16:48:03 ET]
Table 'Merapi IV' 6-max Seat #2 is the button
Seat 3: Spartansmike ($86.77 in chips) is sitting out
Seat 1: Gjeneral66 ($45.84 in chips) 
Seat 2: JoeyBaikie1 ($112.16 in chips) 
Seat 4: p0pa4poker ($101.24 in chips) 
Seat 5: Cositorto ($118.29 in chips) 
Seat 6: vadjkeee ($105.40 in chips) 
p0pa4poker: posts small blind $0.50
Cositorto: posts big blind $1
*** HOLE CARDS ***
vadjkeee: folds 
Gjeneral66: folds 
JoeyBaikie1: folds 
p0pa4poker: raises $2 to $3
Cositorto: calls $2
*** FLOP *** [7c 6d Jc]
p0pa4poker: checks 
Cositorto: checks 
*** TURN *** [7c 6d Jc] [Ks]
p0pa4poker: checks 
Cositorto: checks 
*** RIVER *** [7c 6d Jc Ks] [2h]
p0pa4poker: bets $9
Cositorto: folds 
Uncalled bet ($9) returned to p0pa4poker
p0pa4poker collected $5.70 from pot
p0pa4poker: doesn't show hand 
*** SUMMARY ***
Total pot $6 | Rake $0.30 
Board [7c 6d Jc Ks 2h]
Seat 3: Spartansmike
Seat 1: Gjeneral66 folded before Flop (didn't bet)
Seat 2: JoeyBaikie1 (button) folded before Flop (didn't bet)
Seat 4: p0pa4poker (small blind) collected ($5.70)
Seat 5: Cositorto (big blind) folded on the River
Seat 6: vadjkeee folded before Flop (didn't bet)



PokerStars Hand #254536403089:  Hold'em No Limit ($0.50/$1.00 USD) - 2025/01/24 21:48:45 WET [2025/01/24 16:48:45 ET]
Table 'Merapi IV' 6-max Seat #4 is the button
Seat 3: Spartansmike ($86.77 in chips) is sitting out
Seat 1: Gjeneral66 ($45.84 in chips) 
Seat 2: JoeyBaikie1 ($112.16 in chips) 
Seat 4: p0pa4poker ($103.94 in chips) 
Seat 5: Cositorto ($115.29 in chips) 
Seat 6: vadjkeee ($105.40 in chips) 
Cositorto: posts small blind $0.50
vadjkeee: posts big blind $1
Spartansmike: sits out 
*** HOLE CARDS ***
Gjeneral66: folds 
JoeyBaikie1: folds 
p0pa4poker: folds 
Cositorto: folds 
Uncalled bet ($0.50) returned to vadjkeee
vadjkeee collected $1 from pot
vadjkeee: doesn't show hand 
*** SUMMARY ***
Total pot $1 | Rake $0 
Seat 3: Spartansmike
Seat 1: Gjeneral66 folded before Flop (didn't bet)
Seat 2: JoeyBaikie1 folded before Flop (didn't bet)
Seat 4: p0pa4poker (button) folded before Flop (didn't bet)
Seat 5: Cositorto (small blind) folded before Flop
Seat 6: vadjkeee (big blind) collected ($1)



PokerStars Hand #254536405509:  Hold'em No Limit ($0.50/$1.00 USD) - 2025/01/24 21:48:53 WET [2025/01/24 16:48:53 ET]
Table 'Merapi IV' 6-max Seat #5 is the button
Seat 3: Spartansmike ($86.77 in chips) is sitting out
Seat 1: Gjeneral66 ($45.84 in chips) 
Seat 2: JoeyBaikie1 ($112.16 in chips) 
Seat 4: p0pa4poker ($103.94 in chips) 
Seat 5: Cositorto ($114.79 in chips) 
Seat 6: vadjkeee ($105.90 in chips) 
vadjkeee: posts small blind $0.50
Gjeneral66: posts big blind $1
Spartansmike: sits out 
*** HOLE CARDS ***
JoeyBaikie1: folds 
p0pa4poker: folds 
Cositorto: raises $1.50 to $2.50
vadjkeee: folds 
Gjeneral66: folds 
Uncalled bet ($1.50) returned to Cositorto
Cositorto collected $2.50 from pot
Cositorto: doesn't show hand 
*** SUMMARY ***
Total pot $2.50 | Rake $0 
Seat 3: Spartansmike
Seat 1: Gjeneral66 (big blind) folded before Flop
Seat 2: JoeyBaikie1 folded before Flop (didn't bet)
Seat 4: p0pa4poker folded before Flop (didn't bet)
Seat 5: Cositorto (button) collected ($2.50)
Seat 6: vadjkeee (small blind) folded before Flop



PokerStars Hand #254536409531:  Hold'em No Limit ($0.50/$1.00 USD) - 2025/01/24 21:49:06 WET [2025/01/24 16:49:06 ET]
Table 'Merapi IV' 6-max Seat #6 is the button
Seat 1: Gjeneral66 ($44.84 in chips) 
Seat 2: JoeyBaikie1 ($112.16 in chips) 
Seat 3: Spartansmike ($86.77 in chips) 
Seat 4: p0pa4poker ($103.94 in chips) 
Seat 5: Cositorto ($116.29 in chips) 
Seat 6: vadjkeee ($105.40 in chips) 
Gjeneral66: posts small blind $0.50
JoeyBaikie1: posts big blind $1
Spartansmike: posts small & big blinds $1.50
*** HOLE CARDS ***
Spartansmike: checks 
p0pa4poker: folds 
Cositorto: folds 
vadjkeee: raises $4 to $5
Gjeneral66: folds 
JoeyBaikie1: folds 
Spartansmike: folds 
Uncalled bet ($4) returned to vadjkeee
vadjkeee collected $4 from pot
vadjkeee: doesn't show hand 
*** SUMMARY ***
Total pot $4 | Rake $0 
Seat 1: Gjeneral66 (small blind) folded before Flop
Seat 2: JoeyBaikie1 (big blind) folded before Flop
Seat 3: Spartansmike folded before Flop (didn't bet)
Seat 4: p0pa4poker folded before Flop (didn't bet)
Seat 5: Cositorto folded before Flop (didn't bet)
Seat 6: vadjkeee (button) collected ($4)



PokerStars Hand #254536416729:  Hold'em No Limit ($0.50/$1.00 USD) - 2025/01/24 21:49:29 WET [2025/01/24 16:49:29 ET]
Table 'Merapi IV' 6-max Seat #1 is the button
Seat 1: Gjeneral66 ($44.34 in chips) 
Seat 2: JoeyBaikie1 ($111.16 in chips) 
Seat 3: Spartansmike ($85.27 in chips) 
Seat 4: p0pa4poker ($103.94 in chips) 
Seat 5: Cositorto ($116.29 in chips) 
Seat 6: vadjkeee ($108.40 in chips) 
JoeyBaikie1: posts small blind $0.50
Spartansmike: posts big blind $1
*** HOLE CARDS ***
p0pa4poker: raises $1 to $2
Cositorto: folds 
vadjkeee: folds 
Gjeneral66: calls $2
JoeyBaikie1: folds 
Spartansmike: calls $1
*** FLOP *** [6c 4c 9s]
Spartansmike: checks 
p0pa4poker: bets $2.04
Gjeneral66: folds 
Spartansmike: raises $10.26 to $12.30
p0pa4poker: calls $10.26
*** TURN *** [6c 4c 9s] [7s]
Spartansmike: checks 
p0pa4poker: bets $18.31
Spartansmike: folds 
Uncalled bet ($18.31) returned to p0pa4poker
p0pa4poker collected $29.54 from pot
p0pa4poker: doesn't show hand 
*** SUMMARY ***
Total pot $31.10 | Rake $1.56 
Board [6c 4c 9s 7s]
Seat 1: Gjeneral66 (button) folded on the Flop
Seat 2: JoeyBaikie1 (small blind) folded before Flop
Seat 3: Spartansmike (big blind) folded on the Turn
Seat 4: p0pa4poker collected ($29.54)
Seat 5: Cositorto folded before Flop (didn't bet)
Seat 6: vadjkeee folded before Flop (didn't bet)



PokerStars Hand #254536440955:  Hold'em No Limit ($0.50/$1.00 USD) - 2025/01/24 21:50:49 WET [2025/01/24 16:50:49 ET]
Table 'Merapi IV' 6-max Seat #2 is the button
Seat 1: Gjeneral66 ($42.34 in chips) 
Seat 2: JoeyBaikie1 ($110.66 in chips) 
Seat 3: Spartansmike ($70.97 in chips) 
Seat 4: p0pa4poker ($119.18 in chips) 
Seat 5: Cositorto ($116.29 in chips) 
Seat 6: vadjkeee ($108.40 in chips) 
Spartansmike: posts small blind $0.50
p0pa4poker: posts big blind $1
*** HOLE CARDS ***
Cositorto: folds 
vadjkeee: raises $2 to $3
Gjeneral66: folds 
JoeyBaikie1: folds 
Spartansmike: folds 
p0pa4poker: calls $2
*** FLOP *** [Ad 2h Qs]
p0pa4poker: checks 
vadjkeee: checks 
*** TURN *** [Ad 2h Qs] [Ah]
p0pa4poker: bets $4.76
vadjkeee: folds 
Uncalled bet ($4.76) returned to p0pa4poker
p0pa4poker collected $6.18 from pot
p0pa4poker: doesn't show hand 
*** SUMMARY ***
Total pot $6.50 | Rake $0.32 
Board [Ad 2h Qs Ah]
Seat 1: Gjeneral66 folded before Flop (didn't bet)
Seat 2: JoeyBaikie1 (button) folded before Flop (didn't bet)
Seat 3: Spartansmike (small blind) folded before Flop
Seat 4: p0pa4poker (big blind) collected ($6.18)
Seat 5: Cositorto folded before Flop (didn't bet)
Seat 6: vadjkeee folded on the Turn



PokerStars Hand #254536463974:  Hold'em No Limit ($0.50/$1.00 USD) - 2025/01/24 21:52:04 WET [2025/01/24 16:52:04 ET]
Table 'Merapi IV' 6-max Seat #3 is the button
Seat 5: Cositorto ($116.29 in chips) is sitting out
Seat 1: Gjeneral66 ($42.34 in chips) 
Seat 2: JoeyBaikie1 ($110.66 in chips) 
Seat 3: Spartansmike ($70.47 in chips) 
Seat 4: p0pa4poker ($122.36 in chips) 
Seat 6: vadjkeee ($105.40 in chips) 
p0pa4poker: posts small blind $0.50
Cositorto: is sitting out 
vadjkeee: posts big blind $1
*** HOLE CARDS ***
Cositorto leaves the table
Gjeneral66: folds 
michasia joins the table at seat #5 
JoeyBaikie1: folds 
Spartansmike: raises $2 to $3
p0pa4poker: folds 
vadjkeee: raises $7 to $10
Spartansmike: folds 
Uncalled bet ($7) returned to vadjkeee
vadjkeee collected $6.50 from pot
vadjkeee: doesn't show hand 
*** SUMMARY ***
Total pot $6.50 | Rake $0 
Seat 5: Cositorto
Seat 1: Gjeneral66 folded before Flop (didn't bet)
Seat 2: JoeyBaikie1 folded before Flop (didn't bet)
Seat 3: Spartansmike (button) folded before Flop
Seat 4: p0pa4poker (small blind) folded before Flop
Seat 6: vadjkeee (big blind) collected ($6.50)



PokerStars Hand #254536471531:  Hold'em No Limit ($0.50/$1.00 USD) - 2025/01/24 21:52:29 WET [2025/01/24 16:52:29 ET]
Table 'Merapi IV' 6-max Seat #4 is the button
Seat 5: michasia ($182.10 in chips) is sitting out
Seat 1: Gjeneral66 ($42.34 in chips) 
Seat 2: JoeyBaikie1 ($110.66 in chips) 
Seat 3: Spartansmike ($67.47 in chips) 
Seat 4: p0pa4poker ($121.86 in chips) 
Seat 6: vadjkeee ($108.90 in chips) 
vadjkeee: posts small blind $0.50
Gjeneral66: posts big blind $1
*** HOLE CARDS ***
JoeyBaikie1: raises $1.20 to $2.20
Spartansmike: folds 
Spartansmike leaves the table
p0pa4poker: folds 
vadjkeee: folds 
Gjeneral66: calls $1.20
*** FLOP *** [8s 7c As]
kars0n joins the table at seat #3 
Gjeneral66: checks 
JoeyBaikie1: checks 
*** TURN *** [8s 7c As] [Ah]
Gjeneral66: checks 
JoeyBaikie1: checks 
*** RIVER *** [8s 7c As Ah] [Ad]
Gjeneral66: checks 
JoeyBaikie1: checks 
*** SHOW DOWN ***
Gjeneral66: shows [9s Jd] (three of a kind, Aces)
JoeyBaikie1: shows [Qd Kc] (three of a kind, Aces - King kicker)
JoeyBaikie1 collected $4.66 from pot
*** SUMMARY ***
Total pot $4.90 | Rake $0.24 
Board [8s 7c As Ah Ad]
Seat 5: michasia
Seat 1: Gjeneral66 (big blind) showed [9s Jd] and lost with three of a kind, Aces
Seat 2: JoeyBaikie1 showed [Qd Kc] and won ($4.66) with three of a kind, Aces
Seat 3: Spartansmike folded before Flop (didn't bet)
Seat 4: p0pa4poker (button) folded before Flop (didn't bet)
Seat 6: vadjkeee (small blind) folded before Flop



PokerStars Hand #254536493412:  Hold'em No Limit ($0.50/$1.00 USD) - 2025/01/24 21:53:40 WET [2025/01/24 16:53:40 ET]
Table 'Merapi IV' 6-max Seat #6 is the button
Seat 3: kars0n ($100 in chips) is sitting out
Seat 5: michasia ($182.10 in chips) is sitting out
Seat 1: Gjeneral66 ($40.14 in chips) 
Seat 2: JoeyBaikie1 ($113.12 in chips) 
Seat 4: p0pa4poker ($121.86 in chips) 
Seat 6: vadjkeee ($108.40 in chips) 
Gjeneral66: posts small blind $0.50
JoeyBaikie1: posts big blind $1
kars0n: sits out 
michasia: sits out 
*** HOLE CARDS ***
p0pa4poker: folds 
vadjkeee: folds 
Gjeneral66: folds 
Uncalled bet ($0.50) returned to JoeyBaikie1
JoeyBaikie1 collected $1 from pot
JoeyBaikie1: doesn't show hand 
*** SUMMARY ***
Total pot $1 | Rake $0 
Seat 3: kars0n
Seat 5: michasia
Seat 1: Gjeneral66 (small blind) folded before Flop
Seat 2: JoeyBaikie1 (big blind) collected ($1)
Seat 4: p0pa4poker folded before Flop (didn't bet)
Seat 6: vadjkeee (button) folded before Flop (didn't bet)



PokerStars Hand #254536497213:  Hold'em No Limit ($0.50/$1.00 USD) - 2025/01/24 21:53:52 WET [2025/01/24 16:53:52 ET]
Table 'Merapi IV' 6-max Seat #1 is the button
Seat 5: michasia ($182.10 in chips) is sitting out
Seat 1: Gjeneral66 ($39.64 in chips) 
Seat 2: JoeyBaikie1 ($113.62 in chips) 
Seat 3: kars0n ($100 in chips) 
Seat 4: p0pa4poker ($121.86 in chips) 
Seat 6: vadjkeee ($108.40 in chips) 
JoeyBaikie1: posts small blind $0.50
kars0n: posts big blind $1
michasia: sits out 
*** HOLE CARDS ***
p0pa4poker: folds 
vadjkeee: raises $1.50 to $2.50
Gjeneral66: folds 
JoeyBaikie1: folds 
kars0n: folds 
Uncalled bet ($1.50) returned to vadjkeee
vadjkeee collected $2.50 from pot
vadjkeee: doesn't show hand 
*** SUMMARY ***
Total pot $2.50 | Rake $0 
Seat 5: michasia
Seat 1: Gjeneral66 (button) folded before Flop (didn't bet)
Seat 2: JoeyBaikie1 (small blind) folded before Flop
Seat 3: kars0n (big blind) folded before Flop
Seat 4: p0pa4poker folded before Flop (didn't bet)
Seat 6: vadjkeee collected ($2.50)



PokerStars Hand #254536503484:  Hold'em No Limit ($0.50/$1.00 USD) - 2025/01/24 21:54:13 WET [2025/01/24 16:54:13 ET]
Table 'Merapi IV' 6-max Seat #2 is the button
Seat 5: michasia ($182.10 in chips) is sitting out
Seat 1: Gjeneral66 ($39.64 in chips) 
Seat 2: JoeyBaikie1 ($113.12 in chips) 
Seat 3: kars0n ($100 in chips) 
Seat 4: p0pa4poker ($121.86 in chips) 
Seat 6: vadjkeee ($109.90 in chips) 
kars0n: posts small blind $0.50
p0pa4poker: posts big blind $1
michasia: sits out 
*** HOLE CARDS ***
vadjkeee: folds 
Gjeneral66: folds 
JoeyBaikie1: raises $1.50 to $2.50
kars0n: raises $10 to $12.50
p0pa4poker: folds 
JoeyBaikie1: folds 
Uncalled bet ($10) returned to kars0n
kars0n collected $6 from pot
kars0n: doesn't show hand 
*** SUMMARY ***
Total pot $6 | Rake $0 
Seat 5: michasia
Seat 1: Gjeneral66 folded before Flop (didn't bet)
Seat 2: JoeyBaikie1 (button) folded before Flop
Seat 3: kars0n (small blind) collected ($6)
Seat 4: p0pa4poker (big blind) folded before Flop
Seat 6: vadjkeee folded before Flop (didn't bet)



PokerStars Hand #254536513045:  Hold'em No Limit ($0.50/$1.00 USD) - 2025/01/24 21:54:44 WET [2025/01/24 16:54:44 ET]
Table 'Merapi IV' 6-max Seat #3 is the button
Seat 1: Gjeneral66 ($39.64 in chips) 
Seat 2: JoeyBaikie1 ($110.62 in chips) 
Seat 3: kars0n ($103.50 in chips) 
Seat 4: p0pa4poker ($120.86 in chips) 
Seat 5: michasia ($182.10 in chips) 
Seat 6: vadjkeee ($109.90 in chips) 
p0pa4poker: posts small blind $0.50
michasia: posts big blind $1
*** HOLE CARDS ***
vadjkeee: folds 
Gjeneral66: folds 
JoeyBaikie1: folds 
kars0n: raises $1.50 to $2.50
p0pa4poker: raises $9.50 to $12
michasia: raises $12 to $24
kars0n: folds 
p0pa4poker: folds 
Uncalled bet ($12) returned to michasia
michasia collected $26.50 from pot
michasia: doesn't show hand 
*** SUMMARY ***
Total pot $26.50 | Rake $0 
Seat 1: Gjeneral66 folded before Flop (didn't bet)
Seat 2: JoeyBaikie1 folded before Flop (didn't bet)
Seat 3: kars0n (button) folded before Flop
Seat 4: p0pa4poker (small blind) folded before Flop
Seat 5: michasia (big blind) collected ($26.50)
Seat 6: vadjkeee folded before Flop (didn't bet)



PokerStars Hand #254536528877:  Hold'em No Limit ($0.50/$1.00 USD) - 2025/01/24 21:55:43 WET [2025/01/24 16:55:43 ET]
Table 'Merapi IV' 6-max Seat #4 is the button
Seat 1: Gjeneral66 ($39.64 in chips) 
Seat 2: JoeyBaikie1 ($110.62 in chips) 
Seat 3: kars0n ($101 in chips) 
Seat 4: p0pa4poker ($108.86 in chips) 
Seat 5: michasia ($196.60 in chips) 
Seat 6: vadjkeee ($109.90 in chips) 
michasia: posts small blind $0.50
vadjkeee: posts big blind $1
*** HOLE CARDS ***
Gjeneral66: folds 
JoeyBaikie1: folds 
kars0n: folds 
p0pa4poker: folds 
michasia: folds 
Uncalled bet ($0.50) returned to vadjkeee
vadjkeee collected $1 from pot
vadjkeee: doesn't show hand 
*** SUMMARY ***
Total pot $1 | Rake $0 
Seat 1: Gjeneral66 folded before Flop (didn't bet)
Seat 2: JoeyBaikie1 folded before Flop (didn't bet)
Seat 3: kars0n folded before Flop (didn't bet)
Seat 4: p0pa4poker (button) folded before Flop (didn't bet)
Seat 5: michasia (small blind) folded before Flop
Seat 6: vadjkeee (big blind) collected ($1)



PokerStars Hand #254536532978:  Hold'em No Limit ($0.50/$1.00 USD) - 2025/01/24 21:56:02 WET [2025/01/24 16:56:02 ET]
Table 'Merapi IV' 6-max Seat #5 is the button
Seat 1: Gjeneral66 ($39.64 in chips) 
Seat 2: JoeyBaikie1 ($110.62 in chips) 
Seat 3: kars0n ($101 in chips) 
Seat 4: p0pa4poker ($108.86 in chips) 
Seat 5: michasia ($196.10 in chips) 
Seat 6: vadjkeee ($110.40 in chips) 
vadjkeee: posts small blind $0.50
Gjeneral66: posts big blind $1
*** HOLE CARDS ***
JoeyBaikie1: folds 
kars0n: folds 
p0pa4poker: folds 
michasia: raises $1.80 to $2.80
vadjkeee: folds 
Gjeneral66: folds 
Uncalled bet ($1.80) returned to michasia
michasia collected $2.50 from pot
michasia: doesn't show hand 
*** SUMMARY ***
Total pot $2.50 | Rake $0 
Seat 1: Gjeneral66 (big blind) folded before Flop
Seat 2: JoeyBaikie1 folded before Flop (didn't bet)
Seat 3: kars0n folded before Flop (didn't bet)
Seat 4: p0pa4poker folded before Flop (didn't bet)
Seat 5: michasia (button) collected ($2.50)
Seat 6: vadjkeee (small blind) folded before Flop



PokerStars Hand #254536537428:  Hold'em No Limit ($0.50/$1.00 USD) - 2025/01/24 21:56:21 WET [2025/01/24 16:56:21 ET]
Table 'Merapi IV' 6-max Seat #6 is the button
Seat 1: Gjeneral66 ($38.64 in chips) 
Seat 2: JoeyBaikie1 ($110.62 in chips) 
Seat 3: kars0n ($101 in chips) 
Seat 4: p0pa4poker ($108.86 in chips) 
Seat 5: michasia ($197.60 in chips) 
Seat 6: vadjkeee ($109.90 in chips) 
Gjeneral66: posts small blind $0.50
JoeyBaikie1: posts big blind $1
*** HOLE CARDS ***
kars0n: folds 
p0pa4poker: folds 
michasia: folds 
vadjkeee: folds 
Gjeneral66: folds 
Uncalled bet ($0.50) returned to JoeyBaikie1
JoeyBaikie1 collected $1 from pot
JoeyBaikie1: doesn't show hand 
*** SUMMARY ***
Total pot $1 | Rake $0 
Seat 1: Gjeneral66 (small blind) folded before Flop
Seat 2: JoeyBaikie1 (big blind) collected ($1)
Seat 3: kars0n folded before Flop (didn't bet)
Seat 4: p0pa4poker folded before Flop (didn't bet)
Seat 5: michasia folded before Flop (didn't bet)
Seat 6: vadjkeee (button) folded before Flop (didn't bet)



PokerStars Hand #254536540066:  Hold'em No Limit ($0.50/$1.00 USD) - 2025/01/24 21:56:33 WET [2025/01/24 16:56:33 ET]
Table 'Merapi IV' 6-max Seat #1 is the button
Seat 1: Gjeneral66 ($38.14 in chips) 
Seat 2: JoeyBaikie1 ($111.12 in chips) 
Seat 3: kars0n ($101 in chips) 
Seat 4: p0pa4poker ($108.86 in chips) 
Seat 5: michasia ($197.60 in chips) 
Seat 6: vadjkeee ($109.90 in chips) 
JoeyBaikie1: posts small blind $0.50
kars0n: posts big blind $1
*** HOLE CARDS ***
p0pa4poker: folds 
michasia: raises $1.60 to $2.60
vadjkeee: folds 
Gjeneral66: folds 
JoeyBaikie1: folds 
kars0n: folds 
Uncalled bet ($1.60) returned to michasia
michasia collected $2.50 from pot
michasia: doesn't show hand 
*** SUMMARY ***
Total pot $2.50 | Rake $0 
Seat 1: Gjeneral66 (button) folded before Flop (didn't bet)
Seat 2: JoeyBaikie1 (small blind) folded before Flop
Seat 3: kars0n (big blind) folded before Flop
Seat 4: p0pa4poker folded before Flop (didn't bet)
Seat 5: michasia collected ($2.50)
Seat 6: vadjkeee folded before Flop (didn't bet)



PokerStars Hand #254536543786:  Hold'em No Limit ($0.50/$1.00 USD) - 2025/01/24 21:56:49 WET [2025/01/24 16:56:49 ET]
Table 'Merapi IV' 6-max Seat #2 is the button
Seat 1: Gjeneral66 ($38.14 in chips) 
Seat 2: JoeyBaikie1 ($110.62 in chips) 
Seat 3: kars0n ($100 in chips) 
Seat 4: p0pa4poker ($108.86 in chips) 
Seat 5: michasia ($199.10 in chips) 
Seat 6: vadjkeee ($109.90 in chips) 
kars0n: posts small blind $0.50
p0pa4poker: posts big blind $1
*** HOLE CARDS ***
michasia: folds 
vadjkeee: folds 
Gjeneral66: folds 
JoeyBaikie1: folds 
kars0n: folds 
Uncalled bet ($0.50) returned to p0pa4poker
p0pa4poker collected $1 from pot
p0pa4poker: doesn't show hand 
*** SUMMARY ***
Total pot $1 | Rake $0 
Seat 1: Gjeneral66 folded before Flop (didn't bet)
Seat 2: JoeyBaikie1 (button) folded before Flop (didn't bet)
Seat 3: kars0n (small blind) folded before Flop
Seat 4: p0pa4poker (big blind) collected ($1)
Seat 5: michasia folded before Flop (didn't bet)
Seat 6: vadjkeee folded before Flop (didn't bet)



PokerStars Hand #254536546403:  Hold'em No Limit ($0.50/$1.00 USD) - 2025/01/24 21:57:01 WET [2025/01/24 16:57:01 ET]
Table 'Merapi IV' 6-max Seat #3 is the button
Seat 5: michasia ($199.10 in chips) is sitting out
Seat 1: Gjeneral66 ($38.14 in chips) 
Seat 2: JoeyBaikie1 ($110.62 in chips) 
Seat 3: kars0n ($100 in chips) 
Seat 4: p0pa4poker ($109.36 in chips) 
Seat 6: vadjkeee ($109.90 in chips) 
p0pa4poker: posts small blind $0.50
michasia: is sitting out 
vadjkeee: posts big blind $1
*** HOLE CARDS ***
michasia leaves the table
Gjeneral66: raises $1.50 to $2.50
JoeyBaikie1: folds 
kars0n: folds 
p0pa4poker: folds 
vadjkeee: folds 
Uncalled bet ($1.50) returned to Gjeneral66
Gjeneral66 collected $2.50 from pot
*** SUMMARY ***
Total pot $2.50 | Rake $0 
Seat 5: michasia
Seat 1: Gjeneral66 collected ($2.50)
Seat 2: JoeyBaikie1 folded before Flop (didn't bet)
Seat 3: kars0n (button) folded before Flop (didn't bet)
Seat 4: p0pa4poker (small blind) folded before Flop
Seat 6: vadjkeee (big blind) folded before Flop



PokerStars Hand #254536552301:  Hold'em No Limit ($0.50/$1.00 USD) - 2025/01/24 21:57:26 WET [2025/01/24 16:57:26 ET]
Table 'Merapi IV' 6-max Seat #4 is the button
Seat 1: Gjeneral66 ($39.64 in chips) 
Seat 2: JoeyBaikie1 ($110.62 in chips) 
Seat 3: kars0n ($100 in chips) 
Seat 4: p0pa4poker ($108.86 in chips) 
Seat 6: vadjkeee ($108.90 in chips) 
vadjkeee: posts small blind $0.50
Gjeneral66: posts big blind $1
*** HOLE CARDS ***
Trojanovich joins the table at seat #5 
JoeyBaikie1: folds 
kars0n: folds 
p0pa4poker: folds 
vadjkeee: folds 
Uncalled bet ($0.50) returned to Gjeneral66
Gjeneral66 collected $1 from pot
*** SUMMARY ***
Total pot $1 | Rake $0 
Seat 1: Gjeneral66 (big blind) collected ($1)
Seat 2: JoeyBaikie1 folded before Flop (didn't bet)
Seat 3: kars0n folded before Flop (didn't bet)
Seat 4: p0pa4poker (button) folded before Flop (didn't bet)
Seat 6: vadjkeee (small blind) folded before Flop



PokerStars Hand #254536556448:  Hold'em No Limit ($0.50/$1.00 USD) - 2025/01/24 21:57:45 WET [2025/01/24 16:57:45 ET]
Table 'Merapi IV' 6-max Seat #6 is the button
Seat 5: Trojanovich ($100 in chips) is sitting out
Seat 1: Gjeneral66 ($40.14 in chips) 
Seat 2: JoeyBaikie1 ($110.62 in chips) 
Seat 3: kars0n ($100 in chips) 
Seat 4: p0pa4poker ($108.86 in chips) 
Seat 6: vadjkeee ($108.40 in chips) 
Gjeneral66: posts small blind $0.50
JoeyBaikie1: posts big blind $1
Trojanovich: sits out 
*** HOLE CARDS ***
kars0n: folds 
kars0n leaves the table
p0pa4poker: folds 
vadjkeee: raises $1.50 to $2.50
Gjeneral66: folds 
JoeyBaikie1: folds 
Uncalled bet ($1.50) returned to vadjkeee
vadjkeee collected $2.50 from pot
vadjkeee: doesn't show hand 
*** SUMMARY ***
Total pot $2.50 | Rake $0 
Seat 5: Trojanovich
Seat 1: Gjeneral66 (small blind) folded before Flop
Seat 2: JoeyBaikie1 (big blind) folded before Flop
Seat 3: kars0n folded before Flop (didn't bet)
Seat 4: p0pa4poker folded before Flop (didn't bet)
Seat 6: vadjkeee (button) collected ($2.50)



PokerStars Hand #254536561242:  Hold'em No Limit ($0.50/$1.00 USD) - 2025/01/24 21:58:05 WET [2025/01/24 16:58:05 ET]
Table 'Merapi IV' 6-max Seat #1 is the button
Seat 5: Trojanovich ($100 in chips) is sitting out
Seat 1: Gjeneral66 ($39.64 in chips) 
Seat 2: JoeyBaikie1 ($109.62 in chips) 
Seat 4: p0pa4poker ($108.86 in chips) 
Seat 6: vadjkeee ($109.90 in chips) 
JoeyBaikie1: posts small blind $0.50
p0pa4poker: posts big blind $1
Trojanovich: sits out 
*** HOLE CARDS ***
vadjkeee: folds 
Gjeneral66: folds 
JoeyBaikie1: folds 
Uncalled bet ($0.50) returned to p0pa4poker
p0pa4poker collected $1 from pot
p0pa4poker: doesn't show hand 
*** SUMMARY ***
Total pot $1 | Rake $0 
Seat 5: Trojanovich
Seat 1: Gjeneral66 (button) folded before Flop (didn't bet)
Seat 2: JoeyBaikie1 (small blind) folded before Flop
Seat 4: p0pa4poker (big blind) collected ($1)
Seat 6: vadjkeee folded before Flop (didn't bet)



PokerStars Hand #254536566365:  Hold'em No Limit ($0.50/$1.00 USD) - 2025/01/24 21:58:27 WET [2025/01/24 16:58:27 ET]
Table 'Merapi IV' 6-max Seat #2 is the button
Seat 1: Gjeneral66 ($39.64 in chips) 
Seat 2: JoeyBaikie1 ($109.12 in chips) 
Seat 4: p0pa4poker ($109.36 in chips) 
Seat 5: Trojanovich ($100 in chips) 
Seat 6: vadjkeee ($109.90 in chips) 
p0pa4poker: posts small blind $0.50
Trojanovich: posts big blind $1
*** HOLE CARDS ***
vadjkeee: folds 
vadjkeee leaves the table
Gjeneral66: raises $1.50 to $2.50
JoeyBaikie1: folds 
p0pa4poker: folds 
Trojanovich: folds 
Uncalled bet ($1.50) returned to Gjeneral66
Gjeneral66 collected $2.50 from pot
*** SUMMARY ***
Total pot $2.50 | Rake $0 
Seat 1: Gjeneral66 collected ($2.50)
Seat 2: JoeyBaikie1 (button) folded before Flop (didn't bet)
Seat 4: p0pa4poker (small blind) folded before Flop
Seat 5: Trojanovich (big blind) folded before Flop
Seat 6: vadjkeee folded before Flop (didn't bet)



PokerStars Hand #254536569586:  Hold'em No Limit ($0.50/$1.00 USD) - 2025/01/24 21:58:41 WET [2025/01/24 16:58:41 ET]
Table 'Merapi IV' 6-max Seat #4 is the button
Seat 1: Gjeneral66 ($41.14 in chips) 
Seat 2: JoeyBaikie1 ($109.12 in chips) 
Seat 4: p0pa4poker ($108.86 in chips) 
Seat 5: Trojanovich ($100 in chips) 
Trojanovich: posts small blind $0.50
Gjeneral66: posts big blind $1
*** HOLE CARDS ***
JoeyBaikie1: folds 
p0pa4poker: folds 
Trojanovich: folds 
Uncalled bet ($0.50) returned to Gjeneral66
Gjeneral66 collected $1 from pot
*** SUMMARY ***
Total pot $1 | Rake $0 
Seat 1: Gjeneral66 (big blind) collected ($1)
Seat 2: JoeyBaikie1 folded before Flop (didn't bet)
Seat 4: p0pa4poker (button) folded before Flop (didn't bet)
Seat 5: Trojanovich (small blind) folded before Flop



PokerStars Hand #254536572072:  Hold'em No Limit ($0.50/$1.00 USD) - 2025/01/24 21:58:52 WET [2025/01/24 16:58:52 ET]
Table 'Merapi IV' 6-max Seat #5 is the button
Seat 1: Gjeneral66 ($41.64 in chips) 
Seat 2: JoeyBaikie1 ($109.12 in chips) 
Seat 4: p0pa4poker ($108.86 in chips) 
Seat 5: Trojanovich ($100 in chips) 
Gjeneral66: posts small blind $0.50
JoeyBaikie1: posts big blind $1
*** HOLE CARDS ***
p0pa4poker: raises $1.30 to $2.30
Trojanovich: raises $5.20 to $7.50
Gjeneral66: folds 
JoeyBaikie1: folds 
p0pa4poker: raises $13.50 to $21
Trojanovich: raises $79 to $100 and is all-in
p0pa4poker: calls $79
*** FLOP *** [Qd Ts Th]
*** TURN *** [Qd Ts Th] [4c]
*** RIVER *** [Qd Ts Th 4c] [3d]
*** SHOW DOWN ***
p0pa4poker: shows [Kh As] (a pair of Tens)
Trojanovich: shows [Qh Qs] (a full house, Queens full of Tens)
Trojanovich collected $200.50 from pot
p0pa4poker cashed out the hand for $85.77 | Cash Out Fee $1.75
*** SUMMARY ***
Total pot $201.50 | Rake $1 
Board [Qd Ts Th 4c 3d]
Seat 1: Gjeneral66 (small blind) folded before Flop
Seat 2: JoeyBaikie1 (big blind) folded before Flop
Seat 4: p0pa4poker showed [Kh As] and lost with a pair of Tens (cashed out).
Seat 5: Trojanovich (button) showed [Qh Qs] and won ($200.50) with a full house, Queens full of Tens



PokerStars Hand #254536581988:  Hold'em No Limit ($0.50/$1.00 USD) - 2025/01/24 21:59:35 WET [2025/01/24 16:59:35 ET]
Table 'Merapi IV' 6-max Seat #1 is the button
Seat 4: p0pa4poker ($94.63 in chips) is sitting out
Seat 1: Gjeneral66 ($41.14 in chips) 
Seat 2: JoeyBaikie1 ($108.12 in chips) 
Seat 5: Trojanovich ($200.50 in chips) 
JoeyBaikie1: posts small blind $0.50
p0pa4poker: is sitting out 
Trojanovich: posts big blind $1
*** HOLE CARDS ***
Gjeneral66: raises $1.50 to $2.50
JoeyBaikie1: folds 
Trojanovich: raises $198 to $200.50 and is all-in
Gjeneral66: folds 
Uncalled bet ($198) returned to Trojanovich
Trojanovich collected $5.50 from pot
Trojanovich: doesn't show hand 
*** SUMMARY ***
Total pot $5.50 | Rake $0 
Seat 4: p0pa4poker
Seat 1: Gjeneral66 (button) folded before Flop
Seat 2: JoeyBaikie1 (small blind) folded before Flop
Seat 5: Trojanovich (big blind) collected ($5.50)



PokerStars Hand #254536587671:  Hold'em No Limit ($0.50/$1.00 USD) - 2025/01/24 22:00:00 WET [2025/01/24 17:00:00 ET]
Table 'Merapi IV' 6-max Seat #2 is the button
Seat 4: p0pa4poker ($100 in chips) is sitting out
Seat 1: Gjeneral66 ($38.64 in chips) 
Seat 2: JoeyBaikie1 ($107.62 in chips) 
Seat 5: Trojanovich ($203.50 in chips) 
Trojanovich: posts small blind $0.50
Gjeneral66: posts big blind $1
*** HOLE CARDS ***
JoeyBaikie1: raises $1.50 to $2.50
Trojanovich: folds 
Gjeneral66: calls $1.50
*** FLOP *** [Qd As 5c]
Gjeneral66: checks 
JoeyBaikie1: checks 
*** TURN *** [Qd As 5c] [6h]
Gjeneral66: checks 
JoeyBaikie1: checks 
*** RIVER *** [Qd As 5c 6h] [Td]
Gjeneral66: checks 
JoeyBaikie1: bets $3.92
Gjeneral66: calls $3.92
*** SHOW DOWN ***
JoeyBaikie1: shows [8d Qs] (a pair of Queens)
Gjeneral66: shows [Kd Qc] (a pair of Queens - Ace+King kicker)
Gjeneral66 collected $12.67 from pot
*** SUMMARY ***
Total pot $13.34 | Rake $0.67 
Board [Qd As 5c 6h Td]
Seat 4: p0pa4poker
Seat 1: Gjeneral66 (big blind) showed [Kd Qc] and won ($12.67) with a pair of Queens
Seat 2: JoeyBaikie1 (button) showed [8d Qs] and lost with a pair of Queens
Seat 5: Trojanovich (small blind) folded before Flop



PokerStars Hand #254536598257:  Hold'em No Limit ($0.50/$1.00 USD) - 2025/01/24 22:00:45 WET [2025/01/24 17:00:45 ET]
Table 'Merapi IV' 6-max Seat #5 is the button
Seat 4: p0pa4poker ($100 in chips) is sitting out
Seat 1: Gjeneral66 ($44.89 in chips) 
Seat 2: JoeyBaikie1 ($101.20 in chips) 
Seat 5: Trojanovich ($203 in chips) 
Gjeneral66: posts small blind $0.50
JoeyBaikie1: posts big blind $1
p0pa4poker: sits out 
*** HOLE CARDS ***
Trojanovich: raises $1.50 to $2.50
Gjeneral66: folds 
JoeyBaikie1: folds 
Uncalled bet ($1.50) returned to Trojanovich
Trojanovich collected $2.50 from pot
Trojanovich: doesn't show hand 
*** SUMMARY ***
Total pot $2.50 | Rake $0 
Seat 4: p0pa4poker
Seat 1: Gjeneral66 (small blind) folded before Flop
Seat 2: JoeyBaikie1 (big blind) folded before Flop
Seat 5: Trojanovich (button) collected ($2.50)



PokerStars Hand #254536601087:  Hold'em No Limit ($0.50/$1.00 USD) - 2025/01/24 22:00:56 WET [2025/01/24 17:00:56 ET]
Table 'Merapi IV' 6-max Seat #1 is the button
Seat 1: Gjeneral66 ($44.39 in chips) 
Seat 2: JoeyBaikie1 ($100.20 in chips) 
Seat 4: p0pa4poker ($100 in chips) 
Seat 5: Trojanovich ($204.50 in chips) 
JoeyBaikie1: posts small blind $0.50
p0pa4poker: posts big blind $1
*** HOLE CARDS ***
Trojanovich: folds 
Gjeneral66: raises $1.50 to $2.50
JoeyBaikie1: folds 
p0pa4poker: folds 
Uncalled bet ($1.50) returned to Gjeneral66
Gjeneral66 collected $2.50 from pot
*** SUMMARY ***
Total pot $2.50 | Rake $0 
Seat 1: Gjeneral66 (button) collected ($2.50)
Seat 2: JoeyBaikie1 (small blind) folded before Flop
Seat 4: p0pa4poker (big blind) folded before Flop
Seat 5: Trojanovich folded before Flop (didn't bet)



PokerStars Hand #254536606436:  Hold'em No Limit ($0.50/$1.00 USD) - 2025/01/24 22:01:16 WET [2025/01/24 17:01:16 ET]
Table 'Merapi IV' 6-max Seat #2 is the button
Seat 1: Gjeneral66 ($45.89 in chips) 
Seat 2: JoeyBaikie1 ($100 in chips) 
Seat 4: p0pa4poker ($99 in chips) 
Seat 5: Trojanovich ($204.50 in chips) 
p0pa4poker: posts small blind $0.50
Trojanovich: posts big blind $1
*** HOLE CARDS ***
Gjeneral66: folds 
JoeyBaikie1: raises $1.50 to $2.50
p0pa4poker: folds 
Trojanovich: folds 
Uncalled bet ($1.50) returned to JoeyBaikie1
JoeyBaikie1 collected $2.50 from pot
JoeyBaikie1: doesn't show hand 
*** SUMMARY ***
Total pot $2.50 | Rake $0 
Seat 1: Gjeneral66 folded before Flop (didn't bet)
Seat 2: JoeyBaikie1 (button) collected ($2.50)
Seat 4: p0pa4poker (small blind) folded before Flop
Seat 5: Trojanovich (big blind) folded before Flop



PokerStars Hand #254536611574:  Hold'em No Limit ($0.50/$1.00 USD) - 2025/01/24 22:01:35 WET [2025/01/24 17:01:35 ET]
Table 'Merapi IV' 6-max Seat #4 is the button
Seat 1: Gjeneral66 ($45.89 in chips) 
Seat 2: JoeyBaikie1 ($101.50 in chips) 
Seat 4: p0pa4poker ($100 in chips) 
Seat 5: Trojanovich ($203.50 in chips) 
Trojanovich: posts small blind $0.50
Gjeneral66: posts big blind $1
*** HOLE CARDS ***
JoeyBaikie1: raises $1.20 to $2.20
p0pa4poker: raises $5.30 to $7.50
Trojanovich: folds 
Gjeneral66: folds 
JoeyBaikie1: folds 
Uncalled bet ($5.30) returned to p0pa4poker
p0pa4poker collected $5.90 from pot
p0pa4poker: doesn't show hand 
*** SUMMARY ***
Total pot $5.90 | Rake $0 
Seat 1: Gjeneral66 (big blind) folded before Flop
Seat 2: JoeyBaikie1 folded before Flop
Seat 4: p0pa4poker (button) collected ($5.90)
Seat 5: Trojanovich (small blind) folded before Flop



PokerStars Hand #254536616996:  Hold'em No Limit ($0.50/$1.00 USD) - 2025/01/24 22:01:54 WET [2025/01/24 17:01:54 ET]
Table 'Merapi IV' 6-max Seat #5 is the button
Seat 1: Gjeneral66 ($44.89 in chips) 
Seat 2: JoeyBaikie1 ($100 in chips) 
Seat 4: p0pa4poker ($103.70 in chips) 
Seat 5: Trojanovich ($203 in chips) 
Gjeneral66: posts small blind $0.50
JoeyBaikie1: posts big blind $1
*** HOLE CARDS ***
p0pa4poker: folds 
Trojanovich: folds 
Gjeneral66: raises $2 to $3
JoeyBaikie1: folds 
Uncalled bet ($2) returned to Gjeneral66
Gjeneral66 collected $2 from pot
*** SUMMARY ***
Total pot $2 | Rake $0 
Seat 1: Gjeneral66 (small blind) collected ($2)
Seat 2: JoeyBaikie1 (big blind) folded before Flop
Seat 4: p0pa4poker folded before Flop (didn't bet)
Seat 5: Trojanovich (button) folded before Flop (didn't bet)



PokerStars Hand #254536620233:  Hold'em No Limit ($0.50/$1.00 USD) - 2025/01/24 22:02:06 WET [2025/01/24 17:02:06 ET]
Table 'Merapi IV' 6-max Seat #1 is the button
Seat 1: Gjeneral66 ($45.89 in chips) 
Seat 2: JoeyBaikie1 ($100 in chips) 
Seat 4: p0pa4poker ($103.70 in chips) 
Seat 5: Trojanovich ($203 in chips) 
JoeyBaikie1: posts small blind $0.50
p0pa4poker: posts big blind $1
*** HOLE CARDS ***
Trojanovich: folds 
Gjeneral66: folds 
JoeyBaikie1: raises $2 to $3
p0pa4poker: raises $7 to $10
JoeyBaikie1: folds 
Uncalled bet ($7) returned to p0pa4poker
p0pa4poker collected $6 from pot
p0pa4poker: doesn't show hand 
*** SUMMARY ***
Total pot $6 | Rake $0 
Seat 1: Gjeneral66 (button) folded before Flop (didn't bet)
Seat 2: JoeyBaikie1 (small blind) folded before Flop
Seat 4: p0pa4poker (big blind) collected ($6)
Seat 5: Trojanovich folded before Flop (didn't bet)



PokerStars Hand #254536632300:  Hold'em No Limit ($0.50/$1.00 USD) - 2025/01/24 22:02:46 WET [2025/01/24 17:02:46 ET]
Table 'Merapi IV' 6-max Seat #2 is the button
Seat 1: Gjeneral66 ($45.89 in chips) 
Seat 2: JoeyBaikie1 ($100 in chips) 
Seat 4: p0pa4poker ($106.70 in chips) 
Seat 5: Trojanovich ($203 in chips) 
p0pa4poker: posts small blind $0.50
Trojanovich: posts big blind $1
*** HOLE CARDS ***
Gjeneral66: raises $1.50 to $2.50
JoeyBaikie1: raises $4.50 to $7
p0pa4poker: folds 
Trojanovich: folds 
Gjeneral66: calls $4.50
*** FLOP *** [Qs Qd Ks]
Gjeneral66: checks 
JoeyBaikie1: checks 
*** TURN *** [Qs Qd Ks] [Qc]
Gjeneral66: bets $7.36
JoeyBaikie1: calls $7.36
*** RIVER *** [Qs Qd Ks Qc] [As]
Gjeneral66: checks 
JoeyBaikie1: bets $9.64
Gjeneral66: folds 
Uncalled bet ($9.64) returned to JoeyBaikie1
JoeyBaikie1 collected $29.22 from pot
JoeyBaikie1: doesn't show hand 
*** SUMMARY ***
Total pot $30.22 | Rake $1 
Board [Qs Qd Ks Qc As]
Seat 1: Gjeneral66 folded on the River
Seat 2: JoeyBaikie1 (button) collected ($29.22)
Seat 4: p0pa4poker (small blind) folded before Flop
Seat 5: Trojanovich (big blind) folded before Flop



PokerStars Hand #254536653593:  Hold'em No Limit ($0.50/$1.00 USD) - 2025/01/24 22:03:56 WET [2025/01/24 17:03:56 ET]
Table 'Merapi IV' 6-max Seat #4 is the button
Seat 1: Gjeneral66 ($31.53 in chips) 
Seat 2: JoeyBaikie1 ($114.86 in chips) 
Seat 4: p0pa4poker ($106.20 in chips) 
Seat 5: Trojanovich ($202 in chips) 
Trojanovich: posts small blind $0.50
Gjeneral66: posts big blind $1
*** HOLE CARDS ***
JoeyBaikie1: raises $1.20 to $2.20
p0pa4poker: folds 
Trojanovich: folds 
Gjeneral66: folds 
Uncalled bet ($1.20) returned to JoeyBaikie1
JoeyBaikie1 collected $2.50 from pot
JoeyBaikie1: doesn't show hand 
*** SUMMARY ***
Total pot $2.50 | Rake $0 
Seat 1: Gjeneral66 (big blind) folded before Flop
Seat 2: JoeyBaikie1 collected ($2.50)
Seat 4: p0pa4poker (button) folded before Flop (didn't bet)
Seat 5: Trojanovich (small blind) folded before Flop



PokerStars Hand #254536656717:  Hold'em No Limit ($0.50/$1.00 USD) - 2025/01/24 22:04:07 WET [2025/01/24 17:04:07 ET]
Table 'Merapi IV' 6-max Seat #5 is the button
Seat 1: Gjeneral66 ($30.53 in chips) 
Seat 2: JoeyBaikie1 ($116.36 in chips) 
Seat 4: p0pa4poker ($106.20 in chips) 
Seat 5: Trojanovich ($201.50 in chips) 
Gjeneral66: posts small blind $0.50
JoeyBaikie1: posts big blind $1
*** HOLE CARDS ***
p0pa4poker: raises $1.30 to $2.30
Trojanovich: folds 
Gjeneral66: folds 
JoeyBaikie1: folds 
Uncalled bet ($1.30) returned to p0pa4poker
p0pa4poker collected $2.50 from pot
p0pa4poker: doesn't show hand 
*** SUMMARY ***
Total pot $2.50 | Rake $0 
Seat 1: Gjeneral66 (small blind) folded before Flop
Seat 2: JoeyBaikie1 (big blind) folded before Flop
Seat 4: p0pa4poker collected ($2.50)
Seat 5: Trojanovich (button) folded before Flop (didn't bet)



PokerStars Hand #254536659774:  Hold'em No Limit ($0.50/$1.00 USD) - 2025/01/24 22:04:17 WET [2025/01/24 17:04:17 ET]
Table 'Merapi IV' 6-max Seat #1 is the button
Seat 1: Gjeneral66 ($30.03 in chips) 
Seat 2: JoeyBaikie1 ($115.36 in chips) 
Seat 4: p0pa4poker ($107.70 in chips) 
Seat 5: Trojanovich ($201.50 in chips) 
JoeyBaikie1: posts small blind $0.50
p0pa4poker: posts big blind $1
*** HOLE CARDS ***
Trojanovich: raises $1.50 to $2.50
Gjeneral66: folds 
JoeyBaikie1: raises $8.50 to $11
p0pa4poker: raises $13 to $24
BrilliantDawn84 joins the table at seat #6 
Maks Bavenko joins the table at seat #3 
Trojanovich: raises $177.50 to $201.50 and is all-in
JoeyBaikie1: folds 
p0pa4poker: folds 
Uncalled bet ($177.50) returned to Trojanovich
Trojanovich collected $59 from pot
Trojanovich: doesn't show hand 
*** SUMMARY ***
Total pot $59 | Rake $0 
Seat 1: Gjeneral66 (button) folded before Flop (didn't bet)
Seat 2: JoeyBaikie1 (small blind) folded before Flop
Seat 4: p0pa4poker (big blind) folded before Flop
Seat 5: Trojanovich collected ($59)



PokerStars Hand #254536679310:  Hold'em No Limit ($0.50/$1.00 USD) - 2025/01/24 22:05:21 WET [2025/01/24 17:05:21 ET]
Table 'Merapi IV' 6-max Seat #2 is the button
Seat 3: Maks Bavenko ($100 in chips) is sitting out
Seat 6: BrilliantDawn84 ($100 in chips) is sitting out
Seat 1: Gjeneral66 ($30.03 in chips) 
Seat 2: JoeyBaikie1 ($104.36 in chips) 
Seat 4: p0pa4poker ($100 in chips) 
Seat 5: Trojanovich ($236.50 in chips) 
p0pa4poker: posts small blind $0.50
Trojanovich: posts big blind $1
BrilliantDawn84: sits out 
*** HOLE CARDS ***
Gjeneral66: folds 
JoeyBaikie1: raises $1.50 to $2.50
p0pa4poker: folds 
Trojanovich: calls $1.50
*** FLOP *** [Kh 5d 7c]
Trojanovich: checks 
JoeyBaikie1: checks 
*** TURN *** [Kh 5d 7c] [4d]
Trojanovich: checks 
JoeyBaikie1: checks 
*** RIVER *** [Kh 5d 7c 4d] [4h]
Trojanovich: bets $1.72
JoeyBaikie1: calls $1.72
*** SHOW DOWN ***
Trojanovich: shows [7d 9d] (two pair, Sevens and Fours)
JoeyBaikie1: mucks hand 
Trojanovich collected $8.49 from pot
*** SUMMARY ***
Total pot $8.94 | Rake $0.45 
Board [Kh 5d 7c 4d 4h]
Seat 3: Maks Bavenko
Seat 6: BrilliantDawn84
Seat 1: Gjeneral66 folded before Flop (didn't bet)
Seat 2: JoeyBaikie1 (button) mucked
Seat 4: p0pa4poker (small blind) folded before Flop
Seat 5: Trojanovich (big blind) showed [7d 9d] and won ($8.49) with two pair, Sevens and Fours



PokerStars Hand #254536694044:  Hold'em No Limit ($0.50/$1.00 USD) - 2025/01/24 22:06:10 WET [2025/01/24 17:06:10 ET]
Table 'Merapi IV' 6-max Seat #4 is the button
Seat 3: Maks Bavenko ($100 in chips) is sitting out
Seat 1: Gjeneral66 ($30.03 in chips) 
Seat 2: JoeyBaikie1 ($100.14 in chips) 
Seat 4: p0pa4poker ($99.50 in chips) 
Seat 5: Trojanovich ($240.77 in chips) 
Seat 6: BrilliantDawn84 ($100 in chips) 
Trojanovich: posts small blind $0.50
BrilliantDawn84: posts big blind $1
Maks Bavenko: sits out 
*** HOLE CARDS ***
Gjeneral66: raises $1.50 to $2.50
JoeyBaikie1: folds 
p0pa4poker: folds 
Trojanovich: folds 
BrilliantDawn84: folds 
Uncalled bet ($1.50) returned to Gjeneral66
Gjeneral66 collected $2.50 from pot
*** SUMMARY ***
Total pot $2.50 | Rake $0 
Seat 3: Maks Bavenko
Seat 1: Gjeneral66 collected ($2.50)
Seat 2: JoeyBaikie1 folded before Flop (didn't bet)
Seat 4: p0pa4poker (button) folded before Flop (didn't bet)
Seat 5: Trojanovich (small blind) folded before Flop
Seat 6: BrilliantDawn84 (big blind) folded before Flop



PokerStars Hand #254536702360:  Hold'em No Limit ($0.50/$1.00 USD) - 2025/01/24 22:06:37 WET [2025/01/24 17:06:37 ET]
Table 'Merapi IV' 6-max Seat #5 is the button
Seat 3: Maks Bavenko ($100 in chips) is sitting out
Seat 1: Gjeneral66 ($31.53 in chips) 
Seat 2: JoeyBaikie1 ($100.14 in chips) 
Seat 4: p0pa4poker ($99.50 in chips) 
Seat 5: Trojanovich ($240.27 in chips) 
Seat 6: BrilliantDawn84 ($99 in chips) 
BrilliantDawn84: posts small blind $0.50
Gjeneral66: posts big blind $1
Maks Bavenko: sits out 
*** HOLE CARDS ***
JoeyBaikie1: raises $1.20 to $2.20
p0pa4poker: folds 
Trojanovich: folds 
BrilliantDawn84: calls $1.70
Gjeneral66: folds 
*** FLOP *** [Kh 3c Tc]
BrilliantDawn84: checks 
JoeyBaikie1: checks 
*** TURN *** [Kh 3c Tc] [8c]
BrilliantDawn84: bets $3.57
JoeyBaikie1: calls $3.57
*** RIVER *** [Kh 3c Tc 8c] [Jh]
BrilliantDawn84: bets $4.96
JoeyBaikie1: calls $4.96
*** SHOW DOWN ***
BrilliantDawn84: shows [Kd Ts] (two pair, Kings and Tens)
JoeyBaikie1: mucks hand 
BrilliantDawn84 collected $21.34 from pot
*** SUMMARY ***
Total pot $22.46 | Rake $1.12 
Board [Kh 3c Tc 8c Jh]
Seat 3: Maks Bavenko
Seat 1: Gjeneral66 (big blind) folded before Flop
Seat 2: JoeyBaikie1 mucked
Seat 4: p0pa4poker folded before Flop (didn't bet)
Seat 5: Trojanovich (button) folded before Flop (didn't bet)
Seat 6: BrilliantDawn84 (small blind) showed [Kd Ts] and won ($21.34) with two pair, Kings and Tens



PokerStars Hand #254536716523:  Hold'em No Limit ($0.50/$1.00 USD) - 2025/01/24 22:07:25 WET [2025/01/24 17:07:25 ET]
Table 'Merapi IV' 6-max Seat #6 is the button
Seat 3: Maks Bavenko ($100 in chips) is sitting out
Seat 1: Gjeneral66 ($30.53 in chips) 
Seat 2: JoeyBaikie1 ($100 in chips) 
Seat 4: p0pa4poker ($99.50 in chips) 
Seat 5: Trojanovich ($240.27 in chips) 
Seat 6: BrilliantDawn84 ($109.61 in chips) 
Gjeneral66: posts small blind $0.50
JoeyBaikie1: posts big blind $1
Maks Bavenko: sits out 
*** HOLE CARDS ***
p0pa4poker: folds 
Trojanovich: folds 
BrilliantDawn84: folds 
Gjeneral66: folds 
Uncalled bet ($0.50) returned to JoeyBaikie1
JoeyBaikie1 collected $1 from pot
JoeyBaikie1: doesn't show hand 
*** SUMMARY ***
Total pot $1 | Rake $0 
Seat 3: Maks Bavenko
Seat 1: Gjeneral66 (small blind) folded before Flop
Seat 2: JoeyBaikie1 (big blind) collected ($1)
Seat 4: p0pa4poker folded before Flop (didn't bet)
Seat 5: Trojanovich folded before Flop (didn't bet)
Seat 6: BrilliantDawn84 (button) folded before Flop (didn't bet)



PokerStars Hand #254536720013:  Hold'em No Limit ($0.50/$1.00 USD) - 2025/01/24 22:07:36 WET [2025/01/24 17:07:36 ET]
Table 'Merapi IV' 6-max Seat #1 is the button
Seat 1: Gjeneral66 ($30.03 in chips) 
Seat 2: JoeyBaikie1 ($100.50 in chips) 
Seat 3: Maks Bavenko ($100 in chips) 
Seat 4: p0pa4poker ($99.50 in chips) 
Seat 5: Trojanovich ($240.27 in chips) 
Seat 6: BrilliantDawn84 ($109.61 in chips) 
JoeyBaikie1: posts small blind $0.50
Maks Bavenko: posts big blind $1
*** HOLE CARDS ***
p0pa4poker has timed out
p0pa4poker: folds 
Trojanovich: folds 
BrilliantDawn84: folds 
Gjeneral66: folds 
JoeyBaikie1: raises $2 to $3
Maks Bavenko: folds 
Uncalled bet ($2) returned to JoeyBaikie1
JoeyBaikie1 collected $2 from pot
JoeyBaikie1: doesn't show hand 
*** SUMMARY ***
Total pot $2 | Rake $0 
Seat 1: Gjeneral66 (button) folded before Flop (didn't bet)
Seat 2: JoeyBaikie1 (small blind) collected ($2)
Seat 3: Maks Bavenko (big blind) folded before Flop
Seat 4: p0pa4poker folded before Flop (didn't bet)
Seat 5: Trojanovich folded before Flop (didn't bet)
Seat 6: BrilliantDawn84 folded before Flop (didn't bet)



PokerStars Hand #254536726324:  Hold'em No Limit ($0.50/$1.00 USD) - 2025/01/24 22:07:56 WET [2025/01/24 17:07:56 ET]
Table 'Merapi IV' 6-max Seat #2 is the button
Seat 1: Gjeneral66 ($30.03 in chips) 
Seat 2: JoeyBaikie1 ($101.50 in chips) 
Seat 3: Maks Bavenko ($100 in chips) 
Seat 4: p0pa4poker ($99.50 in chips) 
Seat 5: Trojanovich ($240.27 in chips) 
Seat 6: BrilliantDawn84 ($109.61 in chips) 
Maks Bavenko: posts small blind $0.50
p0pa4poker: posts big blind $1
*** HOLE CARDS ***
Trojanovich: raises $1.50 to $2.50
BrilliantDawn84: folds 
Gjeneral66: folds 
JoeyBaikie1: folds 
Maks Bavenko: folds 
p0pa4poker: folds 
Uncalled bet ($1.50) returned to Trojanovich
Trojanovich collected $2.50 from pot
Trojanovich: doesn't show hand 
*** SUMMARY ***
Total pot $2.50 | Rake $0 
Seat 1: Gjeneral66 folded before Flop (didn't bet)
Seat 2: JoeyBaikie1 (button) folded before Flop (didn't bet)
Seat 3: Maks Bavenko (small blind) folded before Flop
Seat 4: p0pa4poker (big blind) folded before Flop
Seat 5: Trojanovich collected ($2.50)
Seat 6: BrilliantDawn84 folded before Flop (didn't bet)



PokerStars Hand #254536730246:  Hold'em No Limit ($0.50/$1.00 USD) - 2025/01/24 22:08:10 WET [2025/01/24 17:08:10 ET]
Table 'Merapi IV' 6-max Seat #3 is the button
Seat 1: Gjeneral66 ($30.03 in chips) 
Seat 2: JoeyBaikie1 ($101.50 in chips) 
Seat 3: Maks Bavenko ($100 in chips) 
Seat 4: p0pa4poker ($98.50 in chips) 
Seat 5: Trojanovich ($241.77 in chips) 
Seat 6: BrilliantDawn84 ($109.61 in chips) 
p0pa4poker: posts small blind $0.50
Trojanovich: posts big blind $1
*** HOLE CARDS ***
BrilliantDawn84: raises $1.50 to $2.50
Gjeneral66: folds 
JoeyBaikie1: folds 
Maks Bavenko: raises $5 to $7.50
p0pa4poker: folds 
Trojanovich: folds 
BrilliantDawn84: calls $5
*** FLOP *** [8h 2d Qh]
BrilliantDawn84: checks 
Maks Bavenko: bets $5.17
BrilliantDawn84: calls $5.17
*** TURN *** [8h 2d Qh] [9s]
BrilliantDawn84: checks 
Maks Bavenko: checks 
*** RIVER *** [8h 2d Qh 9s] [5s]
BrilliantDawn84: checks 
Maks Bavenko: bets $12.75
BrilliantDawn84: calls $12.75
*** SHOW DOWN ***
Maks Bavenko: shows [Kh Th] (high card King)
BrilliantDawn84: shows [Ad 8d] (a pair of Eights)
BrilliantDawn84 collected $49.84 from pot
*** SUMMARY ***
Total pot $52.34 | Rake $2.50 
Board [8h 2d Qh 9s 5s]
Seat 1: Gjeneral66 folded before Flop (didn't bet)
Seat 2: JoeyBaikie1 folded before Flop (didn't bet)
Seat 3: Maks Bavenko (button) showed [Kh Th] and lost with high card King
Seat 4: p0pa4poker (small blind) folded before Flop
Seat 5: Trojanovich (big blind) folded before Flop
Seat 6: BrilliantDawn84 showed [Ad 8d] and won ($49.84) with a pair of Eights



PokerStars Hand #254536745969:  Hold'em No Limit ($0.50/$1.00 USD) - 2025/01/24 22:09:02 WET [2025/01/24 17:09:02 ET]
Table 'Merapi IV' 6-max Seat #4 is the button
Seat 1: Gjeneral66 ($30.03 in chips) 
Seat 2: JoeyBaikie1 ($101.50 in chips) 
Seat 3: Maks Bavenko ($100 in chips) 
Seat 4: p0pa4poker ($100 in chips) 
Seat 5: Trojanovich ($240.77 in chips) 
Seat 6: BrilliantDawn84 ($134.03 in chips) 
Trojanovich: posts small blind $0.50
BrilliantDawn84: posts big blind $1
*** HOLE CARDS ***
Gjeneral66: folds 
JoeyBaikie1: folds 
Maks Bavenko: raises $1.50 to $2.50
p0pa4poker: folds 
Trojanovich: raises $8.50 to $11
BrilliantDawn84: folds 
Maks Bavenko: raises $13.20 to $24.20
Trojanovich: calls $13.20
*** FLOP *** [6h 9h 9s]
Trojanovich: checks 
Maks Bavenko: bets $15.49
Trojanovich: folds 
Uncalled bet ($15.49) returned to Maks Bavenko
Maks Bavenko collected $46.93 from pot
Maks Bavenko: doesn't show hand 
*** SUMMARY ***
Total pot $49.40 | Rake $2.47 
Board [6h 9h 9s]
Seat 1: Gjeneral66 folded before Flop (didn't bet)
Seat 2: JoeyBaikie1 folded before Flop (didn't bet)
Seat 3: Maks Bavenko collected ($46.93)
Seat 4: p0pa4poker (button) folded before Flop (didn't bet)
Seat 5: Trojanovich (small blind) folded on the Flop
Seat 6: BrilliantDawn84 (big blind) folded before Flop



PokerStars Hand #254536760697:  Hold'em No Limit ($0.50/$1.00 USD) - 2025/01/24 22:09:50 WET [2025/01/24 17:09:50 ET]
Table 'Merapi IV' 6-max Seat #5 is the button
Seat 1: Gjeneral66 ($30.03 in chips) 
Seat 2: JoeyBaikie1 ($101.50 in chips) 
Seat 3: Maks Bavenko ($122.73 in chips) 
Seat 4: p0pa4poker ($100 in chips) 
Seat 5: Trojanovich ($216.57 in chips) 
Seat 6: BrilliantDawn84 ($133.03 in chips) 
BrilliantDawn84: posts small blind $0.50
Gjeneral66: posts big blind $1
*** HOLE CARDS ***
JoeyBaikie1: raises $1.20 to $2.20
Maks Bavenko: raises $5.30 to $7.50
p0pa4poker: folds 
Trojanovich: folds 
BrilliantDawn84: folds 
Gjeneral66: folds 
JoeyBaikie1: calls $5.30
*** FLOP *** [Kh 4d As]
JoeyBaikie1: checks 
Maks Bavenko: bets $5.17
JoeyBaikie1: calls $5.17
*** TURN *** [Kh 4d As] [Tc]
JoeyBaikie1: checks 
Maks Bavenko: bets $12.75
JoeyBaikie1: calls $12.75
*** RIVER *** [Kh 4d As Tc] [3h]
JoeyBaikie1: checks 
Maks Bavenko: bets $24.92
JoeyBaikie1: raises $51.16 to $76.08 and is all-in
Maks Bavenko: calls $51.16
*** SHOW DOWN ***
JoeyBaikie1: shows [Kc Ad] (two pair, Aces and Kings)
Maks Bavenko: shows [Ks Ah] (two pair, Aces and Kings)
JoeyBaikie1 collected $101 from pot
Maks Bavenko collected $101 from pot
*** SUMMARY ***
Total pot $204.50 | Rake $2.50 
Board [Kh 4d As Tc 3h]
Seat 1: Gjeneral66 (big blind) folded before Flop
Seat 2: JoeyBaikie1 showed [Kc Ad] and won ($101) with two pair, Aces and Kings
Seat 3: Maks Bavenko showed [Ks Ah] and won ($101) with two pair, Aces and Kings
Seat 4: p0pa4poker folded before Flop (didn't bet)
Seat 5: Trojanovich (button) folded before Flop (didn't bet)
Seat 6: BrilliantDawn84 (small blind) folded before Flop



PokerStars Hand #254536788113:  Hold'em No Limit ($0.50/$1.00 USD) - 2025/01/24 22:11:21 WET [2025/01/24 17:11:21 ET]
Table 'Merapi IV' 6-max Seat #6 is the button
Seat 2: JoeyBaikie1 ($101 in chips) is sitting out
Seat 1: Gjeneral66 ($29.03 in chips) 
Seat 3: Maks Bavenko ($122.23 in chips) 
Seat 4: p0pa4poker ($100 in chips) 
Seat 5: Trojanovich ($216.57 in chips) 
Seat 6: BrilliantDawn84 ($132.53 in chips) 
Gjeneral66: posts small blind $0.50
JoeyBaikie1: is sitting out 
Maks Bavenko: posts big blind $1
*** HOLE CARDS ***
p0pa4poker: folds 
JoeyBaikie1 leaves the table
Trojanovich: raises $1.50 to $2.50
BrilliantDawn84: folds 
Gjeneral66: folds 
Maks Bavenko: calls $1.50
*** FLOP *** [9s 3h 6d]
Maks Bavenko: checks 
beshece11harf joins the table at seat #2 
Trojanovich: checks 
*** TURN *** [9s 3h 6d] [6s]
Maks Bavenko: checks 
Trojanovich: checks 
*** RIVER *** [9s 3h 6d 6s] [Kh]
Maks Bavenko: checks 
Trojanovich: checks 
*** SHOW DOWN ***
Maks Bavenko: shows [8s As] (a pair of Sixes)
Trojanovich: shows [Th Ad] (a pair of Sixes - Ace+King+Ten kicker)
Trojanovich collected $5.22 from pot
*** SUMMARY ***
Total pot $5.50 | Rake $0.28 
Board [9s 3h 6d 6s Kh]
Seat 2: JoeyBaikie1
Seat 1: Gjeneral66 (small blind) folded before Flop
Seat 3: Maks Bavenko (big blind) showed [8s As] and lost with a pair of Sixes
Seat 4: p0pa4poker folded before Flop (didn't bet)
Seat 5: Trojanovich showed [Th Ad] and won ($5.22) with a pair of Sixes
Seat 6: BrilliantDawn84 (button) folded before Flop (didn't bet)



PokerStars Hand #254536805393:  Hold'em No Limit ($0.50/$1.00 USD) - 2025/01/24 22:12:18 WET [2025/01/24 17:12:18 ET]
Table 'Merapi IV' 6-max Seat #1 is the button
Seat 2: beshece11harf ($100 in chips) is sitting out
Seat 1: Gjeneral66 ($28.53 in chips) 
Seat 3: Maks Bavenko ($119.73 in chips) 
Seat 4: p0pa4poker ($100 in chips) 
Seat 5: Trojanovich ($219.29 in chips) 
Seat 6: BrilliantDawn84 ($132.53 in chips) 
Maks Bavenko: posts small blind $0.50
p0pa4poker: posts big blind $1
*** HOLE CARDS ***
Trojanovich: folds 
BrilliantDawn84: folds 
Gjeneral66: raises $1.50 to $2.50
Maks Bavenko: folds 
p0pa4poker: folds 
Uncalled bet ($1.50) returned to Gjeneral66
Gjeneral66 collected $2.50 from pot
*** SUMMARY ***
Total pot $2.50 | Rake $0 
Seat 2: beshece11harf
Seat 1: Gjeneral66 (button) collected ($2.50)
Seat 3: Maks Bavenko (small blind) folded before Flop
Seat 4: p0pa4poker (big blind) folded before Flop
Seat 5: Trojanovich folded before Flop (didn't bet)
Seat 6: BrilliantDawn84 folded before Flop (didn't bet)



PokerStars Hand #254536811283:  Hold'em No Limit ($0.50/$1.00 USD) - 2025/01/24 22:12:37 WET [2025/01/24 17:12:37 ET]
Table 'Merapi IV' 6-max Seat #3 is the button
Seat 2: beshece11harf ($100 in chips) is sitting out
Seat 1: Gjeneral66 ($30.03 in chips) 
Seat 3: Maks Bavenko ($119.23 in chips) 
Seat 4: p0pa4poker ($100 in chips) 
Seat 5: Trojanovich ($219.29 in chips) 
Seat 6: BrilliantDawn84 ($132.53 in chips) 
p0pa4poker: posts small blind $0.50
Trojanovich: posts big blind $1
beshece11harf: sits out 
*** HOLE CARDS ***
BrilliantDawn84: folds 
Gjeneral66: folds 
Maks Bavenko: raises $1.50 to $2.50
p0pa4poker: folds 
Trojanovich: calls $1.50
*** FLOP *** [Js 8d 2d]
Trojanovich: checks 
Maks Bavenko: bets $3.92
Trojanovich: calls $3.92
*** TURN *** [Js 8d 2d] [Td]
Trojanovich: checks 
Maks Bavenko: checks 
*** RIVER *** [Js 8d 2d Td] [Jh]
Trojanovich: checks 
Maks Bavenko: bets $8.36
Trojanovich: folds 
Uncalled bet ($8.36) returned to Maks Bavenko
Maks Bavenko collected $12.67 from pot
Maks Bavenko: doesn't show hand 
*** SUMMARY ***
Total pot $13.34 | Rake $0.67 
Board [Js 8d 2d Td Jh]
Seat 2: beshece11harf
Seat 1: Gjeneral66 folded before Flop (didn't bet)
Seat 3: Maks Bavenko (button) collected ($12.67)
Seat 4: p0pa4poker (small blind) folded before Flop
Seat 5: Trojanovich (big blind) folded on the River
Seat 6: BrilliantDawn84 folded before Flop (didn't bet)



PokerStars Hand #254536837491:  Hold'em No Limit ($0.50/$1.00 USD) - 2025/01/24 22:14:04 WET [2025/01/24 17:14:04 ET]
Table 'Merapi IV' 6-max Seat #4 is the button
Seat 2: beshece11harf ($100 in chips) is sitting out
Seat 1: Gjeneral66 ($30.03 in chips) 
Seat 3: Maks Bavenko ($125.48 in chips) 
Seat 4: p0pa4poker ($99.50 in chips) 
Seat 5: Trojanovich ($212.87 in chips) 
Seat 6: BrilliantDawn84 ($132.53 in chips) 
Trojanovich: posts small blind $0.50
BrilliantDawn84: posts big blind $1
beshece11harf: sits out 
*** HOLE CARDS ***
Gjeneral66: folds 
Maks Bavenko: folds 
p0pa4poker: raises $1.50 to $2.50
Trojanovich: raises $8.50 to $11
BrilliantDawn84: folds 
p0pa4poker: folds 
Uncalled bet ($8.50) returned to Trojanovich
Trojanovich collected $6 from pot
Trojanovich: doesn't show hand 
*** SUMMARY ***
Total pot $6 | Rake $0 
Seat 2: beshece11harf
Seat 1: Gjeneral66 folded before Flop (didn't bet)
Seat 3: Maks Bavenko folded before Flop (didn't bet)
Seat 4: p0pa4poker (button) folded before Flop
Seat 5: Trojanovich (small blind) collected ($6)
Seat 6: BrilliantDawn84 (big blind) folded before Flop



PokerStars Hand #254536842664:  Hold'em No Limit ($0.50/$1.00 USD) - 2025/01/24 22:14:21 WET [2025/01/24 17:14:21 ET]
Table 'Merapi IV' 6-max Seat #5 is the button
Seat 2: beshece11harf ($100 in chips) is sitting out
Seat 1: Gjeneral66 ($30.03 in chips) 
Seat 3: Maks Bavenko ($125.48 in chips) 
Seat 4: p0pa4poker ($100 in chips) 
Seat 5: Trojanovich ($216.37 in chips) 
Seat 6: BrilliantDawn84 ($131.53 in chips) 
BrilliantDawn84: posts small blind $0.50
Gjeneral66: posts big blind $1
beshece11harf: sits out 
*** HOLE CARDS ***
Maks Bavenko: folds 
p0pa4poker: folds 
Trojanovich: raises $1.50 to $2.50
BrilliantDawn84: folds 
Gjeneral66: folds 
Uncalled bet ($1.50) returned to Trojanovich
Trojanovich collected $2.50 from pot
Trojanovich: doesn't show hand 
*** SUMMARY ***
Total pot $2.50 | Rake $0 
Seat 2: beshece11harf
Seat 1: Gjeneral66 (big blind) folded before Flop
Seat 3: Maks Bavenko folded before Flop (didn't bet)
Seat 4: p0pa4poker folded before Flop (didn't bet)
Seat 5: Trojanovich (button) collected ($2.50)
Seat 6: BrilliantDawn84 (small blind) folded before Flop



PokerStars Hand #254536848168:  Hold'em No Limit ($0.50/$1.00 USD) - 2025/01/24 22:14:39 WET [2025/01/24 17:14:39 ET]
Table 'Merapi IV' 6-max Seat #6 is the button
Seat 1: Gjeneral66 ($29.03 in chips) 
Seat 2: beshece11harf ($100 in chips) 
Seat 3: Maks Bavenko ($125.48 in chips) 
Seat 4: p0pa4poker ($100 in chips) 
Seat 5: Trojanovich ($217.87 in chips) 
Seat 6: BrilliantDawn84 ($131.03 in chips) 
Gjeneral66: posts small blind $0.50
beshece11harf: posts big blind $1
*** HOLE CARDS ***
Maks Bavenko: folds 
p0pa4poker: folds 
Trojanovich: folds 
BrilliantDawn84: folds 
Gjeneral66: folds 
Uncalled bet ($0.50) returned to beshece11harf
beshece11harf collected $1 from pot
beshece11harf: doesn't show hand 
*** SUMMARY ***
Total pot $1 | Rake $0 
Seat 1: Gjeneral66 (small blind) folded before Flop
Seat 2: beshece11harf (big blind) collected ($1)
Seat 3: Maks Bavenko folded before Flop (didn't bet)
Seat 4: p0pa4poker folded before Flop (didn't bet)
Seat 5: Trojanovich folded before Flop (didn't bet)
Seat 6: BrilliantDawn84 (button) folded before Flop (didn't bet)



PokerStars Hand #254536851309:  Hold'em No Limit ($0.50/$1.00 USD) - 2025/01/24 22:14:49 WET [2025/01/24 17:14:49 ET]
Table 'Merapi IV' 6-max Seat #1 is the button
Seat 1: Gjeneral66 ($28.53 in chips) 
Seat 2: beshece11harf ($100.50 in chips) 
Seat 3: Maks Bavenko ($125.48 in chips) 
Seat 4: p0pa4poker ($100 in chips) 
Seat 5: Trojanovich ($217.87 in chips) 
Seat 6: BrilliantDawn84 ($131.03 in chips) 
beshece11harf: posts small blind $0.50
Maks Bavenko: posts big blind $1
*** HOLE CARDS ***
p0pa4poker: folds 
Trojanovich: folds 
BrilliantDawn84: folds 
Gjeneral66: folds 
beshece11harf: raises $2 to $3
Maks Bavenko: folds 
Uncalled bet ($2) returned to beshece11harf
beshece11harf collected $2 from pot
beshece11harf: doesn't show hand 
*** SUMMARY ***
Total pot $2 | Rake $0 
Seat 1: Gjeneral66 (button) folded before Flop (didn't bet)
Seat 2: beshece11harf (small blind) collected ($2)
Seat 3: Maks Bavenko (big blind) folded before Flop
Seat 4: p0pa4poker folded before Flop (didn't bet)
Seat 5: Trojanovich folded before Flop (didn't bet)
Seat 6: BrilliantDawn84 folded before Flop (didn't bet)



PokerStars Hand #254536998564:  Hold'em No Limit ($0.50/$1.00 USD) - 2025/01/24 22:22:59 WET [2025/01/24 17:22:59 ET]
Table 'Merapi IV' 6-max Seat #4 is the button
Seat 2: beshece11harf ($100 in chips) 
Seat 3: yassine2525 ($12.79 in chips) 
Seat 4: p0pa4poker ($99.50 in chips) 
Seat 5: Trojanovich ($219.87 in chips) 
Seat 6: BrilliantDawn84 ($233.53 in chips) 
Trojanovich: posts small blind $0.50
BrilliantDawn84: posts big blind $1
yassine2525: posts big blind $1
*** HOLE CARDS ***
beshece11harf: folds 
yassine2525: raises $2 to $3
zangetsu800 joins the table at seat #1 
zangetsu800 is disconnected 
p0pa4poker: folds 
Trojanovich: folds 
BrilliantDawn84: folds 
Uncalled bet ($2) returned to yassine2525
yassine2525 collected $2.50 from pot
*** SUMMARY ***
Total pot $2.50 | Rake $0 
Seat 2: beshece11harf folded before Flop (didn't bet)
Seat 3: yassine2525 collected ($2.50)
Seat 4: p0pa4poker (button) folded before Flop (didn't bet)
Seat 5: Trojanovich (small blind) folded before Flop
Seat 6: BrilliantDawn84 (big blind) folded before Flop



PokerStars Hand #254537002502:  Hold'em No Limit ($0.50/$1.00 USD) - 2025/01/24 22:23:12 WET [2025/01/24 17:23:12 ET]
Table 'Merapi IV' 6-max Seat #5 is the button
Seat 1: zangetsu800 ($10 in chips) 
Seat 2: beshece11harf ($100 in chips) 
Seat 3: yassine2525 ($14.29 in chips) 
Seat 4: p0pa4poker ($99.50 in chips) 
Seat 5: Trojanovich ($219.37 in chips) 
Seat 6: BrilliantDawn84 ($232.53 in chips) 
BrilliantDawn84: posts small blind $0.50
zangetsu800: posts big blind $1
*** HOLE CARDS ***
beshece11harf: folds 
yassine2525: folds 
p0pa4poker: raises $1.50 to $2.50
Trojanovich: raises $5 to $7.50
BrilliantDawn84: calls $7
zangetsu800: calls $6.50
p0pa4poker: calls $5
*** FLOP *** [Js 5s 4c]
BrilliantDawn84: checks 
zangetsu800: checks 
p0pa4poker: checks 
Trojanovich: bets $9.41
BrilliantDawn84: folds 
zangetsu800: calls $2.50 and is all-in
p0pa4poker: folds 
Uncalled bet ($6.91) returned to Trojanovich
*** TURN *** [Js 5s 4c] [6d]
*** RIVER *** [Js 5s 4c 6d] [2s]
*** SHOW DOWN ***
zangetsu800: shows [2c 9c] (a pair of Deuces)
Trojanovich: shows [Qc Ac] (high card Ace)
zangetsu800 collected $33.25 from pot
*** SUMMARY ***
Total pot $35 | Rake $1.75 
Board [Js 5s 4c 6d 2s]
Seat 1: zangetsu800 (big blind) showed [2c 9c] and won ($33.25) with a pair of Deuces
Seat 2: beshece11harf folded before Flop (didn't bet)
Seat 3: yassine2525 folded before Flop (didn't bet)
Seat 4: p0pa4poker folded on the Flop
Seat 5: Trojanovich (button) showed [Qc Ac] and lost with high card Ace
Seat 6: BrilliantDawn84 (small blind) folded on the Flop



PokerStars Hand #254537022285:  Hold'em No Limit ($0.50/$1.00 USD) - 2025/01/24 22:24:19 WET [2025/01/24 17:24:19 ET]
Table 'Merapi IV' 6-max Seat #6 is the button
Seat 1: zangetsu800 ($33.25 in chips) 
Seat 2: beshece11harf ($100 in chips) 
Seat 3: yassine2525 ($14.29 in chips) 
Seat 4: p0pa4poker ($100 in chips) 
Seat 5: Trojanovich ($209.37 in chips) 
Seat 6: BrilliantDawn84 ($225.03 in chips) 
zangetsu800: posts small blind $0.50
beshece11harf: posts big blind $1
*** HOLE CARDS ***
yassine2525: raises $1 to $2
p0pa4poker: folds 
Trojanovich: folds 
BrilliantDawn84: calls $2
zangetsu800: calls $1.50
beshece11harf: calls $1
*** FLOP *** [6d Kh 4s]
zangetsu800: checks 
beshece11harf: checks 
yassine2525: bets $2.80
BrilliantDawn84: folds 
zangetsu800: calls $2.80
beshece11harf: calls $2.80
*** TURN *** [6d Kh 4s] [Kd]
zangetsu800: checks 
beshece11harf: checks 
yassine2525: bets $4.80
zangetsu800: calls $4.80
beshece11harf: folds 
*** RIVER *** [6d Kh 4s Kd] [Td]
zangetsu800: checks 
yassine2525: bets $4.69 and is all-in
zangetsu800: calls $4.69
*** SHOW DOWN ***
yassine2525: shows [9d Tc] (two pair, Kings and Tens)
zangetsu800: shows [9h 8s] (a pair of Kings)
yassine2525 collected $33.61 from pot
*** SUMMARY ***
Total pot $35.38 | Rake $1.77 
Board [6d Kh 4s Kd Td]
Seat 1: zangetsu800 (small blind) showed [9h 8s] and lost with a pair of Kings
Seat 2: beshece11harf (big blind) folded on the Turn
Seat 3: yassine2525 showed [9d Tc] and won ($33.61) with two pair, Kings and Tens
Seat 4: p0pa4poker folded before Flop (didn't bet)
Seat 5: Trojanovich folded before Flop (didn't bet)
Seat 6: BrilliantDawn84 (button) folded on the Flop



PokerStars Hand #254537052944:  Hold'em No Limit ($0.50/$1.00 USD) - 2025/01/24 22:26:02 WET [2025/01/24 17:26:02 ET]
Table 'Merapi IV' 6-max Seat #1 is the button
Seat 1: zangetsu800 ($18.96 in chips) 
Seat 2: beshece11harf ($100 in chips) 
Seat 3: yassine2525 ($33.61 in chips) 
Seat 4: p0pa4poker ($100 in chips) 
Seat 5: Trojanovich ($209.37 in chips) 
Seat 6: BrilliantDawn84 ($223.03 in chips) 
beshece11harf: posts small blind $0.50
yassine2525: posts big blind $1
*** HOLE CARDS ***
p0pa4poker: folds 
Trojanovich: folds 
BrilliantDawn84: folds 
zangetsu800: calls $1
beshece11harf: raises $2.50 to $3.50
yassine2525: calls $2.50
zangetsu800: calls $2.50
*** FLOP *** [Ad 7c 5s]
beshece11harf: checks 
yassine2525: checks 
zangetsu800: checks 
*** TURN *** [Ad 7c 5s] [2d]
beshece11harf: checks 
yassine2525: bets $3.99
zangetsu800: calls $3.99
beshece11harf: folds 
*** RIVER *** [Ad 7c 5s 2d] [4s]
yassine2525: bets $9.78
zangetsu800: calls $9.78
*** SHOW DOWN ***
yassine2525: shows [7s 7h] (three of a kind, Sevens)
zangetsu800: shows [3s 9s] (a straight, Ace to Five)
zangetsu800 collected $36.14 from pot
*** SUMMARY ***
Total pot $38.04 | Rake $1.90 
Board [Ad 7c 5s 2d 4s]
Seat 1: zangetsu800 (button) showed [3s 9s] and won ($36.14) with a straight, Ace to Five
Seat 2: beshece11harf (small blind) folded on the Turn
Seat 3: yassine2525 (big blind) showed [7s 7h] and lost with three of a kind, Sevens
Seat 4: p0pa4poker folded before Flop (didn't bet)
Seat 5: Trojanovich folded before Flop (didn't bet)
Seat 6: BrilliantDawn84 folded before Flop (didn't bet)



PokerStars Hand #254537079711:  Hold'em No Limit ($0.50/$1.00 USD) - 2025/01/24 22:27:33 WET [2025/01/24 17:27:33 ET]
Table 'Merapi IV' 6-max Seat #2 is the button
Seat 1: zangetsu800 ($37.83 in chips) 
Seat 2: beshece11harf ($100 in chips) 
Seat 3: yassine2525 ($16.34 in chips) 
Seat 4: p0pa4poker ($100 in chips) 
Seat 5: Trojanovich ($209.37 in chips) 
Seat 6: BrilliantDawn84 ($223.03 in chips) 
yassine2525: posts small blind $0.50
p0pa4poker: posts big blind $1
*** HOLE CARDS ***
Trojanovich: raises $1.50 to $2.50
BrilliantDawn84: folds 
zangetsu800: calls $2.50
beshece11harf: folds 
yassine2525: raises $13.84 to $16.34 and is all-in
p0pa4poker: folds 
Trojanovich: folds 
zangetsu800: folds 
Uncalled bet ($13.84) returned to yassine2525
yassine2525 collected $8.50 from pot
*** SUMMARY ***
Total pot $8.50 | Rake $0 
Seat 1: zangetsu800 folded before Flop
Seat 2: beshece11harf (button) folded before Flop (didn't bet)
Seat 3: yassine2525 (small blind) collected ($8.50)
Seat 4: p0pa4poker (big blind) folded before Flop
Seat 5: Trojanovich folded before Flop
Seat 6: BrilliantDawn84 folded before Flop (didn't bet)



PokerStars Hand #254537085765:  Hold'em No Limit ($0.50/$1.00 USD) - 2025/01/24 22:27:54 WET [2025/01/24 17:27:54 ET]
Table 'Merapi IV' 6-max Seat #3 is the button
Seat 1: zangetsu800 ($35.33 in chips) 
Seat 2: beshece11harf ($100 in chips) 
Seat 3: yassine2525 ($22.34 in chips) 
Seat 4: p0pa4poker ($99 in chips) 
Seat 5: Trojanovich ($206.87 in chips) 
Seat 6: BrilliantDawn84 ($223.03 in chips) 
p0pa4poker: posts small blind $0.50
Trojanovich: posts big blind $1
*** HOLE CARDS ***
BrilliantDawn84: folds 
zangetsu800: calls $1
beshece11harf: raises $2.50 to $3.50
yassine2525: calls $3.50
p0pa4poker: folds 
Trojanovich: folds 
zangetsu800: calls $2.50
*** FLOP *** [2s Kd 7s]
zangetsu800: checks 
beshece11harf: bets $2.85
yassine2525: folds 
zangetsu800: calls $2.85
*** TURN *** [2s Kd 7s] [4d]
zangetsu800: checks 
beshece11harf: checks 
*** RIVER *** [2s Kd 7s 4d] [5d]
zangetsu800: checks 
beshece11harf: checks 
*** SHOW DOWN ***
zangetsu800: shows [8c 4h] (a pair of Fours)
beshece11harf: shows [5h Qh] (a pair of Fives)
beshece11harf collected $16.82 from pot
*** SUMMARY ***
Total pot $17.70 | Rake $0.88 
Board [2s Kd 7s 4d 5d]
Seat 1: zangetsu800 showed [8c 4h] and lost with a pair of Fours
Seat 2: beshece11harf showed [5h Qh] and won ($16.82) with a pair of Fives
Seat 3: yassine2525 (button) folded on the Flop
Seat 4: p0pa4poker (small blind) folded before Flop
Seat 5: Trojanovich (big blind) folded before Flop
Seat 6: BrilliantDawn84 folded before Flop (didn't bet)



PokerStars Hand #254537108413:  Hold'em No Limit ($0.50/$1.00 USD) - 2025/01/24 22:29:11 WET [2025/01/24 17:29:11 ET]
Table 'Merapi IV' 6-max Seat #4 is the button
Seat 1: zangetsu800 ($28.98 in chips) 
Seat 2: beshece11harf ($110.47 in chips) 
Seat 3: yassine2525 ($18.84 in chips) 
Seat 4: p0pa4poker ($98.50 in chips) 
Seat 5: Trojanovich ($205.87 in chips) 
Seat 6: BrilliantDawn84 ($223.03 in chips) 
Trojanovich: posts small blind $0.50
BrilliantDawn84: posts big blind $1
*** HOLE CARDS ***
zangetsu800: calls $1
beshece11harf: folds 
yassine2525: raises $4.50 to $5.50
p0pa4poker: folds 
Trojanovich: folds 
BrilliantDawn84: folds 
zangetsu800: calls $4.50
*** FLOP *** [Jc 2c 6c]
zangetsu800: checks 
yassine2525: bets $5.94
zangetsu800: calls $5.94
*** TURN *** [Jc 2c 6c] [Ah]
zangetsu800: checks 
yassine2525: bets $7.40 and is all-in
zangetsu800: calls $7.40
*** RIVER *** [Jc 2c 6c Ah] [Th]
*** SHOW DOWN ***
zangetsu800: shows [7c Qs] (high card Ace)
yassine2525: shows [2d 2s] (three of a kind, Deuces)
yassine2525 cashed out the hand for $29.84 | Cash Out Fee $0.61
*** SUMMARY ***
Total pot $39.18 | Rake $1.96 
Board [Jc 2c 6c Ah Th]
Seat 1: zangetsu800 showed [7c Qs] and lost with high card Ace
Seat 2: beshece11harf folded before Flop (didn't bet)
Seat 3: yassine2525 showed [2d 2s] and won ($37.22) with three of a kind, Deuces (pot not awarded as player cashed out)
Seat 4: p0pa4poker (button) folded before Flop (didn't bet)
Seat 5: Trojanovich (small blind) folded before Flop
Seat 6: BrilliantDawn84 (big blind) folded before Flop



PokerStars Hand #254537125137:  Hold'em No Limit ($0.50/$1.00 USD) - 2025/01/24 22:30:07 WET [2025/01/24 17:30:07 ET]
Table 'Merapi IV' 6-max Seat #5 is the button
Seat 1: zangetsu800 ($10.14 in chips) 
Seat 2: beshece11harf ($110.47 in chips) 
Seat 3: yassine2525 ($29.84 in chips) 
Seat 4: p0pa4poker ($98.50 in chips) 
Seat 5: Trojanovich ($205.37 in chips) 
Seat 6: BrilliantDawn84 ($222.03 in chips) 
BrilliantDawn84: posts small blind $0.50
zangetsu800: posts big blind $1
*** HOLE CARDS ***
beshece11harf: raises $1 to $2
yassine2525: calls $2
p0pa4poker: folds 
Trojanovich: calls $2
BrilliantDawn84: calls $1.50
zangetsu800: calls $1
*** FLOP *** [9s 2s 9d]
BrilliantDawn84: checks 
zangetsu800: checks 
beshece11harf: checks 
yassine2525: checks 
Trojanovich: checks 
*** TURN *** [9s 2s 9d] [8h]
BrilliantDawn84: bets $4.75
zangetsu800: calls $4.75
beshece11harf: folds 
yassine2525: calls $4.75
Trojanovich: folds 
*** RIVER *** [9s 2s 9d 8h] [6s]
BrilliantDawn84: checks 
zangetsu800: checks 
yassine2525: bets $9
BrilliantDawn84: raises $41.04 to $50.04
zangetsu800: calls $3.39 and is all-in
yassine2525: folds 
Uncalled bet ($41.04) returned to BrilliantDawn84
*** SHOW DOWN ***
BrilliantDawn84: shows [9c 8s] (a full house, Nines full of Eights)
BrilliantDawn84 collected $10.66 from side pot
zangetsu800: shows [8d 5s] (two pair, Nines and Eights)
BrilliantDawn84 collected $32.70 from main pot
*** SUMMARY ***
Total pot $45.64 Main pot $32.70. Side pot $10.66. | Rake $2.28 
Board [9s 2s 9d 8h 6s]
Seat 1: zangetsu800 (big blind) showed [8d 5s] and lost with two pair, Nines and Eights
Seat 2: beshece11harf folded on the Turn
Seat 3: yassine2525 folded on the River
Seat 4: p0pa4poker folded before Flop (didn't bet)
Seat 5: Trojanovich (button) folded on the Turn
Seat 6: BrilliantDawn84 (small blind) showed [9c 8s] and won ($43.36) with a full house, Nines full of Eights



PokerStars Hand #254537154074:  Hold'em No Limit ($0.50/$1.00 USD) - 2025/01/24 22:31:45 WET [2025/01/24 17:31:45 ET]
Table 'Merapi IV' 6-max Seat #6 is the button
Seat 1: zangetsu800 ($0 in chips) is sitting out
Seat 2: beshece11harf ($108.47 in chips) 
Seat 3: yassine2525 ($14.09 in chips) 
Seat 4: p0pa4poker ($100 in chips) 
Seat 5: Trojanovich ($203.37 in chips) 
Seat 6: BrilliantDawn84 ($249.64 in chips) 
beshece11harf: posts small blind $0.50
yassine2525: posts big blind $1
*** HOLE CARDS ***
p0pa4poker: folds 
Trojanovich: folds 
BrilliantDawn84: folds 
beshece11harf: folds 
Uncalled bet ($0.50) returned to yassine2525
yassine2525 collected $1 from pot
*** SUMMARY ***
Total pot $1 | Rake $0 
Seat 1: zangetsu800
Seat 2: beshece11harf (small blind) folded before Flop
Seat 3: yassine2525 (big blind) collected ($1)
Seat 4: p0pa4poker folded before Flop (didn't bet)
Seat 5: Trojanovich folded before Flop (didn't bet)
Seat 6: BrilliantDawn84 (button) folded before Flop (didn't bet)



PokerStars Hand #254537158477:  Hold'em No Limit ($0.50/$1.00 USD) - 2025/01/24 22:32:01 WET [2025/01/24 17:32:01 ET]
Table 'Merapi IV' 6-max Seat #2 is the button
Seat 1: zangetsu800 ($11 in chips) 
Seat 2: beshece11harf ($107.97 in chips) 
Seat 3: yassine2525 ($14.59 in chips) 
Seat 4: p0pa4poker ($100 in chips) 
Seat 5: Trojanovich ($203.37 in chips) 
Seat 6: BrilliantDawn84 ($249.64 in chips) 
yassine2525: posts small blind $0.50
p0pa4poker: posts big blind $1
zangetsu800: posts small blind $0.50
*** HOLE CARDS ***
Trojanovich: raises $1.50 to $2.50
BrilliantDawn84: folds 
zangetsu800: calls $2.50
beshece11harf: folds 
yassine2525: raises $12.09 to $14.59 and is all-in
p0pa4poker: folds 
Trojanovich: raises $12.09 to $26.68
zangetsu800: calls $8 and is all-in
Uncalled bet ($12.09) returned to Trojanovich
*** FLOP *** [9c 2d Jh]
*** TURN *** [9c 2d Jh] [7d]
*** RIVER *** [9c 2d Jh 7d] [Td]
*** SHOW DOWN ***
yassine2525: shows [Kd Qs] (a straight, Nine to King)
Trojanovich: shows [Ah Ks] (high card Ace)
yassine2525 collected $7.77 from side pot
zangetsu800: shows [Qc 5d] (high card Queen)
yassine2525 collected $31.35 from main pot
*** SUMMARY ***
Total pot $41.18 Main pot $31.35. Side pot $7.77. | Rake $2.06 
Board [9c 2d Jh 7d Td]
Seat 1: zangetsu800 showed [Qc 5d] and lost with high card Queen
Seat 2: beshece11harf (button) folded before Flop (didn't bet)
Seat 3: yassine2525 (small blind) showed [Kd Qs] and won ($39.12) with a straight, Nine to King
Seat 4: p0pa4poker (big blind) folded before Flop
Seat 5: Trojanovich showed [Ah Ks] and lost with high card Ace
Seat 6: BrilliantDawn84 folded before Flop (didn't bet)



PokerStars Hand #254537170865:  Hold'em No Limit ($0.50/$1.00 USD) - 2025/01/24 22:32:43 WET [2025/01/24 17:32:43 ET]
Table 'Merapi IV' 6-max Seat #3 is the button
Seat 1: zangetsu800 ($0 in chips) is sitting out
Seat 2: beshece11harf ($107.97 in chips) 
Seat 3: yassine2525 ($39.12 in chips) 
Seat 4: p0pa4poker ($100 in chips) 
Seat 5: Trojanovich ($188.78 in chips) 
Seat 6: BrilliantDawn84 ($249.64 in chips) 
p0pa4poker: posts small blind $0.50
Trojanovich: posts big blind $1
*** HOLE CARDS ***
BrilliantDawn84: raises $1.50 to $2.50
zangetsu800 is disconnected 
beshece11harf: raises $5 to $7.50
yassine2525: calls $7.50
p0pa4poker: folds 
Trojanovich: folds 
BrilliantDawn84: calls $5
*** FLOP *** [8c 8d 8s]
BrilliantDawn84: checks 
beshece11harf: bets $5.70
yassine2525: calls $5.70
BrilliantDawn84: calls $5.70
*** TURN *** [8c 8d 8s] [5s]
BrilliantDawn84: checks 
beshece11harf: checks 
yassine2525: checks 
*** RIVER *** [8c 8d 8s 5s] [7s]
BrilliantDawn84: bets $39.04
beshece11harf: folds 
yassine2525: folds 
Uncalled bet ($39.04) returned to BrilliantDawn84
BrilliantDawn84 collected $39.04 from pot
BrilliantDawn84: doesn't show hand 
*** SUMMARY ***
Total pot $41.10 | Rake $2.06 
Board [8c 8d 8s 5s 7s]
Seat 1: zangetsu800
Seat 2: beshece11harf folded on the River
Seat 3: yassine2525 (button) folded on the River
Seat 4: p0pa4poker (small blind) folded before Flop
Seat 5: Trojanovich (big blind) folded before Flop
Seat 6: BrilliantDawn84 collected ($39.04)



PokerStars Hand #254537198444:  Hold'em No Limit ($0.50/$1.00 USD) - 2025/01/24 22:34:18 WET [2025/01/24 17:34:18 ET]
Table 'Merapi IV' 6-max Seat #4 is the button
Seat 1: zangetsu800 ($0 in chips) is sitting out
Seat 2: beshece11harf ($100 in chips) 
Seat 3: yassine2525 ($25.92 in chips) 
Seat 4: p0pa4poker ($100 in chips) 
Seat 5: Trojanovich ($187.78 in chips) 
Seat 6: BrilliantDawn84 ($275.48 in chips) 
Trojanovich: posts small blind $0.50
BrilliantDawn84: posts big blind $1
*** HOLE CARDS ***
beshece11harf: folds 
yassine2525: raises $2 to $3
p0pa4poker: raises $6 to $9
Trojanovich: folds 
BrilliantDawn84: folds 
yassine2525: raises $16.92 to $25.92 and is all-in
p0pa4poker: calls $16.92
*** FLOP *** [9h 5c 4s]
*** TURN *** [9h 5c 4s] [Kd]
*** RIVER *** [9h 5c 4s Kd] [6h]
*** SHOW DOWN ***
yassine2525: shows [Ad 7d] (high card Ace)
p0pa4poker: shows [Th Ac] (high card Ace - King+Ten kicker)
p0pa4poker collected $50.84 from pot
*** SUMMARY ***
Total pot $53.34 | Rake $2.50 
Board [9h 5c 4s Kd 6h]
Seat 1: zangetsu800
Seat 2: beshece11harf folded before Flop (didn't bet)
Seat 3: yassine2525 showed [Ad 7d] and lost with high card Ace
Seat 4: p0pa4poker (button) showed [Th Ac] and won ($50.84) with high card Ace
Seat 5: Trojanovich (small blind) folded before Flop
Seat 6: BrilliantDawn84 (big blind) folded before Flop



PokerStars Hand #254537212104:  Hold'em No Limit ($0.50/$1.00 USD) - 2025/01/24 22:35:04 WET [2025/01/24 17:35:04 ET]
Table 'Merapi IV' 6-max Seat #5 is the button
Seat 3: yassine2525 ($0 in chips) is sitting out
Seat 1: zangetsu800 ($21 in chips) 
Seat 2: beshece11harf ($100 in chips) 
Seat 4: p0pa4poker ($124.92 in chips) 
Seat 5: Trojanovich ($187.28 in chips) 
Seat 6: BrilliantDawn84 ($274.48 in chips) 
BrilliantDawn84: posts small blind $0.50
zangetsu800: posts big blind $1
*** HOLE CARDS ***
beshece11harf: raises $1 to $2
p0pa4poker: folds 
Trojanovich: folds 
BrilliantDawn84: folds 
zangetsu800: calls $1
*** FLOP *** [9s Qs 5d]
zangetsu800: checks 
beshece11harf: bets $1.07
zangetsu800: calls $1.07
*** TURN *** [9s Qs 5d] [Ah]
zangetsu800: checks 
beshece11harf: bets $4.50
zangetsu800: calls $4.50
*** RIVER *** [9s Qs 5d Ah] [2d]
zangetsu800: checks 
beshece11harf: bets $14
zangetsu800: folds 
Uncalled bet ($14) returned to beshece11harf
beshece11harf collected $14.86 from pot
beshece11harf: doesn't show hand 
*** SUMMARY ***
Total pot $15.64 | Rake $0.78 
Board [9s Qs 5d Ah 2d]
Seat 3: yassine2525
Seat 1: zangetsu800 (big blind) folded on the River
Seat 2: beshece11harf collected ($14.86)
Seat 4: p0pa4poker folded before Flop (didn't bet)
Seat 5: Trojanovich (button) folded before Flop (didn't bet)
Seat 6: BrilliantDawn84 (small blind) folded before Flop



PokerStars Hand #254537229753:  Hold'em No Limit ($0.50/$1.00 USD) - 2025/01/24 22:36:05 WET [2025/01/24 17:36:05 ET]
Table 'Merapi IV' 6-max Seat #6 is the button
Seat 1: zangetsu800 ($13.43 in chips) 
Seat 2: beshece11harf ($107.29 in chips) 
Seat 3: yassine2525 ($16.15 in chips) 
Seat 4: p0pa4poker ($124.92 in chips) 
Seat 5: Trojanovich ($187.28 in chips) 
Seat 6: BrilliantDawn84 ($273.98 in chips) 
zangetsu800: posts small blind $0.50
beshece11harf: posts big blind $1
*** HOLE CARDS ***
yassine2525: folds 
p0pa4poker: folds 
Trojanovich: raises $1.50 to $2.50
BrilliantDawn84: folds 
zangetsu800: calls $2
beshece11harf: folds 
*** FLOP *** [2c 3d 9h]
zangetsu800: checks 
Trojanovich: bets $1.88
zangetsu800: calls $1.88
*** TURN *** [2c 3d 9h] [7d]
zangetsu800: checks 
Trojanovich: checks 
*** RIVER *** [2c 3d 9h 7d] [Kc]
zangetsu800: checks 
Trojanovich: checks 
*** SHOW DOWN ***
zangetsu800: shows [5h 9s] (a pair of Nines)
Trojanovich: mucks hand 
zangetsu800 collected $9.27 from pot
*** SUMMARY ***
Total pot $9.76 | Rake $0.49 
Board [2c 3d 9h 7d Kc]
Seat 1: zangetsu800 (small blind) showed [5h 9s] and won ($9.27) with a pair of Nines
Seat 2: beshece11harf (big blind) folded before Flop
Seat 3: yassine2525 folded before Flop (didn't bet)
Seat 4: p0pa4poker folded before Flop (didn't bet)
Seat 5: Trojanovich mucked
Seat 6: BrilliantDawn84 (button) folded before Flop (didn't bet)



PokerStars Hand #254537241694:  Hold'em No Limit ($0.50/$1.00 USD) - 2025/01/24 22:36:46 WET [2025/01/24 17:36:46 ET]
Table 'Merapi IV' 6-max Seat #1 is the button
Seat 1: zangetsu800 ($18.32 in chips) 
Seat 2: beshece11harf ($106.29 in chips) 
Seat 3: yassine2525 ($16.15 in chips) 
Seat 4: p0pa4poker ($124.92 in chips) 
Seat 5: Trojanovich ($182.90 in chips) 
Seat 6: BrilliantDawn84 ($273.98 in chips) 
beshece11harf: posts small blind $0.50
yassine2525: posts big blind $1
*** HOLE CARDS ***
p0pa4poker: folds 
Trojanovich: folds 
BrilliantDawn84: folds 
zangetsu800: calls $1
beshece11harf: folds 
yassine2525: raises $3.50 to $4.50
zangetsu800: calls $3.50
*** FLOP *** [9d 9h 8h]
yassine2525: bets $5.51
zangetsu800: folds 
Uncalled bet ($5.51) returned to yassine2525
yassine2525 collected $9.02 from pot
*** SUMMARY ***
Total pot $9.50 | Rake $0.48 
Board [9d 9h 8h]
Seat 1: zangetsu800 (button) folded on the Flop
Seat 2: beshece11harf (small blind) folded before Flop
Seat 3: yassine2525 (big blind) collected ($9.02)
Seat 4: p0pa4poker folded before Flop (didn't bet)
Seat 5: Trojanovich folded before Flop (didn't bet)
Seat 6: BrilliantDawn84 folded before Flop (didn't bet)



PokerStars Hand #254537252601:  Hold'em No Limit ($0.50/$1.00 USD) - 2025/01/24 22:37:24 WET [2025/01/24 17:37:24 ET]
Table 'Merapi IV' 6-max Seat #2 is the button
Seat 1: zangetsu800 ($13.82 in chips) 
Seat 2: beshece11harf ($105.79 in chips) 
Seat 3: yassine2525 ($20.67 in chips) 
Seat 4: p0pa4poker ($124.92 in chips) 
Seat 5: Trojanovich ($182.90 in chips) 
Seat 6: BrilliantDawn84 ($273.98 in chips) 
yassine2525: posts small blind $0.50
p0pa4poker: posts big blind $1
*** HOLE CARDS ***
Trojanovich: folds 
BrilliantDawn84: folds 
zangetsu800: calls $1
beshece11harf: raises $2.50 to $3.50
yassine2525: folds 
p0pa4poker: raises $8.50 to $12
zangetsu800: folds 
beshece11harf: folds 
Uncalled bet ($8.50) returned to p0pa4poker
p0pa4poker collected $8.50 from pot
p0pa4poker: doesn't show hand 
*** SUMMARY ***
Total pot $8.50 | Rake $0 
Seat 1: zangetsu800 folded before Flop
Seat 2: beshece11harf (button) folded before Flop
Seat 3: yassine2525 (small blind) folded before Flop
Seat 4: p0pa4poker (big blind) collected ($8.50)
Seat 5: Trojanovich folded before Flop (didn't bet)
Seat 6: BrilliantDawn84 folded before Flop (didn't bet)



PokerStars Hand #254537261506:  Hold'em No Limit ($0.50/$1.00 USD) - 2025/01/24 22:37:54 WET [2025/01/24 17:37:54 ET]
Table 'Merapi IV' 6-max Seat #3 is the button
Seat 1: zangetsu800 ($12.82 in chips) 
Seat 2: beshece11harf ($102.29 in chips) 
Seat 3: yassine2525 ($20.17 in chips) 
Seat 4: p0pa4poker ($129.92 in chips) 
Seat 5: Trojanovich ($182.90 in chips) 
Seat 6: BrilliantDawn84 ($273.98 in chips) 
p0pa4poker: posts small blind $0.50
Trojanovich: posts big blind $1
*** HOLE CARDS ***
BrilliantDawn84: raises $1.50 to $2.50
zangetsu800: calls $2.50
beshece11harf: folds 
yassine2525: raises $5.50 to $8
p0pa4poker: folds 
Trojanovich: folds 
BrilliantDawn84: folds 
zangetsu800: calls $5.50
*** FLOP *** [2d Ts 2s]
zangetsu800: checks 
yassine2525: bets $9.50
zangetsu800: calls $4.82 and is all-in
Uncalled bet ($4.68) returned to yassine2525
*** TURN *** [2d Ts 2s] [Kd]
*** RIVER *** [2d Ts 2s Kd] [Qd]
*** SHOW DOWN ***
zangetsu800: shows [6s Jh] (a pair of Deuces)
yassine2525: shows [8s 8h] (two pair, Eights and Deuces)
yassine2525 cashed out the hand for $24.19 | Cash Out Fee $0.49
*** SUMMARY ***
Total pot $29.64 | Rake $1.48 
Board [2d Ts 2s Kd Qd]
Seat 1: zangetsu800 showed [6s Jh] and lost with a pair of Deuces
Seat 2: beshece11harf folded before Flop (didn't bet)
Seat 3: yassine2525 (button) showed [8s 8h] and won ($28.16) with two pair, Eights and Deuces (pot not awarded as player cashed out)
Seat 4: p0pa4poker (small blind) folded before Flop
Seat 5: Trojanovich (big blind) folded before Flop
Seat 6: BrilliantDawn84 folded before Flop



PokerStars Hand #254537275152:  Hold'em No Limit ($0.50/$1.00 USD) - 2025/01/24 22:38:41 WET [2025/01/24 17:38:41 ET]
Table 'Merapi IV' 6-max Seat #4 is the button
Seat 1: zangetsu800 ($0 in chips) is sitting out
Seat 2: beshece11harf ($102.29 in chips) 
Seat 3: yassine2525 ($31.54 in chips) 
Seat 4: p0pa4poker ($129.42 in chips) 
Seat 5: Trojanovich ($181.90 in chips) 
Seat 6: BrilliantDawn84 ($271.48 in chips) 
Trojanovich: posts small blind $0.50
BrilliantDawn84: posts big blind $1
*** HOLE CARDS ***
beshece11harf: folds 
yassine2525: folds 
zangetsu800 is disconnected 
p0pa4poker: raises $1.50 to $2.50
Trojanovich: raises $8.50 to $11
BrilliantDawn84: folds 
p0pa4poker: calls $8.50
*** FLOP *** [Ts Ad 3h]
Trojanovich: checks 
p0pa4poker: bets $13.55
Trojanovich: calls $13.55
*** TURN *** [Ts Ad 3h] [5d]
Trojanovich: checks 
p0pa4poker: bets $29.51
Trojanovich: calls $29.51
*** RIVER *** [Ts Ad 3h 5d] [4c]
Trojanovich: checks 
p0pa4poker: bets $75.36 and is all-in
Trojanovich: calls $75.36
*** SHOW DOWN ***
p0pa4poker: shows [3s 3c] (three of a kind, Threes)
Trojanovich: shows [Ac As] (three of a kind, Aces)
Trojanovich collected $257.34 from pot
*** SUMMARY ***
Total pot $259.84 | Rake $2.50 
Board [Ts Ad 3h 5d 4c]
Seat 1: zangetsu800
Seat 2: beshece11harf folded before Flop (didn't bet)
Seat 3: yassine2525 folded before Flop (didn't bet)
Seat 4: p0pa4poker (button) showed [3s 3c] and lost with three of a kind, Threes
Seat 5: Trojanovich (small blind) showed [Ac As] and won ($257.34) with three of a kind, Aces
Seat 6: BrilliantDawn84 (big blind) folded before Flop



PokerStars Hand #254537313336:  Hold'em No Limit ($0.50/$1.00 USD) - 2025/01/24 22:40:53 WET [2025/01/24 17:40:53 ET]
Table 'Merapi IV' 6-max Seat #5 is the button
Seat 1: zangetsu800 ($0 in chips) is sitting out
Seat 2: beshece11harf ($102.29 in chips) 
Seat 3: yassine2525 ($31.54 in chips) 
Seat 4: p0pa4poker ($24.64 in chips) 
Seat 5: Trojanovich ($309.82 in chips) 
Seat 6: BrilliantDawn84 ($270.48 in chips) 
BrilliantDawn84: posts small blind $0.50
beshece11harf: posts big blind $1
*** HOLE CARDS ***
yassine2525: raises $1 to $2
p0pa4poker: folds 
Trojanovich: folds 
BrilliantDawn84: raises $6 to $8
beshece11harf: folds 
yassine2525: calls $6
*** FLOP *** [2c Kh 4s]
BrilliantDawn84: bets $8.08
yassine2525: folds 
Uncalled bet ($8.08) returned to BrilliantDawn84
BrilliantDawn84 collected $16.15 from pot
BrilliantDawn84: doesn't show hand 
*** SUMMARY ***
Total pot $17 | Rake $0.85 
Board [2c Kh 4s]
Seat 1: zangetsu800
Seat 2: beshece11harf (big blind) folded before Flop
Seat 3: yassine2525 folded on the Flop
Seat 4: p0pa4poker folded before Flop (didn't bet)
Seat 5: Trojanovich (button) folded before Flop (didn't bet)
Seat 6: BrilliantDawn84 (small blind) collected ($16.15)



PokerStars Hand #254537324095:  Hold'em No Limit ($0.50/$1.00 USD) - 2025/01/24 22:41:30 WET [2025/01/24 17:41:30 ET]
Table 'Merapi IV' 6-max Seat #6 is the button
Seat 1: zangetsu800 ($0 in chips) is sitting out
Seat 2: beshece11harf ($101.29 in chips) 
Seat 3: yassine2525 ($23.54 in chips) 
Seat 4: p0pa4poker ($100 in chips) 
Seat 5: Trojanovich ($309.82 in chips) 
Seat 6: BrilliantDawn84 ($278.63 in chips) 
beshece11harf: posts small blind $0.50
yassine2525: posts big blind $1
*** HOLE CARDS ***
p0pa4poker: folds 
Trojanovich: raises $1.50 to $2.50
BrilliantDawn84: folds 
beshece11harf: folds 
yassine2525: calls $1.50
*** FLOP *** [3s 3d 2h]
yassine2525: checks 
Trojanovich: bets $1.30
yassine2525: calls $1.30
*** TURN *** [3s 3d 2h] [Qh]
yassine2525: checks 
Trojanovich: bets $4.11
yassine2525: folds 
Uncalled bet ($4.11) returned to Trojanovich
Trojanovich collected $7.70 from pot
Trojanovich: doesn't show hand 
*** SUMMARY ***
Total pot $8.10 | Rake $0.40 
Board [3s 3d 2h Qh]
Seat 1: zangetsu800
Seat 2: beshece11harf (small blind) folded before Flop
Seat 3: yassine2525 (big blind) folded on the Turn
Seat 4: p0pa4poker folded before Flop (didn't bet)
Seat 5: Trojanovich collected ($7.70)
Seat 6: BrilliantDawn84 (button) folded before Flop (didn't bet)



PokerStars Hand #254537334864:  Hold'em No Limit ($0.50/$1.00 USD) - 2025/01/24 22:42:08 WET [2025/01/24 17:42:08 ET]
Table 'Merapi IV' 6-max Seat #2 is the button
Seat 1: zangetsu800 ($0 in chips) is sitting out
Seat 2: beshece11harf ($100.79 in chips) 
Seat 3: yassine2525 ($19.74 in chips) 
Seat 4: p0pa4poker ($100 in chips) 
Seat 5: Trojanovich ($313.72 in chips) 
Seat 6: BrilliantDawn84 ($278.63 in chips) 
yassine2525: posts small blind $0.50
p0pa4poker: posts big blind $1
*** HOLE CARDS ***
Trojanovich: folds 
BrilliantDawn84: folds 
beshece11harf: folds 
yassine2525: folds 
Uncalled bet ($0.50) returned to p0pa4poker
p0pa4poker collected $1 from pot
p0pa4poker: doesn't show hand 
*** SUMMARY ***
Total pot $1 | Rake $0 
Seat 1: zangetsu800
Seat 2: beshece11harf (button) folded before Flop (didn't bet)
Seat 3: yassine2525 (small blind) folded before Flop
Seat 4: p0pa4poker (big blind) collected ($1)
Seat 5: Trojanovich folded before Flop (didn't bet)
Seat 6: BrilliantDawn84 folded before Flop (didn't bet)



PokerStars Hand #254537338524:  Hold'em No Limit ($0.50/$1.00 USD) - 2025/01/24 22:42:20 WET [2025/01/24 17:42:20 ET]
Table 'Merapi IV' 6-max Seat #3 is the button
Seat 1: zangetsu800 ($0 in chips) is sitting out
Seat 2: beshece11harf ($100.79 in chips) 
Seat 3: yassine2525 ($19.24 in chips) 
Seat 4: p0pa4poker ($100.50 in chips) 
Seat 5: Trojanovich ($313.72 in chips) 
Seat 6: BrilliantDawn84 ($278.63 in chips) 
p0pa4poker: posts small blind $0.50
Trojanovich: posts big blind $1
*** HOLE CARDS ***
BrilliantDawn84: folds 
beshece11harf: raises $1 to $2
yassine2525: raises $5.50 to $7.50
p0pa4poker: folds 
Trojanovich: folds 
beshece11harf: folds 
Uncalled bet ($5.50) returned to yassine2525
yassine2525 collected $5.50 from pot
*** SUMMARY ***
Total pot $5.50 | Rake $0 
Seat 1: zangetsu800
Seat 2: beshece11harf folded before Flop
Seat 3: yassine2525 (button) collected ($5.50)
Seat 4: p0pa4poker (small blind) folded before Flop
Seat 5: Trojanovich (big blind) folded before Flop
Seat 6: BrilliantDawn84 folded before Flop (didn't bet)



PokerStars Hand #254537347355:  Hold'em No Limit ($0.50/$1.00 USD) - 2025/01/24 22:42:51 WET [2025/01/24 17:42:51 ET]
Table 'Merapi IV' 6-max Seat #4 is the button
Seat 1: zangetsu800 ($0 in chips) is sitting out
Seat 2: beshece11harf ($100 in chips) 
Seat 3: yassine2525 ($22.74 in chips) 
Seat 4: p0pa4poker ($100 in chips) 
Seat 5: Trojanovich ($312.72 in chips) 
Seat 6: BrilliantDawn84 ($278.63 in chips) 
Trojanovich: posts small blind $0.50
BrilliantDawn84: posts big blind $1
*** HOLE CARDS ***
beshece11harf: raises $1 to $2
yassine2525: calls $2
p0pa4poker: calls $2
Trojanovich: folds 
BrilliantDawn84: folds 
*** FLOP *** [4c Th Kd]
beshece11harf: checks 
yassine2525: checks 
p0pa4poker: checks 
*** TURN *** [4c Th Kd] [9d]
beshece11harf: checks 
yassine2525: bets $3.56
p0pa4poker: folds 
beshece11harf: calls $3.56
*** RIVER *** [4c Th Kd 9d] [7s]
beshece11harf: checks 
yassine2525: bets $7.95
beshece11harf: folds 
Uncalled bet ($7.95) returned to yassine2525
yassine2525 collected $13.89 from pot
*** SUMMARY ***
Total pot $14.62 | Rake $0.73 
Board [4c Th Kd 9d 7s]
Seat 1: zangetsu800
Seat 2: beshece11harf folded on the River
Seat 3: yassine2525 collected ($13.89)
Seat 4: p0pa4poker (button) folded on the Turn
Seat 5: Trojanovich (small blind) folded before Flop
Seat 6: BrilliantDawn84 (big blind) folded before Flop



PokerStars Hand #254537379189:  Hold'em No Limit ($0.50/$1.00 USD) - 2025/01/24 22:44:40 WET [2025/01/24 17:44:40 ET]
Table 'Merapi IV' 6-max Seat #5 is the button
Seat 1: zangetsu800 ($0 in chips) is sitting out
Seat 2: beshece11harf ($100 in chips) 
Seat 3: yassine2525 ($31.07 in chips) 
Seat 4: p0pa4poker ($98 in chips) 
Seat 5: Trojanovich ($312.22 in chips) 
Seat 6: BrilliantDawn84 ($277.63 in chips) 
BrilliantDawn84: posts small blind $0.50
beshece11harf: posts big blind $1
*** HOLE CARDS ***
yassine2525: folds 
p0pa4poker: folds 
Trojanovich: raises $1.50 to $2.50
BrilliantDawn84: folds 
beshece11harf: folds 
Uncalled bet ($1.50) returned to Trojanovich
Trojanovich collected $2.50 from pot
Trojanovich: doesn't show hand 
*** SUMMARY ***
Total pot $2.50 | Rake $0 
Seat 1: zangetsu800
Seat 2: beshece11harf (big blind) folded before Flop
Seat 3: yassine2525 folded before Flop (didn't bet)
Seat 4: p0pa4poker folded before Flop (didn't bet)
Seat 5: Trojanovich (button) collected ($2.50)
Seat 6: BrilliantDawn84 (small blind) folded before Flop



PokerStars Hand #254537384768:  Hold'em No Limit ($0.50/$1.00 USD) - 2025/01/24 22:45:00 WET [2025/01/24 17:45:00 ET]
Table 'Merapi IV' 6-max Seat #6 is the button
Seat 1: zangetsu800 ($0 in chips) is sitting out
Seat 2: beshece11harf ($100 in chips) 
Seat 3: yassine2525 ($31.07 in chips) 
Seat 4: p0pa4poker ($98 in chips) 
Seat 5: Trojanovich ($313.72 in chips) 
Seat 6: BrilliantDawn84 ($277.13 in chips) 
beshece11harf: posts small blind $0.50
yassine2525: posts big blind $1
*** HOLE CARDS ***
p0pa4poker: folds 
Trojanovich: folds 
BrilliantDawn84: raises $1.50 to $2.50
beshece11harf: calls $2
yassine2525: calls $1.50
*** FLOP *** [2s Kh Qh]
beshece11harf: checks 
yassine2525: checks 
BrilliantDawn84: bets $2.56
beshece11harf: calls $2.56
yassine2525: folds 
*** TURN *** [2s Kh Qh] [Jc]
beshece11harf: checks 
BrilliantDawn84: checks 
*** RIVER *** [2s Kh Qh Jc] [6d]
beshece11harf: bets $6
BrilliantDawn84: folds 
Uncalled bet ($6) returned to beshece11harf
beshece11harf collected $11.99 from pot
beshece11harf: doesn't show hand 
*** SUMMARY ***
Total pot $12.62 | Rake $0.63 
Board [2s Kh Qh Jc 6d]
Seat 1: zangetsu800
Seat 2: beshece11harf (small blind) collected ($11.99)
Seat 3: yassine2525 (big blind) folded on the Flop
Seat 4: p0pa4poker folded before Flop (didn't bet)
Seat 5: Trojanovich folded before Flop (didn't bet)
Seat 6: BrilliantDawn84 (button) folded on the River



PokerStars Hand #254537403116:  Hold'em No Limit ($0.50/$1.00 USD) - 2025/01/24 22:46:03 WET [2025/01/24 17:46:03 ET]
Table 'Merapi IV' 6-max Seat #2 is the button
Seat 1: zangetsu800 ($0 in chips) is sitting out
Seat 2: beshece11harf ($106.93 in chips) 
Seat 3: yassine2525 ($28.57 in chips) 
Seat 4: p0pa4poker ($100 in chips) 
Seat 5: Trojanovich ($313.72 in chips) 
Seat 6: BrilliantDawn84 ($272.07 in chips) 
yassine2525: posts small blind $0.50
p0pa4poker: posts big blind $1
*** HOLE CARDS ***
Trojanovich: folds 
BrilliantDawn84: folds 
beshece11harf: folds 
yassine2525: folds 
Uncalled bet ($0.50) returned to p0pa4poker
p0pa4poker collected $1 from pot
p0pa4poker: doesn't show hand 
*** SUMMARY ***
Total pot $1 | Rake $0 
Seat 1: zangetsu800
Seat 2: beshece11harf (button) folded before Flop (didn't bet)
Seat 3: yassine2525 (small blind) folded before Flop
Seat 4: p0pa4poker (big blind) collected ($1)
Seat 5: Trojanovich folded before Flop (didn't bet)
Seat 6: BrilliantDawn84 folded before Flop (didn't bet)



PokerStars Hand #254537406248:  Hold'em No Limit ($0.50/$1.00 USD) - 2025/01/24 22:46:14 WET [2025/01/24 17:46:14 ET]
Table 'Merapi IV' 6-max Seat #3 is the button
Seat 1: zangetsu800 ($0 in chips) is sitting out
Seat 2: beshece11harf ($106.93 in chips) 
Seat 3: yassine2525 ($28.07 in chips) 
Seat 4: p0pa4poker ($100.50 in chips) 
Seat 5: Trojanovich ($313.72 in chips) 
Seat 6: BrilliantDawn84 ($272.07 in chips) 
p0pa4poker: posts small blind $0.50
Trojanovich: posts big blind $1
*** HOLE CARDS ***
BrilliantDawn84: folds 
beshece11harf: folds 
yassine2525: raises $2 to $3
p0pa4poker: folds 
Trojanovich: folds 
Uncalled bet ($2) returned to yassine2525
yassine2525 collected $2.50 from pot
*** SUMMARY ***
Total pot $2.50 | Rake $0 
Seat 1: zangetsu800
Seat 2: beshece11harf folded before Flop (didn't bet)
Seat 3: yassine2525 (button) collected ($2.50)
Seat 4: p0pa4poker (small blind) folded before Flop
Seat 5: Trojanovich (big blind) folded before Flop
Seat 6: BrilliantDawn84 folded before Flop (didn't bet)



PokerStars Hand #254537411259:  Hold'em No Limit ($0.50/$1.00 USD) - 2025/01/24 22:46:31 WET [2025/01/24 17:46:31 ET]
Table 'Merapi IV' 6-max Seat #4 is the button
Seat 1: zangetsu800 ($0 in chips) is sitting out
Seat 2: beshece11harf ($106.93 in chips) 
Seat 3: yassine2525 ($29.57 in chips) 
Seat 4: p0pa4poker ($100 in chips) 
Seat 5: Trojanovich ($312.72 in chips) 
Seat 6: BrilliantDawn84 ($272.07 in chips) 
Trojanovich: posts small blind $0.50
BrilliantDawn84: posts big blind $1
*** HOLE CARDS ***
beshece11harf: folds 
yassine2525: raises $2 to $3
p0pa4poker: folds 
Trojanovich: folds 
BrilliantDawn84: folds 
Uncalled bet ($2) returned to yassine2525
yassine2525 collected $2.50 from pot
*** SUMMARY ***
Total pot $2.50 | Rake $0 
Seat 1: zangetsu800
Seat 2: beshece11harf folded before Flop (didn't bet)
Seat 3: yassine2525 collected ($2.50)
Seat 4: p0pa4poker (button) folded before Flop (didn't bet)
Seat 5: Trojanovich (small blind) folded before Flop
Seat 6: BrilliantDawn84 (big blind) folded before Flop



PokerStars Hand #254537414521:  Hold'em No Limit ($0.50/$1.00 USD) - 2025/01/24 22:46:42 WET [2025/01/24 17:46:42 ET]
Table 'Merapi IV' 6-max Seat #5 is the button
Seat 1: zangetsu800 ($0 in chips) is sitting out
Seat 2: beshece11harf ($106.93 in chips) 
Seat 3: yassine2525 ($31.07 in chips) 
Seat 4: p0pa4poker ($100 in chips) 
Seat 5: Trojanovich ($312.22 in chips) 
Seat 6: BrilliantDawn84 ($271.07 in chips) 
BrilliantDawn84: posts small blind $0.50
beshece11harf: posts big blind $1
*** HOLE CARDS ***
yassine2525: raises $1 to $2
p0pa4poker: folds 
Trojanovich: folds 
BrilliantDawn84: folds 
beshece11harf: raises $5.50 to $7.50
yassine2525: calls $5.50
*** FLOP *** [Ac 2s Ts]
beshece11harf: checks 
yassine2525: bets $7.80
beshece11harf: calls $7.80
*** TURN *** [Ac 2s Ts] [Ks]
beshece11harf: checks 
yassine2525: bets $15.77 and is all-in
beshece11harf: calls $15.77
*** RIVER *** [Ac 2s Ts Ks] [7h]
*** SHOW DOWN ***
beshece11harf: shows [Qs As] (a flush, Ace high)
yassine2525: shows [5d 5s] (a pair of Fives)
beshece11harf collected $60.14 from pot
*** SUMMARY ***
Total pot $62.64 | Rake $2.50 
Board [Ac 2s Ts Ks 7h]
Seat 1: zangetsu800
Seat 2: beshece11harf (big blind) showed [Qs As] and won ($60.14) with a flush, Ace high
Seat 3: yassine2525 showed [5d 5s] and lost with a pair of Fives
Seat 4: p0pa4poker folded before Flop (didn't bet)
Seat 5: Trojanovich (button) folded before Flop (didn't bet)
Seat 6: BrilliantDawn84 (small blind) folded before Flop



PokerStars Hand #254537432581:  Hold'em No Limit ($0.50/$1.00 USD) - 2025/01/24 22:47:45 WET [2025/01/24 17:47:45 ET]
Table 'Merapi IV' 6-max Seat #6 is the button
Seat 1: zangetsu800 ($0 in chips) is sitting out
Seat 2: beshece11harf ($136 in chips) 
Seat 4: p0pa4poker ($100 in chips) 
Seat 5: Trojanovich ($312.22 in chips) 
Seat 6: BrilliantDawn84 ($270.57 in chips) 
beshece11harf: posts small blind $0.50
p0pa4poker: posts big blind $1
*** HOLE CARDS ***
Trojanovich: folds 
BrilliantDawn84: folds 
beshece11harf: folds 
Uncalled bet ($0.50) returned to p0pa4poker
p0pa4poker collected $1 from pot
p0pa4poker: doesn't show hand 
*** SUMMARY ***
Total pot $1 | Rake $0 
Seat 1: zangetsu800
Seat 2: beshece11harf (small blind) folded before Flop
Seat 4: p0pa4poker (big blind) collected ($1)
Seat 5: Trojanovich folded before Flop (didn't bet)
Seat 6: BrilliantDawn84 (button) folded before Flop (didn't bet)



PokerStars Hand #254537437604:  Hold'em No Limit ($0.50/$1.00 USD) - 2025/01/24 22:48:02 WET [2025/01/24 17:48:02 ET]
Table 'Merapi IV' 6-max Seat #2 is the button
Seat 1: zangetsu800 ($0 in chips) is sitting out
Seat 2: beshece11harf ($135.50 in chips) 
Seat 4: p0pa4poker ($100.50 in chips) 
Seat 5: Trojanovich ($312.22 in chips) 
Seat 6: BrilliantDawn84 ($270.57 in chips) 
p0pa4poker: posts small blind $0.50
Trojanovich: posts big blind $1
*** HOLE CARDS ***
BrilliantDawn84: folds 
beshece11harf: raises $1.50 to $2.50
p0pa4poker: folds 
Trojanovich: calls $1.50
*** FLOP *** [Td 4c 2d]
Trojanovich: checks 
beshece11harf: bets $2.61
Trojanovich: raises $3.49 to $6.10
zangetsu800 leaves the table
beshece11harf: calls $3.49
*** TURN *** [Td 4c 2d] [7s]
Trojanovich: bets $27.10
beshece11harf: calls $27.10
*** RIVER *** [Td 4c 2d 7s] [Ts]
Trojanovich: bets $276.52 and is all-in
beshece11harf: calls $99.80 and is all-in
Uncalled bet ($176.72) returned to Trojanovich
*** SHOW DOWN ***
Trojanovich: shows [2c 2h] (a full house, Deuces full of Tens)
beshece11harf: shows [Tc Ah] (three of a kind, Tens)
Trojanovich collected $270.50 from pot
*** SUMMARY ***
Total pot $271.50 | Rake $1 
Board [Td 4c 2d 7s Ts]
Seat 1: zangetsu800
Seat 2: beshece11harf (button) showed [Tc Ah] and lost with three of a kind, Tens
Seat 4: p0pa4poker (small blind) folded before Flop
Seat 5: Trojanovich (big blind) showed [2c 2h] and won ($270.50) with a full house, Deuces full of Tens
Seat 6: BrilliantDawn84 folded before Flop (didn't bet)



PokerStars Hand #254537469396:  Hold'em No Limit ($0.50/$1.00 USD) - 2025/01/24 22:49:51 WET [2025/01/24 17:49:51 ET]
Table 'Merapi IV' 6-max Seat #4 is the button
Seat 2: beshece11harf ($100 in chips) 
Seat 4: p0pa4poker ($100 in chips) 
Seat 5: Trojanovich ($447.22 in chips) 
Seat 6: BrilliantDawn84 ($270.57 in chips) 
Trojanovich: posts small blind $0.50
BrilliantDawn84: posts big blind $1
*** HOLE CARDS ***
beshece11harf: raises $1 to $2
p0pa4poker: folds 
Trojanovich: folds 
BrilliantDawn84: folds 
Uncalled bet ($1) returned to beshece11harf
beshece11harf collected $2.50 from pot
beshece11harf: doesn't show hand 
*** SUMMARY ***
Total pot $2.50 | Rake $0 
Seat 2: beshece11harf collected ($2.50)
Seat 4: p0pa4poker (button) folded before Flop (didn't bet)
Seat 5: Trojanovich (small blind) folded before Flop
Seat 6: BrilliantDawn84 (big blind) folded before Flop



PokerStars Hand #254537472611:  Hold'em No Limit ($0.50/$1.00 USD) - 2025/01/24 22:50:03 WET [2025/01/24 17:50:03 ET]
Table 'Merapi IV' 6-max Seat #5 is the button
Seat 2: beshece11harf ($101.50 in chips) 
Seat 4: p0pa4poker ($100 in chips) 
Seat 5: Trojanovich ($446.72 in chips) 
Seat 6: BrilliantDawn84 ($269.57 in chips) 
BrilliantDawn84: posts small blind $0.50
beshece11harf: posts big blind $1
*** HOLE CARDS ***
p0pa4poker: raises $1.30 to $2.30
Trojanovich: calls $2.30
BrilliantDawn84: calls $1.80
beshece11harf: folds 
*** FLOP *** [9s Td Th]
BrilliantDawn84: checks 
p0pa4poker: checks 
Trojanovich: checks 
*** TURN *** [9s Td Th] [9c]
BrilliantDawn84: checks 
p0pa4poker: checks 
Trojanovich: checks 
*** RIVER *** [9s Td Th 9c] [6s]
BrilliantDawn84: checks 
itaba joins the table at seat #3 
p0pa4poker: bets $5.78
Trojanovich: calls $5.78
BrilliantDawn84: folds 
*** SHOW DOWN ***
p0pa4poker: shows [9h Qh] (a full house, Nines full of Tens)
Trojanovich: mucks hand 
p0pa4poker collected $18.49 from pot
*** SUMMARY ***
Total pot $19.46 | Rake $0.97 
Board [9s Td Th 9c 6s]
Seat 2: beshece11harf (big blind) folded before Flop
Seat 4: p0pa4poker showed [9h Qh] and won ($18.49) with a full house, Nines full of Tens
Seat 5: Trojanovich (button) mucked
Seat 6: BrilliantDawn84 (small blind) folded on the River



PokerStars Hand #254537497639:  Hold'em No Limit ($0.50/$1.00 USD) - 2025/01/24 22:51:30 WET [2025/01/24 17:51:30 ET]
Table 'Merapi IV' 6-max Seat #6 is the button
Seat 2: beshece11harf ($100.50 in chips) 
Seat 3: itaba ($18 in chips) 
Seat 4: p0pa4poker ($110.41 in chips) 
Seat 5: Trojanovich ($438.64 in chips) 
Seat 6: BrilliantDawn84 ($267.27 in chips) 
beshece11harf: posts small blind $0.50
itaba: posts big blind $1
*** HOLE CARDS ***
p0pa4poker: folds 
louisf1968 joins the table at seat #1 
Trojanovich: folds 
louisf1968 is disconnected 
BrilliantDawn84: raises $1.50 to $2.50
beshece11harf: folds 
itaba: folds 
Uncalled bet ($1.50) returned to BrilliantDawn84
BrilliantDawn84 collected $2.50 from pot
BrilliantDawn84: doesn't show hand 
*** SUMMARY ***
Total pot $2.50 | Rake $0 
Seat 2: beshece11harf (small blind) folded before Flop
Seat 3: itaba (big blind) folded before Flop
Seat 4: p0pa4poker folded before Flop (didn't bet)
Seat 5: Trojanovich folded before Flop (didn't bet)
Seat 6: BrilliantDawn84 (button) collected ($2.50)



PokerStars Hand #254537505234:  Hold'em No Limit ($0.50/$1.00 USD) - 2025/01/24 22:51:57 WET [2025/01/24 17:51:57 ET]
Table 'Merapi IV' 6-max Seat #2 is the button
Seat 1: louisf1968 ($51.71 in chips) 
Seat 2: beshece11harf ($100 in chips) 
Seat 3: itaba ($17 in chips) 
Seat 4: p0pa4poker ($110.41 in chips) 
Seat 5: Trojanovich ($438.64 in chips) 
Seat 6: BrilliantDawn84 ($268.77 in chips) 
itaba: posts small blind $0.50
p0pa4poker: posts big blind $1
louisf1968: posts big blind $1
*** HOLE CARDS ***
Trojanovich: folds 
BrilliantDawn84: raises $2.50 to $3.50
louisf1968: folds 
beshece11harf: folds 
itaba: folds 
p0pa4poker: raises $8.50 to $12
BrilliantDawn84: folds 
Uncalled bet ($8.50) returned to p0pa4poker
p0pa4poker collected $8.50 from pot
p0pa4poker: doesn't show hand 
*** SUMMARY ***
Total pot $8.50 | Rake $0 
Seat 1: louisf1968 folded before Flop (didn't bet)
Seat 2: beshece11harf (button) folded before Flop (didn't bet)
Seat 3: itaba (small blind) folded before Flop
Seat 4: p0pa4poker (big blind) collected ($8.50)
Seat 5: Trojanovich folded before Flop (didn't bet)
Seat 6: BrilliantDawn84 folded before Flop



PokerStars Hand #254537514260:  Hold'em No Limit ($0.50/$1.00 USD) - 2025/01/24 22:52:28 WET [2025/01/24 17:52:28 ET]
Table 'Merapi IV' 6-max Seat #3 is the button
Seat 1: louisf1968 ($50.71 in chips) 
Seat 2: beshece11harf ($100 in chips) 
Seat 3: itaba ($18.50 in chips) 
Seat 4: p0pa4poker ($115.41 in chips) 
Seat 5: Trojanovich ($438.64 in chips) 
Seat 6: BrilliantDawn84 ($265.27 in chips) 
p0pa4poker: posts small blind $0.50
Trojanovich: posts big blind $1
*** HOLE CARDS ***
BrilliantDawn84: folds 
louisf1968: calls $1
beshece11harf: raises $2.50 to $3.50
itaba: folds 
p0pa4poker: folds 
Trojanovich: folds 
louisf1968: calls $2.50
*** FLOP *** [9c Ac 8c]
louisf1968: checks 
beshece11harf: checks 
*** TURN *** [9c Ac 8c] [Kc]
louisf1968: bets $3
beshece11harf: folds 
Uncalled bet ($3) returned to louisf1968
louisf1968 collected $8.08 from pot
*** SUMMARY ***
Total pot $8.50 | Rake $0.42 
Board [9c Ac 8c Kc]
Seat 1: louisf1968 collected ($8.08)
Seat 2: beshece11harf folded on the Turn
Seat 3: itaba (button) folded before Flop (didn't bet)
Seat 4: p0pa4poker (small blind) folded before Flop
Seat 5: Trojanovich (big blind) folded before Flop
Seat 6: BrilliantDawn84 folded before Flop (didn't bet)



PokerStars Hand #254537530679:  Hold'em No Limit ($0.50/$1.00 USD) - 2025/01/24 22:53:26 WET [2025/01/24 17:53:26 ET]
Table 'Merapi IV' 6-max Seat #4 is the button
Seat 1: louisf1968 ($55.29 in chips) 
Seat 2: beshece11harf ($100 in chips) 
Seat 3: itaba ($18.50 in chips) 
Seat 4: p0pa4poker ($114.91 in chips) 
Seat 5: Trojanovich ($437.64 in chips) 
Seat 6: BrilliantDawn84 ($265.27 in chips) 
Trojanovich: posts small blind $0.50
BrilliantDawn84: posts big blind $1
*** HOLE CARDS ***
louisf1968: folds 
beshece11harf: raises $1 to $2
itaba: folds 
p0pa4poker: raises $5 to $7
Trojanovich: folds 
BrilliantDawn84: folds 
beshece11harf: calls $5
*** FLOP *** [8d Ts Ah]
beshece11harf: checks 
p0pa4poker: bets $4.86
beshece11harf: folds 
Uncalled bet ($4.86) returned to p0pa4poker
p0pa4poker collected $14.72 from pot
p0pa4poker: doesn't show hand 
*** SUMMARY ***
Total pot $15.50 | Rake $0.78 
Board [8d Ts Ah]
Seat 1: louisf1968 folded before Flop (didn't bet)
Seat 2: beshece11harf folded on the Flop
Seat 3: itaba folded before Flop (didn't bet)
Seat 4: p0pa4poker (button) collected ($14.72)
Seat 5: Trojanovich (small blind) folded before Flop
Seat 6: BrilliantDawn84 (big blind) folded before Flop



PokerStars Hand #254537554084:  Hold'em No Limit ($0.50/$1.00 USD) - 2025/01/24 22:54:49 WET [2025/01/24 17:54:49 ET]
Table 'Merapi IV' 6-max Seat #5 is the button
Seat 1: louisf1968 ($55.29 in chips) 
Seat 2: beshece11harf ($100 in chips) 
Seat 3: itaba ($18.50 in chips) 
Seat 4: p0pa4poker ($122.63 in chips) 
Seat 5: Trojanovich ($437.14 in chips) 
Seat 6: BrilliantDawn84 ($264.27 in chips) 
BrilliantDawn84: posts small blind $0.50
louisf1968: posts big blind $1
*** HOLE CARDS ***
beshece11harf: folds 
itaba: raises $1 to $2
p0pa4poker: folds 
Trojanovich: folds 
BrilliantDawn84: calls $1.50
louisf1968: folds 
*** FLOP *** [Jh 6s 3d]
louisf1968 leaves the table
BrilliantDawn84: checks 
itaba: bets $1.57
BrilliantDawn84: raises $3.57 to $5.14
itaba: calls $3.57
*** TURN *** [Jh 6s 3d] [Ac]
BrilliantDawn84: bets $4.26
itaba: calls $4.26
*** RIVER *** [Jh 6s 3d Ac] [Qd]
BrilliantDawn84: bets $8
itaba: calls $7.10 and is all-in
Uncalled bet ($0.90) returned to BrilliantDawn84
kars0n joins the table at seat #1 
*** SHOW DOWN ***
BrilliantDawn84: shows [Qc Js] (two pair, Queens and Jacks)
itaba: shows [Ah Ks] (a pair of Aces)
BrilliantDawn84 collected $36.10 from pot
*** SUMMARY ***
Total pot $38 | Rake $1.90 
Board [Jh 6s 3d Ac Qd]
Seat 1: louisf1968 (big blind) folded before Flop
Seat 2: beshece11harf folded before Flop (didn't bet)
Seat 3: itaba showed [Ah Ks] and lost with a pair of Aces
Seat 4: p0pa4poker folded before Flop (didn't bet)
Seat 5: Trojanovich (button) folded before Flop (didn't bet)
Seat 6: BrilliantDawn84 (small blind) showed [Qc Js] and won ($36.10) with two pair, Queens and Jacks



PokerStars Hand #254537571639:  Hold'em No Limit ($0.50/$1.00 USD) - 2025/01/24 22:56:03 WET [2025/01/24 17:56:03 ET]
Table 'Merapi IV' 6-max Seat #6 is the button
Seat 1: kars0n ($100 in chips) is sitting out
Seat 2: beshece11harf ($100 in chips) 
Seat 3: itaba ($10 in chips) 
Seat 4: p0pa4poker ($122.63 in chips) 
Seat 5: Trojanovich ($437.14 in chips) 
Seat 6: BrilliantDawn84 ($281.87 in chips) 
beshece11harf: posts small blind $0.50
itaba: posts big blind $1
*** HOLE CARDS ***
p0pa4poker: raises $1 to $2
Trojanovich: folds 
BrilliantDawn84: folds 
beshece11harf: raises $8 to $10
itaba: folds 
p0pa4poker: raises $9 to $19
beshece11harf: raises $81 to $100 and is all-in
p0pa4poker: folds 
Uncalled bet ($81) returned to beshece11harf
beshece11harf collected $39 from pot
beshece11harf: doesn't show hand 
*** SUMMARY ***
Total pot $39 | Rake $0 
Seat 1: kars0n
Seat 2: beshece11harf (small blind) collected ($39)
Seat 3: itaba (big blind) folded before Flop
Seat 4: p0pa4poker folded before Flop
Seat 5: Trojanovich folded before Flop (didn't bet)
Seat 6: BrilliantDawn84 (button) folded before Flop (didn't bet)



PokerStars Hand #254537584255:  Hold'em No Limit ($0.50/$1.00 USD) - 2025/01/24 22:57:01 WET [2025/01/24 17:57:01 ET]
Table 'Merapi IV' 6-max Seat #2 is the button
Seat 1: kars0n ($100 in chips) is sitting out
Seat 2: beshece11harf ($120 in chips) 
Seat 3: itaba ($9 in chips) 
Seat 4: p0pa4poker ($103.63 in chips) 
Seat 5: Trojanovich ($437.14 in chips) 
Seat 6: BrilliantDawn84 ($281.87 in chips) 
itaba: posts small blind $0.50
p0pa4poker: posts big blind $1
kars0n: sits out 
*** HOLE CARDS ***
Trojanovich: folds 
BrilliantDawn84: folds 
beshece11harf: raises $1.50 to $2.50
itaba: folds 
p0pa4poker: calls $1.50
*** FLOP *** [4d 5h As]
p0pa4poker: checks 
beshece11harf: checks 
*** TURN *** [4d 5h As] [7s]
p0pa4poker: checks 
beshece11harf: checks 
*** RIVER *** [4d 5h As 7s] [2d]
p0pa4poker: bets $6.53
beshece11harf: folds 
Uncalled bet ($6.53) returned to p0pa4poker
p0pa4poker collected $5.22 from pot
p0pa4poker: doesn't show hand 
*** SUMMARY ***
Total pot $5.50 | Rake $0.28 
Board [4d 5h As 7s 2d]
Seat 1: kars0n
Seat 2: beshece11harf (button) folded on the River
Seat 3: itaba (small blind) folded before Flop
Seat 4: p0pa4poker (big blind) collected ($5.22)
Seat 5: Trojanovich folded before Flop (didn't bet)
Seat 6: BrilliantDawn84 folded before Flop (didn't bet)



PokerStars Hand #254537605562:  Hold'em No Limit ($0.50/$1.00 USD) - 2025/01/24 22:58:41 WET [2025/01/24 17:58:41 ET]
Table 'Merapi IV' 6-max Seat #3 is the button
Seat 1: kars0n ($100 in chips) is sitting out
Seat 2: beshece11harf ($117.50 in chips) 
Seat 3: itaba ($8.50 in chips) 
Seat 4: p0pa4poker ($106.35 in chips) 
Seat 5: Trojanovich ($437.14 in chips) 
Seat 6: BrilliantDawn84 ($281.87 in chips) 
p0pa4poker: posts small blind $0.50
Trojanovich: posts big blind $1
kars0n: sits out 
*** HOLE CARDS ***
BrilliantDawn84: folds 
beshece11harf: folds 
itaba: folds 
p0pa4poker: folds 
Uncalled bet ($0.50) returned to Trojanovich
Trojanovich collected $1 from pot
Trojanovich: doesn't show hand 
*** SUMMARY ***
Total pot $1 | Rake $0 
Seat 1: kars0n
Seat 2: beshece11harf folded before Flop (didn't bet)
Seat 3: itaba (button) folded before Flop (didn't bet)
Seat 4: p0pa4poker (small blind) folded before Flop
Seat 5: Trojanovich (big blind) collected ($1)
Seat 6: BrilliantDawn84 folded before Flop (didn't bet)



PokerStars Hand #254537607647:  Hold'em No Limit ($0.50/$1.00 USD) - 2025/01/24 22:58:51 WET [2025/01/24 17:58:51 ET]
Table 'Merapi IV' 6-max Seat #4 is the button
Seat 1: kars0n ($100 in chips) is sitting out
Seat 2: beshece11harf ($117.50 in chips) 
Seat 3: itaba ($8.50 in chips) 
Seat 4: p0pa4poker ($105.85 in chips) 
Seat 5: Trojanovich ($437.64 in chips) 
Seat 6: BrilliantDawn84 ($281.87 in chips) 
Trojanovich: posts small blind $0.50
BrilliantDawn84: posts big blind $1
kars0n: sits out 
*** HOLE CARDS ***
beshece11harf: folds 
itaba: folds 
p0pa4poker: raises $1.50 to $2.50
Trojanovich: folds 
BrilliantDawn84: folds 
Uncalled bet ($1.50) returned to p0pa4poker
p0pa4poker collected $2.50 from pot
p0pa4poker: doesn't show hand 
*** SUMMARY ***
Total pot $2.50 | Rake $0 
Seat 1: kars0n
Seat 2: beshece11harf folded before Flop (didn't bet)
Seat 3: itaba folded before Flop (didn't bet)
Seat 4: p0pa4poker (button) collected ($2.50)
Seat 5: Trojanovich (small blind) folded before Flop
Seat 6: BrilliantDawn84 (big blind) folded before Flop



PokerStars Hand #254537610928:  Hold'em No Limit ($0.50/$1.00 USD) - 2025/01/24 22:59:06 WET [2025/01/24 17:59:06 ET]
Table 'Merapi IV' 6-max Seat #5 is the button
Seat 1: kars0n ($100 in chips) 
Seat 2: beshece11harf ($117.50 in chips) 
Seat 3: itaba ($8.50 in chips) 
Seat 4: p0pa4poker ($107.35 in chips) 
Seat 5: Trojanovich ($437.14 in chips) 
Seat 6: BrilliantDawn84 ($280.87 in chips) 
BrilliantDawn84: posts small blind $0.50
kars0n: posts big blind $1
*** HOLE CARDS ***
beshece11harf: folds 
itaba: folds 
p0pa4poker: raises $1.30 to $2.30
Trojanovich: folds 
BrilliantDawn84: folds 
kars0n: folds 
Uncalled bet ($1.30) returned to p0pa4poker
p0pa4poker collected $2.50 from pot
p0pa4poker: doesn't show hand 
*** SUMMARY ***
Total pot $2.50 | Rake $0 
Seat 1: kars0n (big blind) folded before Flop
Seat 2: beshece11harf folded before Flop (didn't bet)
Seat 3: itaba folded before Flop (didn't bet)
Seat 4: p0pa4poker collected ($2.50)
Seat 5: Trojanovich (button) folded before Flop (didn't bet)
Seat 6: BrilliantDawn84 (small blind) folded before Flop



PokerStars Hand #254537616530:  Hold'em No Limit ($0.50/$1.00 USD) - 2025/01/24 22:59:33 WET [2025/01/24 17:59:33 ET]
Table 'Merapi IV' 6-max Seat #6 is the button
Seat 1: kars0n ($100 in chips) 
Seat 2: beshece11harf ($117.50 in chips) 
Seat 3: itaba ($8.50 in chips) 
Seat 4: p0pa4poker ($108.85 in chips) 
Seat 5: Trojanovich ($437.14 in chips) 
Seat 6: BrilliantDawn84 ($280.37 in chips) 
kars0n: posts small blind $0.50
beshece11harf: posts big blind $1
*** HOLE CARDS ***
itaba: folds 
itaba leaves the table
p0pa4poker: raises $1 to $2
Trojanovich: folds 
BrilliantDawn84: raises $5.50 to $7.50
kars0n: folds 
beshece11harf: folds 
p0pa4poker: folds 
Uncalled bet ($5.50) returned to BrilliantDawn84
BrilliantDawn84 collected $5.50 from pot
BrilliantDawn84: doesn't show hand 
*** SUMMARY ***
Total pot $5.50 | Rake $0 
Seat 1: kars0n (small blind) folded before Flop
Seat 2: beshece11harf (big blind) folded before Flop
Seat 3: itaba folded before Flop (didn't bet)
Seat 4: p0pa4poker folded before Flop
Seat 5: Trojanovich folded before Flop (didn't bet)
Seat 6: BrilliantDawn84 (button) collected ($5.50)



PokerStars Hand #254537621925:  Hold'em No Limit ($0.50/$1.00 USD) - 2025/01/24 22:59:58 WET [2025/01/24 17:59:58 ET]
Table 'Merapi IV' 6-max Seat #1 is the button
Seat 1: kars0n ($100 in chips) 
Seat 2: beshece11harf ($116.50 in chips) 
Seat 4: p0pa4poker ($106.85 in chips) 
Seat 5: Trojanovich ($437.14 in chips) 
Seat 6: BrilliantDawn84 ($283.87 in chips) 
beshece11harf: posts small blind $0.50
p0pa4poker: posts big blind $1
*** HOLE CARDS ***
Trojanovich: folds 
BrilliantDawn84: raises $1.50 to $2.50
kars0n: folds 
beshece11harf: folds 
p0pa4poker: folds 
Uncalled bet ($1.50) returned to BrilliantDawn84
BrilliantDawn84 collected $2.50 from pot
BrilliantDawn84: doesn't show hand 
*** SUMMARY ***
Total pot $2.50 | Rake $0 
Seat 1: kars0n (button) folded before Flop (didn't bet)
Seat 2: beshece11harf (small blind) folded before Flop
Seat 4: p0pa4poker (big blind) folded before Flop
Seat 5: Trojanovich folded before Flop (didn't bet)
Seat 6: BrilliantDawn84 collected ($2.50)



PokerStars Hand #254537625219:  Hold'em No Limit ($0.50/$1.00 USD) - 2025/01/24 23:00:13 WET [2025/01/24 18:00:13 ET]
Table 'Merapi IV' 6-max Seat #2 is the button
Seat 1: kars0n ($100 in chips) 
Seat 2: beshece11harf ($116 in chips) 
Seat 4: p0pa4poker ($105.85 in chips) 
Seat 5: Trojanovich ($437.14 in chips) 
Seat 6: BrilliantDawn84 ($285.37 in chips) 
p0pa4poker: posts small blind $0.50
Trojanovich: posts big blind $1
*** HOLE CARDS ***
boydst1 joins the table at seat #3 
boydst1 is disconnected 
BrilliantDawn84: raises $1.50 to $2.50
kars0n: folds 
beshece11harf: raises $5.50 to $8
p0pa4poker: folds 
Trojanovich: folds 
BrilliantDawn84: folds 
Uncalled bet ($5.50) returned to beshece11harf
beshece11harf collected $6.50 from pot
beshece11harf: doesn't show hand 
*** SUMMARY ***
Total pot $6.50 | Rake $0 
Seat 1: kars0n folded before Flop (didn't bet)
Seat 2: beshece11harf (button) collected ($6.50)
Seat 4: p0pa4poker (small blind) folded before Flop
Seat 5: Trojanovich (big blind) folded before Flop
Seat 6: BrilliantDawn84 folded before Flop



PokerStars Hand #254537633974:  Hold'em No Limit ($0.50/$1.00 USD) - 2025/01/24 23:00:52 WET [2025/01/24 18:00:52 ET]
Table 'Merapi IV' 6-max Seat #4 is the button
Seat 1: kars0n ($100 in chips) 
Seat 2: beshece11harf ($120 in chips) 
Seat 3: boydst1 ($100 in chips) 
Seat 4: p0pa4poker ($105.35 in chips) 
Seat 5: Trojanovich ($436.14 in chips) 
Seat 6: BrilliantDawn84 ($282.87 in chips) 
Trojanovich: posts small blind $0.50
BrilliantDawn84: posts big blind $1
boydst1: posts big blind $1
*** HOLE CARDS ***
kars0n: folds 
beshece11harf: folds 
boydst1: checks 
p0pa4poker: folds 
Trojanovich: folds 
BrilliantDawn84: checks 
*** FLOP *** [Qs Jh 9d]
BrilliantDawn84: checks 
boydst1: checks 
*** TURN *** [Qs Jh 9d] [6h]
BrilliantDawn84: checks 
boydst1: checks 
*** RIVER *** [Qs Jh 9d 6h] [6d]
BrilliantDawn84: checks 
boydst1: bets $2.38
BrilliantDawn84: folds 
Uncalled bet ($2.38) returned to boydst1
boydst1 collected $2.38 from pot
boydst1: doesn't show hand 
*** SUMMARY ***
Total pot $2.50 | Rake $0.12 
Board [Qs Jh 9d 6h 6d]
Seat 1: kars0n folded before Flop (didn't bet)
Seat 2: beshece11harf folded before Flop (didn't bet)
Seat 3: boydst1 collected ($2.38)
Seat 4: p0pa4poker (button) folded before Flop (didn't bet)
Seat 5: Trojanovich (small blind) folded before Flop
Seat 6: BrilliantDawn84 (big blind) folded on the River



PokerStars Hand #254537644226:  Hold'em No Limit ($0.50/$1.00 USD) - 2025/01/24 23:01:32 WET [2025/01/24 18:01:32 ET]
Table 'Merapi IV' 6-max Seat #5 is the button
Seat 1: kars0n ($100 in chips) is sitting out
Seat 2: beshece11harf ($120 in chips) 
Seat 3: boydst1 ($101.38 in chips) 
Seat 4: p0pa4poker ($105.35 in chips) 
Seat 5: Trojanovich ($435.64 in chips) 
Seat 6: BrilliantDawn84 ($281.87 in chips) 
BrilliantDawn84: posts small blind $0.50
kars0n: is sitting out 
beshece11harf: posts big blind $1
*** HOLE CARDS ***
boydst1: folds 
p0pa4poker: folds 
Trojanovich: folds 
BrilliantDawn84: raises $1.50 to $2.50
beshece11harf: calls $1.50
*** FLOP *** [3c 9s 7c]
BrilliantDawn84: bets $2.38
kars0n leaves the table
beshece11harf: calls $2.38
*** TURN *** [3c 9s 7c] [Qd]
BrilliantDawn84: checks 
XneferX joins the table at seat #1 
beshece11harf: bets $6.95
BrilliantDawn84: folds 
Uncalled bet ($6.95) returned to beshece11harf
beshece11harf collected $9.27 from pot
beshece11harf: doesn't show hand 
*** SUMMARY ***
Total pot $9.76 | Rake $0.49 
Board [3c 9s 7c Qd]
Seat 1: kars0n
Seat 2: beshece11harf (big blind) collected ($9.27)
Seat 3: boydst1 folded before Flop (didn't bet)
Seat 4: p0pa4poker folded before Flop (didn't bet)
Seat 5: Trojanovich (button) folded before Flop (didn't bet)
Seat 6: BrilliantDawn84 (small blind) folded on the Turn



PokerStars Hand #254537660918:  Hold'em No Limit ($0.50/$1.00 USD) - 2025/01/24 23:02:33 WET [2025/01/24 18:02:33 ET]
Table 'Merapi IV' 6-max Seat #6 is the button
Seat 1: XneferX ($100 in chips) is sitting out
Seat 2: beshece11harf ($124.39 in chips) 
Seat 3: boydst1 ($101.38 in chips) 
Seat 4: p0pa4poker ($105.35 in chips) 
Seat 5: Trojanovich ($435.64 in chips) 
Seat 6: BrilliantDawn84 ($276.99 in chips) 
beshece11harf: posts small blind $0.50
boydst1: posts big blind $1
*** HOLE CARDS ***
p0pa4poker: folds 
Trojanovich: raises $1.50 to $2.50
BrilliantDawn84: folds 
beshece11harf: folds 
boydst1: calls $1.50
*** FLOP *** [5s 4d As]
boydst1: checks 
Trojanovich: checks 
*** TURN *** [5s 4d As] [3h]
boydst1: checks 
Trojanovich: checks 
*** RIVER *** [5s 4d As 3h] [Kh]
boydst1: bets $3.61
Trojanovich: folds 
Uncalled bet ($3.61) returned to boydst1
boydst1 collected $5.22 from pot
boydst1: doesn't show hand 
*** SUMMARY ***
Total pot $5.50 | Rake $0.28 
Board [5s 4d As 3h Kh]
Seat 1: XneferX
Seat 2: beshece11harf (small blind) folded before Flop
Seat 3: boydst1 (big blind) collected ($5.22)
Seat 4: p0pa4poker folded before Flop (didn't bet)
Seat 5: Trojanovich folded on the River
Seat 6: BrilliantDawn84 (button) folded before Flop (didn't bet)



PokerStars Hand #254537678738:  Hold'em No Limit ($0.50/$1.00 USD) - 2025/01/24 23:03:38 WET [2025/01/24 18:03:38 ET]
Table 'Merapi IV' 6-max Seat #2 is the button
Seat 1: XneferX ($100 in chips) is sitting out
Seat 2: beshece11harf ($123.89 in chips) 
Seat 3: boydst1 ($104.10 in chips) 
Seat 4: p0pa4poker ($105.35 in chips) 
Seat 5: Trojanovich ($433.14 in chips) 
Seat 6: BrilliantDawn84 ($276.99 in chips) 
boydst1: posts small blind $0.50
p0pa4poker: posts big blind $1
XneferX: sits out 
*** HOLE CARDS ***
Trojanovich: folds 
BrilliantDawn84: raises $1.50 to $2.50
beshece11harf: raises $5.50 to $8
boydst1: folds 
p0pa4poker: folds 
BrilliantDawn84: calls $5.50
*** FLOP *** [2h 9s Ac]
BrilliantDawn84: checks 
beshece11harf: bets $4.16
BrilliantDawn84: calls $4.16
*** TURN *** [2h 9s Ac] [Qc]
BrilliantDawn84: checks 
beshece11harf: bets $19.50
BrilliantDawn84: folds 
Uncalled bet ($19.50) returned to beshece11harf
beshece11harf collected $24.53 from pot
beshece11harf: doesn't show hand 
*** SUMMARY ***
Total pot $25.82 | Rake $1.29 
Board [2h 9s Ac Qc]
Seat 1: XneferX
Seat 2: beshece11harf (button) collected ($24.53)
Seat 3: boydst1 (small blind) folded before Flop
Seat 4: p0pa4poker (big blind) folded before Flop
Seat 5: Trojanovich folded before Flop (didn't bet)
Seat 6: BrilliantDawn84 folded on the Turn



PokerStars Hand #254537694126:  Hold'em No Limit ($0.50/$1.00 USD) - 2025/01/24 23:04:33 WET [2025/01/24 18:04:33 ET]
Table 'Merapi IV' 6-max Seat #3 is the button
Seat 1: XneferX ($100 in chips) is sitting out
Seat 6: BrilliantDawn84 ($264.83 in chips) is sitting out
Seat 2: beshece11harf ($136.26 in chips) 
Seat 3: boydst1 ($103.60 in chips) 
Seat 4: p0pa4poker ($104.35 in chips) 
Seat 5: Trojanovich ($433.14 in chips) 
p0pa4poker: posts small blind $0.50
Trojanovich: posts big blind $1
XneferX: sits out 
*** HOLE CARDS ***
beshece11harf: folds 
boydst1: raises $1 to $2
p0pa4poker: folds 
Trojanovich: folds 
Uncalled bet ($1) returned to boydst1
boydst1 collected $2.50 from pot
boydst1: doesn't show hand 
BrilliantDawn84 leaves the table
*** SUMMARY ***
Total pot $2.50 | Rake $0 
Seat 1: XneferX
Seat 6: BrilliantDawn84
Seat 2: beshece11harf folded before Flop (didn't bet)
Seat 3: boydst1 (button) collected ($2.50)
Seat 4: p0pa4poker (small blind) folded before Flop
Seat 5: Trojanovich (big blind) folded before Flop



PokerStars Hand #254537697849:  Hold'em No Limit ($0.50/$1.00 USD) - 2025/01/24 23:04:46 WET [2025/01/24 18:04:46 ET]
Table 'Merapi IV' 6-max Seat #4 is the button
Seat 1: XneferX ($100 in chips) 
Seat 2: beshece11harf ($136.26 in chips) 
Seat 3: boydst1 ($105.10 in chips) 
Seat 4: p0pa4poker ($103.85 in chips) 
Seat 5: Trojanovich ($432.14 in chips) 
Trojanovich: posts small blind $0.50
XneferX: posts big blind $1
*** HOLE CARDS ***
beshece11harf: folds 
boydst1: folds 
p0pa4poker: raises $1.50 to $2.50
Trojanovich: folds 
XneferX: calls $1.50
*** FLOP *** [7h Kc 4c]
tintin641 joins the table at seat #6 
XneferX: checks 
p0pa4poker: bets $2.61
XneferX: folds 
Uncalled bet ($2.61) returned to p0pa4poker
p0pa4poker collected $5.22 from pot
p0pa4poker: doesn't show hand 
*** SUMMARY ***
Total pot $5.50 | Rake $0.28 
Board [7h Kc 4c]
Seat 1: XneferX (big blind) folded on the Flop
Seat 2: beshece11harf folded before Flop (didn't bet)
Seat 3: boydst1 folded before Flop (didn't bet)
Seat 4: p0pa4poker (button) collected ($5.22)
Seat 5: Trojanovich (small blind) folded before Flop



PokerStars Hand #254537711989:  Hold'em No Limit ($0.50/$1.00 USD) - 2025/01/24 23:05:37 WET [2025/01/24 18:05:37 ET]
Table 'Merapi IV' 6-max Seat #5 is the button
Seat 6: tintin641 ($100 in chips) is sitting out
Seat 1: XneferX ($100 in chips) 
Seat 2: beshece11harf ($136.26 in chips) 
Seat 3: boydst1 ($105.10 in chips) 
Seat 4: p0pa4poker ($106.57 in chips) 
Seat 5: Trojanovich ($431.64 in chips) 
XneferX: posts small blind $0.50
beshece11harf: posts big blind $1
*** HOLE CARDS ***
boydst1: folds 
p0pa4poker: folds 
Trojanovich: raises $1.50 to $2.50
XneferX: folds 
beshece11harf: calls $1.50
*** FLOP *** [6d Ts 3d]
beshece11harf: checks 
Trojanovich: checks 
*** TURN *** [6d Ts 3d] [Qc]
beshece11harf: bets $3.92
Trojanovich: folds 
Uncalled bet ($3.92) returned to beshece11harf
beshece11harf collected $5.22 from pot
beshece11harf: doesn't show hand 
*** SUMMARY ***
Total pot $5.50 | Rake $0.28 
Board [6d Ts 3d Qc]
Seat 6: tintin641
Seat 1: XneferX (small blind) folded before Flop
Seat 2: beshece11harf (big blind) collected ($5.22)
Seat 3: boydst1 folded before Flop (didn't bet)
Seat 4: p0pa4poker folded before Flop (didn't bet)
Seat 5: Trojanovich (button) folded on the Turn



PokerStars Hand #254537734301:  Hold'em No Limit ($0.50/$1.00 USD) - 2025/01/24 23:06:56 WET [2025/01/24 18:06:56 ET]
Table 'Merapi IV' 6-max Seat #1 is the button
Seat 6: tintin641 ($100 in chips) is sitting out
Seat 1: XneferX ($100 in chips) 
Seat 2: beshece11harf ($138.98 in chips) 
Seat 3: boydst1 ($105.10 in chips) 
Seat 4: p0pa4poker ($106.57 in chips) 
Seat 5: Trojanovich ($429.14 in chips) 
beshece11harf: posts small blind $0.50
boydst1: posts big blind $1
tintin641: sits out 
*** HOLE CARDS ***
p0pa4poker: folds 
Trojanovich: folds 
XneferX: raises $1.77 to $2.77
beshece11harf: folds 
boydst1: calls $1.77
*** FLOP *** [Ks 4c 2h]
boydst1: checks 
XneferX: bets $1.20
boydst1: calls $1.20
*** TURN *** [Ks 4c 2h] [Kd]
boydst1: checks 
XneferX: checks 
*** RIVER *** [Ks 4c 2h Kd] [Ts]
boydst1: bets $4.01
XneferX: calls $4.01
*** SHOW DOWN ***
boydst1: shows [Kh 3s] (three of a kind, Kings)
XneferX: mucks hand 
boydst1 collected $15.64 from pot
*** SUMMARY ***
Total pot $16.46 | Rake $0.82 
Board [Ks 4c 2h Kd Ts]
Seat 6: tintin641
Seat 1: XneferX (button) mucked
Seat 2: beshece11harf (small blind) folded before Flop
Seat 3: boydst1 (big blind) showed [Kh 3s] and won ($15.64) with three of a kind, Kings
Seat 4: p0pa4poker folded before Flop (didn't bet)
Seat 5: Trojanovich folded before Flop (didn't bet)



PokerStars Hand #254537750841:  Hold'em No Limit ($0.50/$1.00 USD) - 2025/01/24 23:07:56 WET [2025/01/24 18:07:56 ET]
Table 'Merapi IV' 6-max Seat #2 is the button
Seat 6: tintin641 ($100 in chips) is sitting out
Seat 1: XneferX ($100 in chips) 
Seat 2: beshece11harf ($138.48 in chips) 
Seat 3: boydst1 ($112.76 in chips) 
Seat 4: p0pa4poker ($106.57 in chips) 
Seat 5: Trojanovich ($429.14 in chips) 
boydst1: posts small blind $0.50
p0pa4poker: posts big blind $1
tintin641: sits out 
*** HOLE CARDS ***
Trojanovich: folds 
XneferX: folds 
beshece11harf: raises $1.50 to $2.50
boydst1: calls $2
p0pa4poker: raises $11.50 to $14
beshece11harf: raises $15 to $29
boydst1: folds 
p0pa4poker: raises $77.57 to $106.57 and is all-in
beshece11harf: calls $77.57
*** FLOP *** [9h 4s 2c]
*** TURN *** [9h 4s 2c] [9c]
*** RIVER *** [9h 4s 2c 9c] [Qd]
*** SHOW DOWN ***
p0pa4poker: shows [As 3s] (a pair of Nines)
beshece11harf: shows [Ah Ks] (a pair of Nines - Ace+King kicker)
beshece11harf collected $213.14 from pot
*** SUMMARY ***
Total pot $215.64 | Rake $2.50 
Board [9h 4s 2c 9c Qd]
Seat 6: tintin641
Seat 1: XneferX folded before Flop (didn't bet)
Seat 2: beshece11harf (button) showed [Ah Ks] and won ($213.14) with a pair of Nines
Seat 3: boydst1 (small blind) folded before Flop
Seat 4: p0pa4poker (big blind) showed [As 3s] and lost with a pair of Nines
Seat 5: Trojanovich folded before Flop (didn't bet)



PokerStars Hand #254537774247:  Hold'em No Limit ($0.50/$1.00 USD) - 2025/01/24 23:09:20 WET [2025/01/24 18:09:20 ET]
Table 'Merapi IV' 6-max Seat #3 is the button
Seat 6: tintin641 ($100 in chips) is sitting out
Seat 1: XneferX ($100 in chips) 
Seat 2: beshece11harf ($245.05 in chips) 
Seat 3: boydst1 ($110.26 in chips) 
Seat 4: p0pa4poker ($10 in chips) 
Seat 5: Trojanovich ($429.14 in chips) 
p0pa4poker: posts small blind $0.50
Trojanovich: posts big blind $1
tintin641: sits out 
*** HOLE CARDS ***
XneferX: folds 
beshece11harf: raises $1 to $2
boydst1: folds 
p0pa4poker: folds 
Trojanovich: folds 
Uncalled bet ($1) returned to beshece11harf
beshece11harf collected $2.50 from pot
beshece11harf: doesn't show hand 
*** SUMMARY ***
Total pot $2.50 | Rake $0 
Seat 6: tintin641
Seat 1: XneferX folded before Flop (didn't bet)
Seat 2: beshece11harf collected ($2.50)
Seat 3: boydst1 (button) folded before Flop (didn't bet)
Seat 4: p0pa4poker (small blind) folded before Flop
Seat 5: Trojanovich (big blind) folded before Flop



PokerStars Hand #254537778881:  Hold'em No Limit ($0.50/$1.00 USD) - 2025/01/24 23:09:36 WET [2025/01/24 18:09:36 ET]
Table 'Merapi IV' 6-max Seat #4 is the button
Seat 1: XneferX ($100 in chips) 
Seat 2: beshece11harf ($246.55 in chips) 
Seat 3: boydst1 ($110.26 in chips) 
Seat 4: p0pa4poker ($100 in chips) 
Seat 5: Trojanovich ($428.14 in chips) 
Seat 6: tintin641 ($100 in chips) 
Trojanovich: posts small blind $0.50
tintin641: posts big blind $1
*** HOLE CARDS ***
XneferX: folds 
beshece11harf: raises $1 to $2
boydst1: folds 
p0pa4poker: folds 
Trojanovich: folds 
tintin641: folds 
Uncalled bet ($1) returned to beshece11harf
beshece11harf collected $2.50 from pot
beshece11harf: doesn't show hand 
*** SUMMARY ***
Total pot $2.50 | Rake $0 
Seat 1: XneferX folded before Flop (didn't bet)
Seat 2: beshece11harf collected ($2.50)
Seat 3: boydst1 folded before Flop (didn't bet)
Seat 4: p0pa4poker (button) folded before Flop (didn't bet)
Seat 5: Trojanovich (small blind) folded before Flop
Seat 6: tintin641 (big blind) folded before Flop



PokerStars Hand #254537782645:  Hold'em No Limit ($0.50/$1.00 USD) - 2025/01/24 23:09:50 WET [2025/01/24 18:09:50 ET]
Table 'Merapi IV' 6-max Seat #5 is the button
Seat 1: XneferX ($100 in chips) 
Seat 2: beshece11harf ($248.05 in chips) 
Seat 3: boydst1 ($110.26 in chips) 
Seat 4: p0pa4poker ($100 in chips) 
Seat 5: Trojanovich ($427.64 in chips) 
Seat 6: tintin641 ($100 in chips) 
tintin641: posts small blind $0.50
XneferX: posts big blind $1
*** HOLE CARDS ***
beshece11harf: raises $1 to $2
boydst1: folds 
p0pa4poker: folds 
Trojanovich: calls $2
tintin641: folds 
XneferX: folds 
*** FLOP *** [2s 3c 9h]
beshece11harf: checks 
Trojanovich: bets $2.61
beshece11harf: calls $2.61
*** TURN *** [2s 3c 9h] [Qc]
beshece11harf: checks 
Trojanovich: checks 
*** RIVER *** [2s 3c 9h Qc] [6c]
beshece11harf: bets $7.64
Trojanovich: calls $7.64
*** SHOW DOWN ***
beshece11harf: shows [5s As] (high card Ace)
Trojanovich: shows [8s 9s] (a pair of Nines)
Trojanovich collected $24.70 from pot
*** SUMMARY ***
Total pot $26 | Rake $1.30 
Board [2s 3c 9h Qc 6c]
Seat 1: XneferX (big blind) folded before Flop
Seat 2: beshece11harf showed [5s As] and lost with high card Ace
Seat 3: boydst1 folded before Flop (didn't bet)
Seat 4: p0pa4poker folded before Flop (didn't bet)
Seat 5: Trojanovich (button) showed [8s 9s] and won ($24.70) with a pair of Nines
Seat 6: tintin641 (small blind) folded before Flop



PokerStars Hand #254537804227:  Hold'em No Limit ($0.50/$1.00 USD) - 2025/01/24 23:11:09 WET [2025/01/24 18:11:09 ET]
Table 'Merapi IV' 6-max Seat #6 is the button
Seat 1: XneferX ($100 in chips) 
Seat 2: beshece11harf ($235.80 in chips) 
Seat 3: boydst1 ($110.26 in chips) 
Seat 4: p0pa4poker ($100 in chips) 
Seat 5: Trojanovich ($440.09 in chips) 
Seat 6: tintin641 ($100 in chips) 
XneferX: posts small blind $0.50
beshece11harf: posts big blind $1
*** HOLE CARDS ***
boydst1: raises $1 to $2
p0pa4poker: raises $5 to $7
Trojanovich: folds 
tintin641: folds 
XneferX: folds 
beshece11harf: raises $13 to $20
boydst1: folds 
p0pa4poker: folds 
Uncalled bet ($13) returned to beshece11harf
beshece11harf collected $16.50 from pot
beshece11harf: doesn't show hand 
*** SUMMARY ***
Total pot $16.50 | Rake $0 
Seat 1: XneferX (small blind) folded before Flop
Seat 2: beshece11harf (big blind) collected ($16.50)
Seat 3: boydst1 folded before Flop
Seat 4: p0pa4poker folded before Flop
Seat 5: Trojanovich folded before Flop (didn't bet)
Seat 6: tintin641 (button) folded before Flop (didn't bet)



PokerStars Hand #254537817185:  Hold'em No Limit ($0.50/$1.00 USD) - 2025/01/24 23:11:57 WET [2025/01/24 18:11:57 ET]
Table 'Merapi IV' 6-max Seat #1 is the button
Seat 1: XneferX ($100 in chips) 
Seat 2: beshece11harf ($245.30 in chips) 
Seat 3: boydst1 ($108.26 in chips) 
Seat 4: p0pa4poker ($100 in chips) 
Seat 5: Trojanovich ($440.09 in chips) 
Seat 6: tintin641 ($100 in chips) 
beshece11harf: posts small blind $0.50
boydst1: posts big blind $1
*** HOLE CARDS ***
p0pa4poker: raises $1 to $2
Trojanovich: folds 
tintin641: folds 
XneferX: folds 
beshece11harf: folds 
boydst1: calls $1
*** FLOP *** [4c 5s 9s]
boydst1: checks 
p0pa4poker: bets $1.41
boydst1: calls $1.41
*** TURN *** [4c 5s 9s] [Qd]
boydst1: checks 
p0pa4poker: bets $4.31
boydst1: calls $4.31
*** RIVER *** [4c 5s 9s Qd] [3c]
boydst1: checks 
p0pa4poker: checks 
*** SHOW DOWN ***
boydst1: shows [Ts Js] (high card Queen)
p0pa4poker: shows [Ah 8h] (high card Ace)
p0pa4poker collected $15.14 from pot
*** SUMMARY ***
Total pot $15.94 | Rake $0.80 
Board [4c 5s 9s Qd 3c]
Seat 1: XneferX (button) folded before Flop (didn't bet)
Seat 2: beshece11harf (small blind) folded before Flop
Seat 3: boydst1 (big blind) showed [Ts Js] and lost with high card Queen
Seat 4: p0pa4poker showed [Ah 8h] and won ($15.14) with high card Ace
Seat 5: Trojanovich folded before Flop (didn't bet)
Seat 6: tintin641 folded before Flop (didn't bet)



PokerStars Hand #254537838163:  Hold'em No Limit ($0.50/$1.00 USD) - 2025/01/24 23:13:13 WET [2025/01/24 18:13:13 ET]
Table 'Merapi IV' 6-max Seat #2 is the button
Seat 1: XneferX ($100 in chips) 
Seat 2: beshece11harf ($244.80 in chips) 
Seat 3: boydst1 ($100.54 in chips) 
Seat 4: p0pa4poker ($107.42 in chips) 
Seat 5: Trojanovich ($440.09 in chips) 
Seat 6: tintin641 ($100 in chips) 
boydst1: posts small blind $0.50
p0pa4poker: posts big blind $1
*** HOLE CARDS ***
Trojanovich: folds 
tintin641: folds 
XneferX: folds 
beshece11harf: folds 
boydst1: raises $2 to $3
p0pa4poker: calls $2
*** FLOP *** [8s 5c Ac]
boydst1: bets $2.85
p0pa4poker: folds 
Uncalled bet ($2.85) returned to boydst1
boydst1 collected $5.70 from pot
boydst1: doesn't show hand 
*** SUMMARY ***
Total pot $6 | Rake $0.30 
Board [8s 5c Ac]
Seat 1: XneferX folded before Flop (didn't bet)
Seat 2: beshece11harf (button) folded before Flop (didn't bet)
Seat 3: boydst1 (small blind) collected ($5.70)
Seat 4: p0pa4poker (big blind) folded on the Flop
Seat 5: Trojanovich folded before Flop (didn't bet)
Seat 6: tintin641 folded before Flop (didn't bet)



PokerStars Hand #254537846807:  Hold'em No Limit ($0.50/$1.00 USD) - 2025/01/24 23:13:44 WET [2025/01/24 18:13:44 ET]
Table 'Merapi IV' 6-max Seat #3 is the button
Seat 1: XneferX ($100 in chips) 
Seat 2: beshece11harf ($244.80 in chips) 
Seat 3: boydst1 ($103.24 in chips) 
Seat 4: p0pa4poker ($104.42 in chips) 
Seat 5: Trojanovich ($440.09 in chips) 
Seat 6: tintin641 ($100 in chips) 
p0pa4poker: posts small blind $0.50
Trojanovich: posts big blind $1
*** HOLE CARDS ***
tintin641: folds 
XneferX: folds 
beshece11harf: folds 
boydst1: folds 
p0pa4poker: folds 
Uncalled bet ($0.50) returned to Trojanovich
Trojanovich collected $1 from pot
Trojanovich: doesn't show hand 
*** SUMMARY ***
Total pot $1 | Rake $0 
Seat 1: XneferX folded before Flop (didn't bet)
Seat 2: beshece11harf folded before Flop (didn't bet)
Seat 3: boydst1 (button) folded before Flop (didn't bet)
Seat 4: p0pa4poker (small blind) folded before Flop
Seat 5: Trojanovich (big blind) collected ($1)
Seat 6: tintin641 folded before Flop (didn't bet)



PokerStars Hand #254537852134:  Hold'em No Limit ($0.50/$1.00 USD) - 2025/01/24 23:14:04 WET [2025/01/24 18:14:04 ET]
Table 'Merapi IV' 6-max Seat #4 is the button
Seat 1: XneferX ($100 in chips) 
Seat 2: beshece11harf ($244.80 in chips) 
Seat 3: boydst1 ($103.24 in chips) 
Seat 4: p0pa4poker ($103.92 in chips) 
Seat 5: Trojanovich ($440.59 in chips) 
Seat 6: tintin641 ($100 in chips) 
Trojanovich: posts small blind $0.50
tintin641: posts big blind $1
*** HOLE CARDS ***
XneferX: folds 
beshece11harf: folds 
boydst1: raises $1 to $2
p0pa4poker: folds 
Trojanovich: folds 
tintin641: folds 
Uncalled bet ($1) returned to boydst1
boydst1 collected $2.50 from pot
boydst1: doesn't show hand 
*** SUMMARY ***
Total pot $2.50 | Rake $0 
Seat 1: XneferX folded before Flop (didn't bet)
Seat 2: beshece11harf folded before Flop (didn't bet)
Seat 3: boydst1 collected ($2.50)
Seat 4: p0pa4poker (button) folded before Flop (didn't bet)
Seat 5: Trojanovich (small blind) folded before Flop
Seat 6: tintin641 (big blind) folded before Flop



PokerStars Hand #254537856348:  Hold'em No Limit ($0.50/$1.00 USD) - 2025/01/24 23:14:19 WET [2025/01/24 18:14:19 ET]
Table 'Merapi IV' 6-max Seat #5 is the button
Seat 1: XneferX ($100 in chips) 
Seat 2: beshece11harf ($244.80 in chips) 
Seat 3: boydst1 ($104.74 in chips) 
Seat 4: p0pa4poker ($103.92 in chips) 
Seat 5: Trojanovich ($440.09 in chips) 
Seat 6: tintin641 ($100 in chips) 
tintin641: posts small blind $0.50
XneferX: posts big blind $1
*** HOLE CARDS ***
beshece11harf: folds 
boydst1: folds 
p0pa4poker: raises $1.30 to $2.30
Trojanovich: folds 
tintin641: folds 
XneferX: calls $1.30
*** FLOP *** [As 5c 3h]
XneferX: checks 
p0pa4poker: checks 
*** TURN *** [As 5c 3h] [6d]
XneferX: bets $3.73
p0pa4poker: folds 
Uncalled bet ($3.73) returned to XneferX
XneferX collected $4.84 from pot
XneferX: doesn't show hand 
*** SUMMARY ***
Total pot $5.10 | Rake $0.26 
Board [As 5c 3h 6d]
Seat 1: XneferX (big blind) collected ($4.84)
Seat 2: beshece11harf folded before Flop (didn't bet)
Seat 3: boydst1 folded before Flop (didn't bet)
Seat 4: p0pa4poker folded on the Turn
Seat 5: Trojanovich (button) folded before Flop (didn't bet)
Seat 6: tintin641 (small blind) folded before Flop



PokerStars Hand #254537986576:  Hold'em No Limit ($0.50/$1.00 USD) - 2025/01/24 23:22:16 WET [2025/01/24 18:22:16 ET]
Table 'Merapi IV' 6-max Seat #3 is the button
Seat 1: XneferX ($100.04 in chips) 
Seat 2: beshece11harf ($248.04 in chips) 
Seat 3: boydst1 ($79.39 in chips) 
Seat 4: p0pa4poker ($114.46 in chips) 
Seat 5: Trojanovich ($438.02 in chips) 
Seat 6: tintin641 ($110.80 in chips) 
p0pa4poker: posts small blind $0.50
Trojanovich: posts big blind $1
*** HOLE CARDS ***
tintin641: folds 
XneferX: folds 
beshece11harf: folds 
boydst1: raises $1 to $2
p0pa4poker: raises $7 to $9
Trojanovich: folds 
boydst1: calls $7
*** FLOP *** [4c 5h 4s]
p0pa4poker: checks 
boydst1: bets $9.03
p0pa4poker: calls $9.03
*** TURN *** [4c 5h 4s] [6s]
p0pa4poker: checks 
boydst1: bets $14.61
p0pa4poker: raises $81.82 to $96.43 and is all-in
boydst1: folds 
Uncalled bet ($81.82) returned to p0pa4poker
p0pa4poker collected $63.78 from pot
p0pa4poker: doesn't show hand 
*** SUMMARY ***
Total pot $66.28 | Rake $2.50 
Board [4c 5h 4s 6s]
Seat 1: XneferX folded before Flop (didn't bet)
Seat 2: beshece11harf folded before Flop (didn't bet)
Seat 3: boydst1 (button) folded on the Turn
Seat 4: p0pa4poker (small blind) collected ($63.78)
Seat 5: Trojanovich (big blind) folded before Flop
Seat 6: tintin641 folded before Flop (didn't bet)



PokerStars Hand #254538022805:  Hold'em No Limit ($0.50/$1.00 USD) - 2025/01/24 23:24:28 WET [2025/01/24 18:24:28 ET]
Table 'Merapi IV' 6-max Seat #4 is the button
Seat 1: XneferX ($100.04 in chips) 
Seat 2: beshece11harf ($248.04 in chips) 
Seat 3: boydst1 ($46.75 in chips) 
Seat 4: p0pa4poker ($145.60 in chips) 
Seat 5: Trojanovich ($437.02 in chips) 
Seat 6: tintin641 ($110.80 in chips) 
Trojanovich: posts small blind $0.50
tintin641: posts big blind $1
*** HOLE CARDS ***
XneferX: folds 
beshece11harf: folds 
boydst1: raises $1 to $2
p0pa4poker: folds 
Trojanovich: folds 
tintin641: folds 
Uncalled bet ($1) returned to boydst1
boydst1 collected $2.50 from pot
boydst1: doesn't show hand 
*** SUMMARY ***
Total pot $2.50 | Rake $0 
Seat 1: XneferX folded before Flop (didn't bet)
Seat 2: beshece11harf folded before Flop (didn't bet)
Seat 3: boydst1 collected ($2.50)
Seat 4: p0pa4poker (button) folded before Flop (didn't bet)
Seat 5: Trojanovich (small blind) folded before Flop
Seat 6: tintin641 (big blind) folded before Flop



PokerStars Hand #254538030356:  Hold'em No Limit ($0.50/$1.00 USD) - 2025/01/24 23:24:55 WET [2025/01/24 18:24:55 ET]
Table 'Merapi IV' 6-max Seat #5 is the button
Seat 1: XneferX ($100.04 in chips) 
Seat 2: beshece11harf ($248.04 in chips) 
Seat 3: boydst1 ($48.25 in chips) 
Seat 4: p0pa4poker ($145.60 in chips) 
Seat 5: Trojanovich ($436.52 in chips) 
Seat 6: tintin641 ($109.80 in chips) 
tintin641: posts small blind $0.50
XneferX: posts big blind $1
*** HOLE CARDS ***
beshece11harf: folds 
boydst1: calls $1
p0pa4poker: folds 
Trojanovich: folds 
tintin641: calls $0.50
XneferX: checks 
*** FLOP *** [Kc 4d Td]
tintin641: checks 
XneferX: checks 
boydst1: checks 
*** TURN *** [Kc 4d Td] [Ad]
tintin641: checks 
XneferX: bets $3.33
boydst1: folds 
tintin641: folds 
Uncalled bet ($3.33) returned to XneferX
XneferX collected $2.85 from pot
XneferX: doesn't show hand 
*** SUMMARY ***
Total pot $3 | Rake $0.15 
Board [Kc 4d Td Ad]
Seat 1: XneferX (big blind) collected ($2.85)
Seat 2: beshece11harf folded before Flop (didn't bet)
Seat 3: boydst1 folded on the Turn
Seat 4: p0pa4poker folded before Flop (didn't bet)
Seat 5: Trojanovich (button) folded before Flop (didn't bet)
Seat 6: tintin641 (small blind) folded on the Turn



PokerStars Hand #254538044229:  Hold'em No Limit ($0.50/$1.00 USD) - 2025/01/24 23:25:45 WET [2025/01/24 18:25:45 ET]
Table 'Merapi IV' 6-max Seat #6 is the button
Seat 1: XneferX ($101.89 in chips) 
Seat 2: beshece11harf ($248.04 in chips) 
Seat 3: boydst1 ($47.25 in chips) 
Seat 4: p0pa4poker ($145.60 in chips) 
Seat 5: Trojanovich ($436.52 in chips) 
Seat 6: tintin641 ($108.80 in chips) 
XneferX: posts small blind $0.50
beshece11harf: posts big blind $1
*** HOLE CARDS ***
boydst1: folds 
p0pa4poker: folds 
Trojanovich: folds 
tintin641: raises $1.50 to $2.50
XneferX: folds 
beshece11harf: folds 
Uncalled bet ($1.50) returned to tintin641
tintin641 collected $2.50 from pot
tintin641: doesn't show hand 
*** SUMMARY ***
Total pot $2.50 | Rake $0 
Seat 1: XneferX (small blind) folded before Flop
Seat 2: beshece11harf (big blind) folded before Flop
Seat 3: boydst1 folded before Flop (didn't bet)
Seat 4: p0pa4poker folded before Flop (didn't bet)
Seat 5: Trojanovich folded before Flop (didn't bet)
Seat 6: tintin641 (button) collected ($2.50)



PokerStars Hand #254538051579:  Hold'em No Limit ($0.50/$1.00 USD) - 2025/01/24 23:26:12 WET [2025/01/24 18:26:12 ET]
Table 'Merapi IV' 6-max Seat #1 is the button
Seat 1: XneferX ($101.39 in chips) 
Seat 2: beshece11harf ($247.04 in chips) 
Seat 3: boydst1 ($100 in chips) 
Seat 4: p0pa4poker ($145.60 in chips) 
Seat 5: Trojanovich ($436.52 in chips) 
Seat 6: tintin641 ($110.30 in chips) 
beshece11harf: posts small blind $0.50
boydst1: posts big blind $1
*** HOLE CARDS ***
p0pa4poker: raises $1 to $2
Trojanovich: folds 
tintin641: folds 
XneferX: calls $2
beshece11harf: folds 
boydst1: calls $1
*** FLOP *** [7s Qs 9c]
boydst1: bets $2
p0pa4poker: calls $2
XneferX: calls $2
*** TURN *** [7s Qs 9c] [9d]
boydst1: bets $5.94
p0pa4poker: calls $5.94
XneferX: folds 
*** RIVER *** [7s Qs 9c 9d] [Kh]
boydst1: bets $5
p0pa4poker: raises $26 to $31
boydst1: folds 
Uncalled bet ($26) returned to p0pa4poker
p0pa4poker collected $32.66 from pot
p0pa4poker: doesn't show hand 
*** SUMMARY ***
Total pot $34.38 | Rake $1.72 
Board [7s Qs 9c 9d Kh]
Seat 1: XneferX (button) folded on the Turn
Seat 2: beshece11harf (small blind) folded before Flop
Seat 3: boydst1 (big blind) folded on the River
Seat 4: p0pa4poker collected ($32.66)
Seat 5: Trojanovich folded before Flop (didn't bet)
Seat 6: tintin641 folded before Flop (didn't bet)



PokerStars Hand #254538090139:  Hold'em No Limit ($0.50/$1.00 USD) - 2025/01/24 23:28:32 WET [2025/01/24 18:28:32 ET]
Table 'Merapi IV' 6-max Seat #2 is the button
Seat 1: XneferX ($100 in chips) 
Seat 2: beshece11harf ($246.54 in chips) 
Seat 3: boydst1 ($85.06 in chips) 
Seat 4: p0pa4poker ($163.32 in chips) 
Seat 5: Trojanovich ($436.52 in chips) 
Seat 6: tintin641 ($110.30 in chips) 
boydst1: posts small blind $0.50
p0pa4poker: posts big blind $1
*** HOLE CARDS ***
Trojanovich: folds 
tintin641: folds 
XneferX: folds 
beshece11harf: folds 
boydst1: calls $0.50
p0pa4poker: raises $2 to $3
boydst1: calls $2
*** FLOP *** [3c Kh 2d]
boydst1: checks 
p0pa4poker: bets $1.88
boydst1: calls $1.88
*** TURN *** [3c Kh 2d] [2c]
boydst1: checks 
p0pa4poker: checks 
*** RIVER *** [3c Kh 2d 2c] [6h]
boydst1: bets $4.64
p0pa4poker: calls $4.64
*** SHOW DOWN ***
boydst1: shows [6d Kc] (two pair, Kings and Sixes)
p0pa4poker: mucks hand 
boydst1 collected $18.09 from pot
*** SUMMARY ***
Total pot $19.04 | Rake $0.95 
Board [3c Kh 2d 2c 6h]
Seat 1: XneferX folded before Flop (didn't bet)
Seat 2: beshece11harf (button) folded before Flop (didn't bet)
Seat 3: boydst1 (small blind) showed [6d Kc] and won ($18.09) with two pair, Kings and Sixes
Seat 4: p0pa4poker (big blind) mucked
Seat 5: Trojanovich folded before Flop (didn't bet)
Seat 6: tintin641 folded before Flop (didn't bet)



PokerStars Hand #254538109008:  Hold'em No Limit ($0.50/$1.00 USD) - 2025/01/24 23:29:41 WET [2025/01/24 18:29:41 ET]
Table 'Merapi IV' 6-max Seat #3 is the button
Seat 1: XneferX ($100 in chips) 
Seat 2: beshece11harf ($246.54 in chips) 
Seat 3: boydst1 ($93.63 in chips) 
Seat 4: p0pa4poker ($153.80 in chips) 
Seat 5: Trojanovich ($436.52 in chips) 
Seat 6: tintin641 ($110.30 in chips) 
p0pa4poker: posts small blind $0.50
Trojanovich: posts big blind $1
*** HOLE CARDS ***
tintin641: folds 
XneferX: folds 
beshece11harf: folds 
boydst1: folds 
p0pa4poker: folds 
Uncalled bet ($0.50) returned to Trojanovich
Trojanovich collected $1 from pot
Trojanovich: doesn't show hand 
*** SUMMARY ***
Total pot $1 | Rake $0 
Seat 1: XneferX folded before Flop (didn't bet)
Seat 2: beshece11harf folded before Flop (didn't bet)
Seat 3: boydst1 (button) folded before Flop (didn't bet)
Seat 4: p0pa4poker (small blind) folded before Flop
Seat 5: Trojanovich (big blind) collected ($1)
Seat 6: tintin641 folded before Flop (didn't bet)



PokerStars Hand #254538112858:  Hold'em No Limit ($0.50/$1.00 USD) - 2025/01/24 23:29:55 WET [2025/01/24 18:29:55 ET]
Table 'Merapi IV' 6-max Seat #4 is the button
Seat 1: XneferX ($100 in chips) 
Seat 2: beshece11harf ($246.54 in chips) 
Seat 3: boydst1 ($93.63 in chips) 
Seat 4: p0pa4poker ($153.30 in chips) 
Seat 5: Trojanovich ($437.02 in chips) 
Seat 6: tintin641 ($110.30 in chips) 
Trojanovich: posts small blind $0.50
tintin641: posts big blind $1
*** HOLE CARDS ***
XneferX: raises $1.10 to $2.10
beshece11harf: folds 
boydst1: folds 
p0pa4poker: folds 
Trojanovich: folds 
tintin641: folds 
Uncalled bet ($1.10) returned to XneferX
XneferX collected $2.50 from pot
XneferX: doesn't show hand 
*** SUMMARY ***
Total pot $2.50 | Rake $0 
Seat 1: XneferX collected ($2.50)
Seat 2: beshece11harf folded before Flop (didn't bet)
Seat 3: boydst1 folded before Flop (didn't bet)
Seat 4: p0pa4poker (button) folded before Flop (didn't bet)
Seat 5: Trojanovich (small blind) folded before Flop
Seat 6: tintin641 (big blind) folded before Flop



PokerStars Hand #254538117828:  Hold'em No Limit ($0.50/$1.00 USD) - 2025/01/24 23:30:13 WET [2025/01/24 18:30:13 ET]
Table 'Merapi IV' 6-max Seat #5 is the button
Seat 1: XneferX ($101.50 in chips) 
Seat 2: beshece11harf ($246.54 in chips) 
Seat 3: boydst1 ($93.63 in chips) 
Seat 4: p0pa4poker ($153.30 in chips) 
Seat 5: Trojanovich ($436.52 in chips) 
Seat 6: tintin641 ($109.30 in chips) 
tintin641: posts small blind $0.50
XneferX: posts big blind $1
*** HOLE CARDS ***
beshece11harf: folds 
boydst1: folds 
p0pa4poker: folds 
Trojanovich: folds 
tintin641: raises $2 to $3
XneferX: calls $2
*** FLOP *** [6d Ac Ks]
tintin641: bets $1.88
XneferX: calls $1.88
*** TURN *** [6d Ac Ks] [3c]
tintin641: checks 
XneferX: checks 
*** RIVER *** [6d Ac Ks 3c] [Tc]
tintin641: checks 
XneferX: bets $3.15
tintin641: folds 
Uncalled bet ($3.15) returned to XneferX
XneferX collected $9.27 from pot
XneferX: doesn't show hand 
*** SUMMARY ***
Total pot $9.76 | Rake $0.49 
Board [6d Ac Ks 3c Tc]
Seat 1: XneferX (big blind) collected ($9.27)
Seat 2: beshece11harf folded before Flop (didn't bet)
Seat 3: boydst1 folded before Flop (didn't bet)
Seat 4: p0pa4poker folded before Flop (didn't bet)
Seat 5: Trojanovich (button) folded before Flop (didn't bet)
Seat 6: tintin641 (small blind) folded on the River



PokerStars Hand #254538136566:  Hold'em No Limit ($0.50/$1.00 USD) - 2025/01/24 23:31:21 WET [2025/01/24 18:31:21 ET]
Table 'Merapi IV' 6-max Seat #6 is the button
Seat 1: XneferX ($105.89 in chips) 
Seat 2: beshece11harf ($246.54 in chips) 
Seat 3: boydst1 ($93.63 in chips) 
Seat 4: p0pa4poker ($153.30 in chips) 
Seat 5: Trojanovich ($436.52 in chips) 
Seat 6: tintin641 ($104.42 in chips) 
XneferX: posts small blind $0.50
beshece11harf: posts big blind $1
*** HOLE CARDS ***
boydst1: folds 
p0pa4poker: folds 
Trojanovich: folds 
tintin641: raises $1.50 to $2.50
XneferX: folds 
beshece11harf: calls $1.50
*** FLOP *** [Kc As 5c]
beshece11harf: checks 
tintin641: checks 
*** TURN *** [Kc As 5c] [Td]
beshece11harf: checks 
tintin641: checks 
*** RIVER *** [Kc As 5c Td] [Jh]
beshece11harf: bets $3.92
tintin641: calls $3.92
*** SHOW DOWN ***
beshece11harf: shows [9s 6s] (high card Ace)
tintin641: shows [Kh Js] (two pair, Kings and Jacks)
tintin641 collected $12.67 from pot
*** SUMMARY ***
Total pot $13.34 | Rake $0.67 
Board [Kc As 5c Td Jh]
Seat 1: XneferX (small blind) folded before Flop
Seat 2: beshece11harf (big blind) showed [9s 6s] and lost with high card Ace
Seat 3: boydst1 folded before Flop (didn't bet)
Seat 4: p0pa4poker folded before Flop (didn't bet)
Seat 5: Trojanovich folded before Flop (didn't bet)
Seat 6: tintin641 (button) showed [Kh Js] and won ($12.67) with two pair, Kings and Jacks



PokerStars Hand #254538160865:  Hold'em No Limit ($0.50/$1.00 USD) - 2025/01/24 23:32:50 WET [2025/01/24 18:32:50 ET]
Table 'Merapi IV' 6-max Seat #1 is the button
Seat 1: XneferX ($105.39 in chips) 
Seat 2: beshece11harf ($240.12 in chips) 
Seat 3: boydst1 ($93.63 in chips) 
Seat 4: p0pa4poker ($153.30 in chips) 
Seat 5: Trojanovich ($436.52 in chips) 
Seat 6: tintin641 ($110.67 in chips) 
beshece11harf: posts small blind $0.50
boydst1: posts big blind $1
*** HOLE CARDS ***
p0pa4poker: raises $1 to $2
Trojanovich: folds 
tintin641: folds 
XneferX: folds 
beshece11harf: folds 
boydst1: calls $1
*** FLOP *** [Qc 5h Td]
boydst1: checks 
p0pa4poker: bets $1.41
boydst1: calls $1.41
*** TURN *** [Qc 5h Td] [9s]
boydst1: checks 
p0pa4poker: bets $5.35
boydst1: folds 
Uncalled bet ($5.35) returned to p0pa4poker
p0pa4poker collected $6.95 from pot
p0pa4poker: doesn't show hand 
*** SUMMARY ***
Total pot $7.32 | Rake $0.37 
Board [Qc 5h Td 9s]
Seat 1: XneferX (button) folded before Flop (didn't bet)
Seat 2: beshece11harf (small blind) folded before Flop
Seat 3: boydst1 (big blind) folded on the Turn
Seat 4: p0pa4poker collected ($6.95)
Seat 5: Trojanovich folded before Flop (didn't bet)
Seat 6: tintin641 folded before Flop (didn't bet)



PokerStars Hand #254538180833:  Hold'em No Limit ($0.50/$1.00 USD) - 2025/01/24 23:34:03 WET [2025/01/24 18:34:03 ET]
Table 'Merapi IV' 6-max Seat #2 is the button
Seat 1: XneferX ($105.39 in chips) 
Seat 2: beshece11harf ($239.62 in chips) 
Seat 3: boydst1 ($90.22 in chips) 
Seat 4: p0pa4poker ($156.84 in chips) 
Seat 5: Trojanovich ($436.52 in chips) 
Seat 6: tintin641 ($110.67 in chips) 
boydst1: posts small blind $0.50
p0pa4poker: posts big blind $1
*** HOLE CARDS ***
Trojanovich: folds 
tintin641: folds 
XneferX: folds 
beshece11harf: folds 
boydst1: calls $0.50
p0pa4poker: raises $4 to $5
boydst1: calls $4
*** FLOP *** [9s 4s Js]
boydst1: checks 
p0pa4poker: bets $4.75
boydst1: calls $4.75
*** TURN *** [9s 4s Js] [8h]
boydst1: checks 
p0pa4poker has timed out
p0pa4poker: checks 
*** RIVER *** [9s 4s Js 8h] [6h]
boydst1: bets $9.26
p0pa4poker: calls $9.26
*** SHOW DOWN ***
boydst1: shows [Ks Th] (high card King)
p0pa4poker: shows [Kc Kh] (a pair of Kings)
p0pa4poker collected $36.12 from pot
*** SUMMARY ***
Total pot $38.02 | Rake $1.90 
Board [9s 4s Js 8h 6h]
Seat 1: XneferX folded before Flop (didn't bet)
Seat 2: beshece11harf (button) folded before Flop (didn't bet)
Seat 3: boydst1 (small blind) showed [Ks Th] and lost with high card King
Seat 4: p0pa4poker (big blind) showed [Kc Kh] and won ($36.12) with a pair of Kings
Seat 5: Trojanovich folded before Flop (didn't bet)
Seat 6: tintin641 folded before Flop (didn't bet)



PokerStars Hand #254538207705:  Hold'em No Limit ($0.50/$1.00 USD) - 2025/01/24 23:35:42 WET [2025/01/24 18:35:42 ET]
Table 'Merapi IV' 6-max Seat #3 is the button
Seat 1: XneferX ($105.39 in chips) 
Seat 2: beshece11harf ($239.62 in chips) 
Seat 3: boydst1 ($71.21 in chips) 
Seat 4: p0pa4poker ($173.95 in chips) 
Seat 5: Trojanovich ($436.52 in chips) 
Seat 6: tintin641 ($110.67 in chips) 
p0pa4poker: posts small blind $0.50
Trojanovich: posts big blind $1
*** HOLE CARDS ***
tintin641: folds 
XneferX: raises $1.10 to $2.10
beshece11harf: folds 
boydst1: calls $2.10
p0pa4poker: folds 
Trojanovich: folds 
*** FLOP *** [Ac Jc 3c]
XneferX: bets $1.20
boydst1: folds 
Uncalled bet ($1.20) returned to XneferX
XneferX collected $5.42 from pot
XneferX: doesn't show hand 
*** SUMMARY ***
Total pot $5.70 | Rake $0.28 
Board [Ac Jc 3c]
Seat 1: XneferX collected ($5.42)
Seat 2: beshece11harf folded before Flop (didn't bet)
Seat 3: boydst1 (button) folded on the Flop
Seat 4: p0pa4poker (small blind) folded before Flop
Seat 5: Trojanovich (big blind) folded before Flop
Seat 6: tintin641 folded before Flop (didn't bet)



PokerStars Hand #254538214615:  Hold'em No Limit ($0.50/$1.00 USD) - 2025/01/24 23:36:07 WET [2025/01/24 18:36:07 ET]
Table 'Merapi IV' 6-max Seat #4 is the button
Seat 1: XneferX ($108.71 in chips) 
Seat 2: beshece11harf ($239.62 in chips) 
Seat 3: boydst1 ($69.11 in chips) 
Seat 4: p0pa4poker ($173.45 in chips) 
Seat 5: Trojanovich ($435.52 in chips) 
Seat 6: tintin641 ($110.67 in chips) 
Trojanovich: posts small blind $0.50
tintin641: posts big blind $1
*** HOLE CARDS ***
XneferX: raises $1.10 to $2.10
beshece11harf: folds 
boydst1: folds 
p0pa4poker: folds 
Trojanovich: folds 
tintin641: folds 
Uncalled bet ($1.10) returned to XneferX
XneferX collected $2.50 from pot
XneferX: doesn't show hand 
*** SUMMARY ***
Total pot $2.50 | Rake $0 
Seat 1: XneferX collected ($2.50)
Seat 2: beshece11harf folded before Flop (didn't bet)
Seat 3: boydst1 folded before Flop (didn't bet)
Seat 4: p0pa4poker (button) folded before Flop (didn't bet)
Seat 5: Trojanovich (small blind) folded before Flop
Seat 6: tintin641 (big blind) folded before Flop



PokerStars Hand #254538218380:  Hold'em No Limit ($0.50/$1.00 USD) - 2025/01/24 23:36:21 WET [2025/01/24 18:36:21 ET]
Table 'Merapi IV' 6-max Seat #5 is the button
Seat 1: XneferX ($110.21 in chips) 
Seat 2: beshece11harf ($239.62 in chips) 
Seat 3: boydst1 ($69.11 in chips) 
Seat 4: p0pa4poker ($173.45 in chips) 
Seat 5: Trojanovich ($435.02 in chips) 
Seat 6: tintin641 ($109.67 in chips) 
tintin641: posts small blind $0.50
XneferX: posts big blind $1
*** HOLE CARDS ***
beshece11harf: folds 
boydst1: raises $1 to $2
p0pa4poker: raises $4 to $6
Trojanovich: raises $7 to $13
tintin641: folds 
XneferX: folds 
boydst1: folds 
p0pa4poker: calls $7
*** FLOP *** [8d 2h Ad]
p0pa4poker: checks 
Trojanovich: bets $9.25
p0pa4poker: folds 
Uncalled bet ($9.25) returned to Trojanovich
Trojanovich collected $28.02 from pot
Trojanovich: doesn't show hand 
*** SUMMARY ***
Total pot $29.50 | Rake $1.48 
Board [8d 2h Ad]
Seat 1: XneferX (big blind) folded before Flop
Seat 2: beshece11harf folded before Flop (didn't bet)
Seat 3: boydst1 folded before Flop
Seat 4: p0pa4poker folded on the Flop
Seat 5: Trojanovich (button) collected ($28.02)
Seat 6: tintin641 (small blind) folded before Flop



PokerStars Hand #254538230865:  Hold'em No Limit ($0.50/$1.00 USD) - 2025/01/24 23:37:08 WET [2025/01/24 18:37:08 ET]
Table 'Merapi IV' 6-max Seat #6 is the button
Seat 1: XneferX ($109.21 in chips) 
Seat 2: beshece11harf ($239.62 in chips) 
Seat 3: boydst1 ($80.51 in chips) 
Seat 4: p0pa4poker ($160.45 in chips) 
Seat 5: Trojanovich ($450.04 in chips) 
Seat 6: tintin641 ($109.17 in chips) 
XneferX: posts small blind $0.50
beshece11harf: posts big blind $1
*** HOLE CARDS ***
boydst1: folds 
p0pa4poker: folds 
Trojanovich: folds 
tintin641: folds 
XneferX: folds 
Uncalled bet ($0.50) returned to beshece11harf
beshece11harf collected $1 from pot
beshece11harf: doesn't show hand 
*** SUMMARY ***
Total pot $1 | Rake $0 
Seat 1: XneferX (small blind) folded before Flop
Seat 2: beshece11harf (big blind) collected ($1)
Seat 3: boydst1 folded before Flop (didn't bet)
Seat 4: p0pa4poker folded before Flop (didn't bet)
Seat 5: Trojanovich folded before Flop (didn't bet)
Seat 6: tintin641 (button) folded before Flop (didn't bet)



PokerStars Hand #254538234313:  Hold'em No Limit ($0.50/$1.00 USD) - 2025/01/24 23:37:21 WET [2025/01/24 18:37:21 ET]
Table 'Merapi IV' 6-max Seat #1 is the button
Seat 1: XneferX ($108.71 in chips) 
Seat 2: beshece11harf ($240.12 in chips) 
Seat 3: boydst1 ($80.51 in chips) 
Seat 4: p0pa4poker ($160.45 in chips) 
Seat 5: Trojanovich ($450.04 in chips) 
Seat 6: tintin641 ($109.17 in chips) 
beshece11harf: posts small blind $0.50
boydst1: posts big blind $1
*** HOLE CARDS ***
p0pa4poker: raises $1 to $2
Trojanovich: folds 
tintin641: folds 
XneferX: calls $2
beshece11harf: folds 
boydst1: folds 
*** FLOP *** [5h Qc 2d]
p0pa4poker: bets $1.72
XneferX: calls $1.72
*** TURN *** [5h Qc 2d] [8d]
p0pa4poker: checks 
XneferX: bets $9.93
p0pa4poker: folds 
Uncalled bet ($9.93) returned to XneferX
XneferX collected $8.49 from pot
XneferX: doesn't show hand 
*** SUMMARY ***
Total pot $8.94 | Rake $0.45 
Board [5h Qc 2d 8d]
Seat 1: XneferX (button) collected ($8.49)
Seat 2: beshece11harf (small blind) folded before Flop
Seat 3: boydst1 (big blind) folded before Flop
Seat 4: p0pa4poker folded on the Turn
Seat 5: Trojanovich folded before Flop (didn't bet)
Seat 6: tintin641 folded before Flop (didn't bet)



PokerStars Hand #254538254867:  Hold'em No Limit ($0.50/$1.00 USD) - 2025/01/24 23:38:38 WET [2025/01/24 18:38:38 ET]
Table 'Merapi IV' 6-max Seat #2 is the button
Seat 1: XneferX ($113.48 in chips) 
Seat 2: beshece11harf ($239.62 in chips) 
Seat 3: boydst1 ($79.51 in chips) 
Seat 4: p0pa4poker ($156.73 in chips) 
Seat 5: Trojanovich ($450.04 in chips) 
Seat 6: tintin641 ($109.17 in chips) 
boydst1: posts small blind $0.50
p0pa4poker: posts big blind $1
*** HOLE CARDS ***
Trojanovich: folds 
tintin641: raises $1.50 to $2.50
XneferX: folds 
beshece11harf: folds 
boydst1: folds 
p0pa4poker: folds 
Uncalled bet ($1.50) returned to tintin641
tintin641 collected $2.50 from pot
tintin641: doesn't show hand 
*** SUMMARY ***
Total pot $2.50 | Rake $0 
Seat 1: XneferX folded before Flop (didn't bet)
Seat 2: beshece11harf (button) folded before Flop (didn't bet)
Seat 3: boydst1 (small blind) folded before Flop
Seat 4: p0pa4poker (big blind) folded before Flop
Seat 5: Trojanovich folded before Flop (didn't bet)
Seat 6: tintin641 collected ($2.50)



PokerStars Hand #254538259237:  Hold'em No Limit ($0.50/$1.00 USD) - 2025/01/24 23:38:54 WET [2025/01/24 18:38:54 ET]
Table 'Merapi IV' 6-max Seat #3 is the button
Seat 1: XneferX ($113.48 in chips) 
Seat 2: beshece11harf ($239.62 in chips) 
Seat 3: boydst1 ($79.01 in chips) 
Seat 4: p0pa4poker ($155.73 in chips) 
Seat 5: Trojanovich ($450.04 in chips) 
Seat 6: tintin641 ($110.67 in chips) 
p0pa4poker: posts small blind $0.50
Trojanovich: posts big blind $1
*** HOLE CARDS ***
tintin641: folds 
XneferX: folds 
beshece11harf: folds 
boydst1: folds 
p0pa4poker: folds 
Uncalled bet ($0.50) returned to Trojanovich
Trojanovich collected $1 from pot
Trojanovich: doesn't show hand 
*** SUMMARY ***
Total pot $1 | Rake $0 
Seat 1: XneferX folded before Flop (didn't bet)
Seat 2: beshece11harf folded before Flop (didn't bet)
Seat 3: boydst1 (button) folded before Flop (didn't bet)
Seat 4: p0pa4poker (small blind) folded before Flop
Seat 5: Trojanovich (big blind) collected ($1)
Seat 6: tintin641 folded before Flop (didn't bet)



PokerStars Hand #254538263722:  Hold'em No Limit ($0.50/$1.00 USD) - 2025/01/24 23:39:11 WET [2025/01/24 18:39:11 ET]
Table 'Merapi IV' 6-max Seat #4 is the button
Seat 1: XneferX ($113.48 in chips) 
Seat 2: beshece11harf ($239.62 in chips) 
Seat 3: boydst1 ($79.01 in chips) 
Seat 4: p0pa4poker ($155.23 in chips) 
Seat 5: Trojanovich ($450.54 in chips) 
Seat 6: tintin641 ($110.67 in chips) 
Trojanovich: posts small blind $0.50
tintin641: posts big blind $1
*** HOLE CARDS ***
XneferX: folds 
beshece11harf: folds 
boydst1: calls $1
p0pa4poker: folds 
Trojanovich: raises $5 to $6
tintin641: folds 
boydst1: calls $5
*** FLOP *** [9c 8d 6d]
Trojanovich: checks 
boydst1: checks 
*** TURN *** [9c 8d 6d] [Jc]
Trojanovich: bets $9.26
boydst1: calls $9.26
*** RIVER *** [9c 8d 6d Jc] [Qc]
Trojanovich: bets $9.88
boydst1: raises $9.88 to $19.76
Trojanovich: calls $9.88
*** SHOW DOWN ***
boydst1: shows [Tc Qd] (a straight, Eight to Queen)
Trojanovich: mucks hand 
boydst1 collected $68.54 from pot
*** SUMMARY ***
Total pot $71.04 | Rake $2.50 
Board [9c 8d 6d Jc Qc]
Seat 1: XneferX folded before Flop (didn't bet)
Seat 2: beshece11harf folded before Flop (didn't bet)
Seat 3: boydst1 showed [Tc Qd] and won ($68.54) with a straight, Eight to Queen
Seat 4: p0pa4poker (button) folded before Flop (didn't bet)
Seat 5: Trojanovich (small blind) mucked
Seat 6: tintin641 (big blind) folded before Flop



PokerStars Hand #254538283529:  Hold'em No Limit ($0.50/$1.00 USD) - 2025/01/24 23:40:25 WET [2025/01/24 18:40:25 ET]
Table 'Merapi IV' 6-max Seat #5 is the button
Seat 1: XneferX ($113.48 in chips) 
Seat 2: beshece11harf ($239.62 in chips) 
Seat 3: boydst1 ($112.53 in chips) 
Seat 4: p0pa4poker ($155.23 in chips) 
Seat 5: Trojanovich ($415.52 in chips) 
Seat 6: tintin641 ($109.67 in chips) 
tintin641: posts small blind $0.50
XneferX: posts big blind $1
*** HOLE CARDS ***
beshece11harf: folds 
boydst1: folds 
p0pa4poker: folds 
Trojanovich: raises $1.50 to $2.50
tintin641: folds 
XneferX: folds 
Uncalled bet ($1.50) returned to Trojanovich
Trojanovich collected $2.50 from pot
Trojanovich: doesn't show hand 
*** SUMMARY ***
Total pot $2.50 | Rake $0 
Seat 1: XneferX (big blind) folded before Flop
Seat 2: beshece11harf folded before Flop (didn't bet)
Seat 3: boydst1 folded before Flop (didn't bet)
Seat 4: p0pa4poker folded before Flop (didn't bet)
Seat 5: Trojanovich (button) collected ($2.50)
Seat 6: tintin641 (small blind) folded before Flop



PokerStars Hand #254538288924:  Hold'em No Limit ($0.50/$1.00 USD) - 2025/01/24 23:40:45 WET [2025/01/24 18:40:45 ET]
Table 'Merapi IV' 6-max Seat #6 is the button
Seat 1: XneferX ($112.48 in chips) 
Seat 2: beshece11harf ($239.62 in chips) 
Seat 3: boydst1 ($112.53 in chips) 
Seat 4: p0pa4poker ($155.23 in chips) 
Seat 5: Trojanovich ($417.02 in chips) 
Seat 6: tintin641 ($109.17 in chips) 
XneferX: posts small blind $0.50
beshece11harf: posts big blind $1
*** HOLE CARDS ***
boydst1: calls $1
p0pa4poker: folds 
Trojanovich: folds 
tintin641: raises $3 to $4
XneferX: folds 
beshece11harf: folds 
boydst1: calls $3
*** FLOP *** [Jh 8c Kh]
boydst1: checks 
tintin641: bets $2.98
boydst1: calls $2.98
*** TURN *** [Jh 8c Kh] [Ah]
boydst1: checks 
tintin641: checks 
*** RIVER *** [Jh 8c Kh Ah] [Qh]
boydst1: bets $7.35
tintin641: calls $7.35
*** SHOW DOWN ***
boydst1: shows [3d 3h] (a flush, Ace high)
tintin641: mucks hand 
boydst1 collected $28.65 from pot
*** SUMMARY ***
Total pot $30.16 | Rake $1.51 
Board [Jh 8c Kh Ah Qh]
Seat 1: XneferX (small blind) folded before Flop
Seat 2: beshece11harf (big blind) folded before Flop
Seat 3: boydst1 showed [3d 3h] and won ($28.65) with a flush, Ace high
Seat 4: p0pa4poker folded before Flop (didn't bet)
Seat 5: Trojanovich folded before Flop (didn't bet)
Seat 6: tintin641 (button) mucked



PokerStars Hand #254538305065:  Hold'em No Limit ($0.50/$1.00 USD) - 2025/01/24 23:41:47 WET [2025/01/24 18:41:47 ET]
Table 'Merapi IV' 6-max Seat #1 is the button
Seat 1: XneferX ($111.98 in chips) 
Seat 2: beshece11harf ($238.62 in chips) 
Seat 3: boydst1 ($126.85 in chips) 
Seat 4: p0pa4poker ($155.23 in chips) 
Seat 5: Trojanovich ($417.02 in chips) 
Seat 6: tintin641 ($100 in chips) 
beshece11harf: posts small blind $0.50
boydst1: posts big blind $1
*** HOLE CARDS ***
p0pa4poker: folds 
Trojanovich: folds 
tintin641: folds 
XneferX: folds 
beshece11harf: folds 
Uncalled bet ($0.50) returned to boydst1
boydst1 collected $1 from pot
boydst1: doesn't show hand 
*** SUMMARY ***
Total pot $1 | Rake $0 
Seat 1: XneferX (button) folded before Flop (didn't bet)
Seat 2: beshece11harf (small blind) folded before Flop
Seat 3: boydst1 (big blind) collected ($1)
Seat 4: p0pa4poker folded before Flop (didn't bet)
Seat 5: Trojanovich folded before Flop (didn't bet)
Seat 6: tintin641 folded before Flop (didn't bet)



PokerStars Hand #254538309435:  Hold'em No Limit ($0.50/$1.00 USD) - 2025/01/24 23:42:03 WET [2025/01/24 18:42:03 ET]
Table 'Merapi IV' 6-max Seat #2 is the button
Seat 1: XneferX ($111.98 in chips) 
Seat 2: beshece11harf ($238.12 in chips) 
Seat 3: boydst1 ($127.35 in chips) 
Seat 4: p0pa4poker ($155.23 in chips) 
Seat 5: Trojanovich ($417.02 in chips) 
Seat 6: tintin641 ($100 in chips) 
boydst1: posts small blind $0.50
p0pa4poker: posts big blind $1
*** HOLE CARDS ***
Trojanovich: folds 
tintin641: folds 
XneferX: raises $1.30 to $2.30
beshece11harf: folds 
boydst1: calls $1.80
p0pa4poker: calls $1.30
*** FLOP *** [Js Jd Td]
boydst1: checks 
p0pa4poker: checks 
XneferX: bets $1.71
boydst1: calls $1.71
p0pa4poker: folds 
*** TURN *** [Js Jd Td] [Ah]
boydst1: checks 
XneferX: checks 
*** RIVER *** [Js Jd Td Ah] [Ks]
boydst1: bets $4.90
XneferX: calls $4.90
*** SHOW DOWN ***
boydst1: shows [2d 3d] (a pair of Jacks)
XneferX: shows [Qc As] (a straight, Ten to Ace)
XneferX collected $19.11 from pot
*** SUMMARY ***
Total pot $20.12 | Rake $1.01 
Board [Js Jd Td Ah Ks]
Seat 1: XneferX showed [Qc As] and won ($19.11) with a straight, Ten to Ace
Seat 2: beshece11harf (button) folded before Flop (didn't bet)
Seat 3: boydst1 (small blind) showed [2d 3d] and lost with a pair of Jacks
Seat 4: p0pa4poker (big blind) folded on the Flop
Seat 5: Trojanovich folded before Flop (didn't bet)
Seat 6: tintin641 folded before Flop (didn't bet)



PokerStars Hand #254538322342:  Hold'em No Limit ($0.50/$1.00 USD) - 2025/01/24 23:42:53 WET [2025/01/24 18:42:53 ET]
Table 'Merapi IV' 6-max Seat #3 is the button
Seat 1: XneferX ($122.18 in chips) 
Seat 2: beshece11harf ($238.12 in chips) 
Seat 3: boydst1 ($118.44 in chips) 
Seat 4: p0pa4poker ($152.93 in chips) 
Seat 5: Trojanovich ($417.02 in chips) 
Seat 6: tintin641 ($100 in chips) 
p0pa4poker: posts small blind $0.50
Trojanovich: posts big blind $1
*** HOLE CARDS ***
tintin641: raises $1.50 to $2.50
XneferX: folds 
beshece11harf: folds 
boydst1: calls $2.50
p0pa4poker: calls $2
Trojanovich: folds 
*** FLOP *** [5d 9c 7d]
p0pa4poker: checks 
tintin641: checks 
boydst1: bets $4.04
p0pa4poker: folds 
tintin641: folds 
Uncalled bet ($4.04) returned to boydst1
boydst1 collected $8.08 from pot
boydst1: doesn't show hand 
*** SUMMARY ***
Total pot $8.50 | Rake $0.42 
Board [5d 9c 7d]
Seat 1: XneferX folded before Flop (didn't bet)
Seat 2: beshece11harf folded before Flop (didn't bet)
Seat 3: boydst1 (button) collected ($8.08)
Seat 4: p0pa4poker (small blind) folded on the Flop
Seat 5: Trojanovich (big blind) folded before Flop
Seat 6: tintin641 folded on the Flop



PokerStars Hand #254538332373:  Hold'em No Limit ($0.50/$1.00 USD) - 2025/01/24 23:43:32 WET [2025/01/24 18:43:32 ET]
Table 'Merapi IV' 6-max Seat #4 is the button
Seat 1: XneferX ($122.18 in chips) 
Seat 2: beshece11harf ($238.12 in chips) 
Seat 3: boydst1 ($124.02 in chips) 
Seat 4: p0pa4poker ($150.43 in chips) 
Seat 5: Trojanovich ($416.02 in chips) 
Seat 6: tintin641 ($100 in chips) 
Trojanovich: posts small blind $0.50
tintin641: posts big blind $1
*** HOLE CARDS ***
XneferX: folds 
beshece11harf: folds 
boydst1: folds 
p0pa4poker: folds 
Trojanovich: folds 
Uncalled bet ($0.50) returned to tintin641
tintin641 collected $1 from pot
tintin641: doesn't show hand 
*** SUMMARY ***
Total pot $1 | Rake $0 
Seat 1: XneferX folded before Flop (didn't bet)
Seat 2: beshece11harf folded before Flop (didn't bet)
Seat 3: boydst1 folded before Flop (didn't bet)
Seat 4: p0pa4poker (button) folded before Flop (didn't bet)
Seat 5: Trojanovich (small blind) folded before Flop
Seat 6: tintin641 (big blind) collected ($1)



PokerStars Hand #254538335043:  Hold'em No Limit ($0.50/$1.00 USD) - 2025/01/24 23:43:42 WET [2025/01/24 18:43:42 ET]
Table 'Merapi IV' 6-max Seat #5 is the button
Seat 1: XneferX ($122.18 in chips) 
Seat 2: beshece11harf ($238.12 in chips) 
Seat 3: boydst1 ($124.02 in chips) 
Seat 4: p0pa4poker ($150.43 in chips) 
Seat 5: Trojanovich ($415.52 in chips) 
Seat 6: tintin641 ($100.50 in chips) 
tintin641: posts small blind $0.50
XneferX: posts big blind $1
*** HOLE CARDS ***
beshece11harf: folds 
boydst1: calls $1
p0pa4poker: raises $2.50 to $3.50
Trojanovich: calls $3.50
tintin641: folds 
XneferX: folds 
boydst1: calls $2.50
*** FLOP *** [Ad 5c 8s]
boydst1: checks 
p0pa4poker: bets $3.76
Trojanovich: calls $3.76
boydst1: calls $3.76
*** TURN *** [Ad 5c 8s] [2h]
boydst1: checks 
p0pa4poker: checks 
Trojanovich: bets $16.59
boydst1: calls $16.59
p0pa4poker: folds 
*** RIVER *** [Ad 5c 8s 2h] [6c]
boydst1: bets $26.98
Trojanovich: raises $364.69 to $391.67 and is all-in
boydst1: calls $73.19 and is all-in
Uncalled bet ($291.50) returned to Trojanovich
*** SHOW DOWN ***
Trojanovich: shows [5h 5s] (three of a kind, Fives)
boydst1: shows [Ac 3c] (a pair of Aces)
Trojanovich collected $254.30 from pot
*** SUMMARY ***
Total pot $256.80 | Rake $2.50 
Board [Ad 5c 8s 2h 6c]
Seat 1: XneferX (big blind) folded before Flop
Seat 2: beshece11harf folded before Flop (didn't bet)
Seat 3: boydst1 showed [Ac 3c] and lost with a pair of Aces
Seat 4: p0pa4poker folded on the Turn
Seat 5: Trojanovich (button) showed [5h 5s] and won ($254.30) with three of a kind, Fives
Seat 6: tintin641 (small blind) folded before Flop



PokerStars Hand #254538378762:  Hold'em No Limit ($0.50/$1.00 USD) - 2025/01/24 23:46:31 WET [2025/01/24 18:46:31 ET]
Table 'Merapi IV' 6-max Seat #6 is the button
Seat 2: beshece11harf ($238.12 in chips) is sitting out
Seat 3: boydst1 ($0 in chips) is sitting out
Seat 1: XneferX ($121.18 in chips) 
Seat 4: p0pa4poker ($143.17 in chips) 
Seat 5: Trojanovich ($545.80 in chips) 
Seat 6: tintin641 ($100 in chips) 
XneferX: posts small blind $0.50
beshece11harf: is sitting out 
p0pa4poker: posts big blind $1
*** HOLE CARDS ***
Trojanovich: folds 
tintin641: raises $1.50 to $2.50
boydst1 leaves the table
XneferX: folds 
p0pa4poker: calls $1.50
*** FLOP *** [9d 3h 5c]
p0pa4poker: checks 
tintin641: checks 
*** TURN *** [9d 3h 5c] [9s]
GuigaMan joins the table at seat #3 
p0pa4poker: bets $1.72
tintin641: calls $1.72
*** RIVER *** [9d 3h 5c 9s] [5d]
p0pa4poker: checks 
tintin641: bets $12.74
p0pa4poker: folds 
Uncalled bet ($12.74) returned to tintin641
tintin641 collected $8.49 from pot
tintin641: doesn't show hand 
*** SUMMARY ***
Total pot $8.94 | Rake $0.45 
Board [9d 3h 5c 9s 5d]
Seat 2: beshece11harf
Seat 3: boydst1
Seat 1: XneferX (small blind) folded before Flop
Seat 4: p0pa4poker (big blind) folded on the River
Seat 5: Trojanovich folded before Flop (didn't bet)
Seat 6: tintin641 (button) collected ($8.49)



PokerStars Hand #254538404029:  Hold'em No Limit ($0.50/$1.00 USD) - 2025/01/24 23:48:11 WET [2025/01/24 18:48:11 ET]
Table 'Merapi IV' 6-max Seat #1 is the button
Seat 2: beshece11harf ($238.12 in chips) is sitting out
Seat 3: GuigaMan ($100 in chips) is sitting out
Seat 1: XneferX ($120.68 in chips) 
Seat 4: p0pa4poker ($138.95 in chips) 
Seat 5: Trojanovich ($545.80 in chips) 
Seat 6: tintin641 ($104.27 in chips) 
p0pa4poker: posts small blind $0.50
Trojanovich: posts big blind $1
*** HOLE CARDS ***
tintin641: raises $1.50 to $2.50
XneferX: folds 
p0pa4poker: folds 
Trojanovich: folds 
Uncalled bet ($1.50) returned to tintin641
tintin641 collected $2.50 from pot
tintin641: doesn't show hand 
*** SUMMARY ***
Total pot $2.50 | Rake $0 
Seat 2: beshece11harf
Seat 3: GuigaMan
Seat 1: XneferX (button) folded before Flop (didn't bet)
Seat 4: p0pa4poker (small blind) folded before Flop
Seat 5: Trojanovich (big blind) folded before Flop
Seat 6: tintin641 collected ($2.50)



PokerStars Hand #254538406760:  Hold'em No Limit ($0.50/$1.00 USD) - 2025/01/24 23:48:22 WET [2025/01/24 18:48:22 ET]
Table 'Merapi IV' 6-max Seat #4 is the button
Seat 1: XneferX ($120.68 in chips) is sitting out
Seat 2: beshece11harf ($238.12 in chips) is sitting out
Seat 6: tintin641 ($105.77 in chips) is sitting out
Seat 3: GuigaMan ($100 in chips) 
Seat 4: p0pa4poker ($138.45 in chips) 
Seat 5: Trojanovich ($544.80 in chips) 
Trojanovich: posts small blind $0.50
tintin641: is sitting out 
XneferX: is sitting out 
GuigaMan: posts big blind $1
*** HOLE CARDS ***
XneferX leaves the table
tintin641 leaves the table
p0pa4poker: raises $1.50 to $2.50
Trojanovich: folds 
GuigaMan: folds 
Uncalled bet ($1.50) returned to p0pa4poker
p0pa4poker collected $2.50 from pot
p0pa4poker: doesn't show hand 
*** SUMMARY ***
Total pot $2.50 | Rake $0 
Seat 1: XneferX
Seat 2: beshece11harf
Seat 6: tintin641
Seat 3: GuigaMan (big blind) folded before Flop
Seat 4: p0pa4poker (button) collected ($2.50)
Seat 5: Trojanovich (small blind) folded before Flop



PokerStars Hand #254538409941:  Hold'em No Limit ($0.50/$1.00 USD) - 2025/01/24 23:48:34 WET [2025/01/24 18:48:34 ET]
Table 'Merapi IV' 6-max Seat #3 is the button
Seat 2: beshece11harf ($238.12 in chips) is sitting out
Seat 3: GuigaMan ($100 in chips) 
Seat 5: Trojanovich ($544.30 in chips) 
GuigaMan: posts small blind $0.50
Trojanovich: posts big blind $1
*** HOLE CARDS ***
GuigaMan: raises $1.50 to $2.50
Trojanovich: folds 
Uncalled bet ($1.50) returned to GuigaMan
GuigaMan collected $2 from pot
GuigaMan: doesn't show hand 
*** SUMMARY ***
Total pot $2 | Rake $0 
Seat 2: beshece11harf
Seat 3: GuigaMan (button) (small blind) collected ($2)
Seat 5: Trojanovich (big blind) folded before Flop



