PokerStars Hand #254506212193:  Hold'em No Limit ($0.50/$1.00 USD) - 2025/01/22 21:38:52 WET [2025/01/22 16:38:52 ET]
Table 'Ajax III' 6-max Seat #6 is the button
Seat 1: vadjkeee ($130.35 in chips) 
Seat 2: socito ($107.62 in chips) 
Seat 3: Iospirate ($100 in chips) 
Seat 4: Trojanovich ($110.57 in chips) 
Seat 5: henri789 ($196.82 in chips) 
Seat 6: franco232315 ($174.68 in chips) 
vadjkeee: posts small blind $0.50
socito: posts big blind $1
*** HOLE CARDS ***
Iospirate: calls $1
Trojanovich: folds 
henri789: folds 
franco232315: folds 
vadjkeee: raises $4 to $5
socito: folds 
Iospirate: calls $4
*** FLOP *** [6s Qd 5s]
vadjkeee: bets $3.45
Iospirate: raises $6.55 to $10
vadjkeee: folds 
Uncalled bet ($6.55) returned to Iospirate
Iospirate collected $17 from pot
Iospirate: doesn't show hand 
*** SUMMARY ***
Total pot $17.90 | Rake $0.90 
Board [6s Qd 5s]
Seat 1: vadjkeee (small blind) folded on the Flop
Seat 2: socito (big blind) folded before Flop
Seat 3: Iospirate collected ($17)
Seat 4: Trojanovich folded before Flop (didn't bet)
Seat 5: henri789 folded before Flop (didn't bet)
Seat 6: franco232315 (button) folded before Flop (didn't bet)



PokerStars Hand #254506222172:  Hold'em No Limit ($0.50/$1.00 USD) - 2025/01/22 21:39:27 WET [2025/01/22 16:39:27 ET]
Table 'Ajax III' 6-max Seat #1 is the button
Seat 1: vadjkeee ($121.90 in chips) 
Seat 2: socito ($106.62 in chips) 
Seat 3: Iospirate ($108.55 in chips) 
Seat 4: Trojanovich ($110.57 in chips) 
Seat 5: henri789 ($196.82 in chips) 
Seat 6: franco232315 ($174.68 in chips) 
socito: posts small blind $0.50
Iospirate: posts big blind $1
*** HOLE CARDS ***
Trojanovich: folds 
henri789: folds 
franco232315: raises $1.50 to $2.50
vadjkeee: folds 
socito: folds 
Iospirate: folds 
Uncalled bet ($1.50) returned to franco232315
franco232315 collected $2.50 from pot
franco232315: doesn't show hand 
*** SUMMARY ***
Total pot $2.50 | Rake $0 
Seat 1: vadjkeee (button) folded before Flop (didn't bet)
Seat 2: socito (small blind) folded before Flop
Seat 3: Iospirate (big blind) folded before Flop
Seat 4: Trojanovich folded before Flop (didn't bet)
Seat 5: henri789 folded before Flop (didn't bet)
Seat 6: franco232315 collected ($2.50)



PokerStars Hand #254506225025:  Hold'em No Limit ($0.50/$1.00 USD) - 2025/01/22 21:39:36 WET [2025/01/22 16:39:36 ET]
Table 'Ajax III' 6-max Seat #2 is the button
Seat 1: vadjkeee ($121.90 in chips) 
Seat 2: socito ($106.12 in chips) 
Seat 3: Iospirate ($107.55 in chips) 
Seat 4: Trojanovich ($110.57 in chips) 
Seat 5: henri789 ($196.82 in chips) 
Seat 6: franco232315 ($176.18 in chips) 
Iospirate: posts small blind $0.50
Trojanovich: posts big blind $1
*** HOLE CARDS ***
henri789: folds 
franco232315: folds 
vadjkeee: folds 
socito: folds 
Iospirate: folds 
Uncalled bet ($0.50) returned to Trojanovich
Trojanovich collected $1 from pot
Trojanovich: doesn't show hand 
*** SUMMARY ***
Total pot $1 | Rake $0 
Seat 1: vadjkeee folded before Flop (didn't bet)
Seat 2: socito (button) folded before Flop (didn't bet)
Seat 3: Iospirate (small blind) folded before Flop
Seat 4: Trojanovich (big blind) collected ($1)
Seat 5: henri789 folded before Flop (didn't bet)
Seat 6: franco232315 folded before Flop (didn't bet)



PokerStars Hand #254506229254:  Hold'em No Limit ($0.50/$1.00 USD) - 2025/01/22 21:39:51 WET [2025/01/22 16:39:51 ET]
Table 'Ajax III' 6-max Seat #3 is the button
Seat 1: vadjkeee ($121.90 in chips) 
Seat 2: socito ($106.12 in chips) 
Seat 3: Iospirate ($107.05 in chips) 
Seat 4: Trojanovich ($111.07 in chips) 
Seat 5: henri789 ($196.82 in chips) 
Seat 6: franco232315 ($176.18 in chips) 
Trojanovich: posts small blind $0.50
henri789: posts big blind $1
*** HOLE CARDS ***
franco232315: folds 
vadjkeee: folds 
socito: folds 
Iospirate: folds 
Trojanovich: folds 
Uncalled bet ($0.50) returned to henri789
henri789 collected $1 from pot
henri789: doesn't show hand 
*** SUMMARY ***
Total pot $1 | Rake $0 
Seat 1: vadjkeee folded before Flop (didn't bet)
Seat 2: socito folded before Flop (didn't bet)
Seat 3: Iospirate (button) folded before Flop (didn't bet)
Seat 4: Trojanovich (small blind) folded before Flop
Seat 5: henri789 (big blind) collected ($1)
Seat 6: franco232315 folded before Flop (didn't bet)



PokerStars Hand #254506232357:  Hold'em No Limit ($0.50/$1.00 USD) - 2025/01/22 21:40:02 WET [2025/01/22 16:40:02 ET]
Table 'Ajax III' 6-max Seat #4 is the button
Seat 1: vadjkeee ($121.90 in chips) 
Seat 2: socito ($106.12 in chips) 
Seat 3: Iospirate ($107.05 in chips) 
Seat 4: Trojanovich ($110.57 in chips) 
Seat 5: henri789 ($197.32 in chips) 
Seat 6: franco232315 ($176.18 in chips) 
henri789: posts small blind $0.50
franco232315: posts big blind $1
*** HOLE CARDS ***
vadjkeee: raises $1.50 to $2.50
socito: folds 
Iospirate: calls $2.50
Trojanovich: folds 
henri789: folds 
franco232315: calls $1.50
*** FLOP *** [Td 6s 6c]
franco232315: checks 
vadjkeee: bets $1.90
Iospirate: raises $1.90 to $3.80
franco232315: raises $5.60 to $9.40
vadjkeee: calls $7.50
Iospirate: calls $5.60
*** TURN *** [Td 6s 6c] [5d]
franco232315: bets $11.35
vadjkeee: calls $11.35
Iospirate: calls $11.35
*** RIVER *** [Td 6s 6c 5d] [Jh]
franco232315: checks 
vadjkeee: checks 
Iospirate: bets $83.80 and is all-in
franco232315: folds 
vadjkeee: folds 
Uncalled bet ($83.80) returned to Iospirate
Iospirate collected $67.75 from pot
Iospirate: doesn't show hand 
*** SUMMARY ***
Total pot $70.25 | Rake $2.50 
Board [Td 6s 6c 5d Jh]
Seat 1: vadjkeee folded on the River
Seat 2: socito folded before Flop (didn't bet)
Seat 3: Iospirate collected ($67.75)
Seat 4: Trojanovich (button) folded before Flop (didn't bet)
Seat 5: henri789 (small blind) folded before Flop
Seat 6: franco232315 (big blind) folded on the River



PokerStars Hand #254506268830:  Hold'em No Limit ($0.50/$1.00 USD) - 2025/01/22 21:42:08 WET [2025/01/22 16:42:08 ET]
Table 'Ajax III' 6-max Seat #5 is the button
Seat 1: vadjkeee ($100 in chips) 
Seat 2: socito ($106.12 in chips) 
Seat 3: Iospirate ($151.55 in chips) 
Seat 4: Trojanovich ($110.57 in chips) 
Seat 5: henri789 ($196.82 in chips) 
Seat 6: franco232315 ($152.93 in chips) 
franco232315: posts small blind $0.50
vadjkeee: posts big blind $1
*** HOLE CARDS ***
socito: folds 
Iospirate: folds 
Trojanovich: raises $1.50 to $2.50
henri789: folds 
franco232315: folds 
vadjkeee: folds 
Uncalled bet ($1.50) returned to Trojanovich
Trojanovich collected $2.50 from pot
Trojanovich: doesn't show hand 
*** SUMMARY ***
Total pot $2.50 | Rake $0 
Seat 1: vadjkeee (big blind) folded before Flop
Seat 2: socito folded before Flop (didn't bet)
Seat 3: Iospirate folded before Flop (didn't bet)
Seat 4: Trojanovich collected ($2.50)
Seat 5: henri789 (button) folded before Flop (didn't bet)
Seat 6: franco232315 (small blind) folded before Flop



PokerStars Hand #254506272760:  Hold'em No Limit ($0.50/$1.00 USD) - 2025/01/22 21:42:22 WET [2025/01/22 16:42:22 ET]
Table 'Ajax III' 6-max Seat #6 is the button
Seat 2: socito ($106.12 in chips) is sitting out
Seat 1: vadjkeee ($100 in chips) 
Seat 3: Iospirate ($151.55 in chips) 
Seat 4: Trojanovich ($112.07 in chips) 
Seat 5: henri789 ($196.82 in chips) 
Seat 6: franco232315 ($152.43 in chips) 
vadjkeee: posts small blind $0.50
socito: is sitting out 
Iospirate: posts big blind $1
*** HOLE CARDS ***
socito leaves the table
Trojanovich: folds 
michasia joins the table at seat #2 
henri789: folds 
franco232315: folds 
vadjkeee: folds 
Uncalled bet ($0.50) returned to Iospirate
Iospirate collected $1 from pot
Iospirate: doesn't show hand 
*** SUMMARY ***
Total pot $1 | Rake $0 
Seat 2: socito
Seat 1: vadjkeee (small blind) folded before Flop
Seat 3: Iospirate (big blind) collected ($1)
Seat 4: Trojanovich folded before Flop (didn't bet)
Seat 5: henri789 folded before Flop (didn't bet)
Seat 6: franco232315 (button) folded before Flop (didn't bet)



PokerStars Hand #254506276684:  Hold'em No Limit ($0.50/$1.00 USD) - 2025/01/22 21:42:35 WET [2025/01/22 16:42:35 ET]
Table 'Ajax III' 6-max Seat #1 is the button
Seat 2: michasia ($100 in chips) is sitting out
Seat 6: franco232315 ($152.43 in chips) is sitting out
Seat 1: vadjkeee ($100 in chips) 
Seat 3: Iospirate ($152.05 in chips) 
Seat 4: Trojanovich ($112.07 in chips) 
Seat 5: henri789 ($196.82 in chips) 
Iospirate: posts small blind $0.50
Trojanovich: posts big blind $1
*** HOLE CARDS ***
henri789: folds 
vadjkeee: raises $2 to $3
Iospirate: calls $2.50
Trojanovich: folds 
*** FLOP *** [Qh 5c Ah]
Iospirate: checks 
vadjkeee: bets $8
Iospirate: calls $8
*** TURN *** [Qh 5c Ah] [3c]
Iospirate: checks 
vadjkeee: bets $26.50
Iospirate: calls $26.50
*** RIVER *** [Qh 5c Ah 3c] [Jc]
Iospirate: checks 
vadjkeee: checks 
*** SHOW DOWN ***
Iospirate: shows [7h 9h] (high card Ace)
vadjkeee: shows [Th Jd] (a pair of Jacks)
vadjkeee collected $75 from pot
*** SUMMARY ***
Total pot $76 | Rake $1 
Board [Qh 5c Ah 3c Jc]
Seat 2: michasia
Seat 6: franco232315
Seat 1: vadjkeee (button) showed [Th Jd] and won ($75) with a pair of Jacks
Seat 3: Iospirate (small blind) showed [7h 9h] and lost with high card Ace
Seat 4: Trojanovich (big blind) folded before Flop
Seat 5: henri789 folded before Flop (didn't bet)



PokerStars Hand #254506291392:  Hold'em No Limit ($0.50/$1.00 USD) - 2025/01/22 21:43:27 WET [2025/01/22 16:43:27 ET]
Table 'Ajax III' 6-max Seat #3 is the button
Seat 2: michasia ($100 in chips) is sitting out
Seat 6: franco232315 ($152.43 in chips) is sitting out
Seat 1: vadjkeee ($137.50 in chips) 
Seat 3: Iospirate ($114.55 in chips) 
Seat 4: Trojanovich ($111.07 in chips) 
Seat 5: henri789 ($196.82 in chips) 
Trojanovich: posts small blind $0.50
henri789: posts big blind $1
michasia: sits out 
*** HOLE CARDS ***
vadjkeee: folds 
Iospirate: folds 
Trojanovich: raises $2 to $3
henri789: raises $6 to $9
Trojanovich: calls $6
*** FLOP *** [3h 5s 5c]
Trojanovich: checks 
henri789: bets $8.38
Trojanovich: folds 
Uncalled bet ($8.38) returned to henri789
henri789 collected $17.10 from pot
henri789: doesn't show hand 
*** SUMMARY ***
Total pot $18 | Rake $0.90 
Board [3h 5s 5c]
Seat 2: michasia
Seat 6: franco232315
Seat 1: vadjkeee folded before Flop (didn't bet)
Seat 3: Iospirate (button) folded before Flop (didn't bet)
Seat 4: Trojanovich (small blind) folded on the Flop
Seat 5: henri789 (big blind) collected ($17.10)



PokerStars Hand #254506303564:  Hold'em No Limit ($0.50/$1.00 USD) - 2025/01/22 21:44:09 WET [2025/01/22 16:44:09 ET]
Table 'Ajax III' 6-max Seat #4 is the button
Seat 2: michasia ($100 in chips) is sitting out
Seat 6: franco232315 ($152.43 in chips) is sitting out
Seat 1: vadjkeee ($137.50 in chips) 
Seat 3: Iospirate ($114.55 in chips) 
Seat 4: Trojanovich ($102.07 in chips) 
Seat 5: henri789 ($204.92 in chips) 
henri789: posts small blind $0.50
vadjkeee: posts big blind $1
michasia: sits out 
*** HOLE CARDS ***
Iospirate: calls $1
Trojanovich: raises $2.50 to $3.50
henri789: raises $10 to $13.50
vadjkeee: folds 
Iospirate: folds 
Trojanovich: calls $10
*** FLOP *** [Qc 4h 7d]
henri789: bets $9.24
Trojanovich: calls $9.24
*** TURN *** [Qc 4h 7d] [8d]
henri789: checks 
Trojanovich: bets $15.34
henri789: calls $15.34
*** RIVER *** [Qc 4h 7d 8d] [Jh]
henri789: checks 
Trojanovich: checks 
*** SHOW DOWN ***
henri789: shows [Td Tc] (a pair of Tens)
Trojanovich: shows [Qh Ad] (a pair of Queens)
Trojanovich collected $77.16 from pot
*** SUMMARY ***
Total pot $78.16 | Rake $1 
Board [Qc 4h 7d 8d Jh]
Seat 2: michasia
Seat 6: franco232315
Seat 1: vadjkeee (big blind) folded before Flop
Seat 3: Iospirate folded before Flop
Seat 4: Trojanovich (button) showed [Qh Ad] and won ($77.16) with a pair of Queens
Seat 5: henri789 (small blind) showed [Td Tc] and lost with a pair of Tens



PokerStars Hand #254506340444:  Hold'em No Limit ($0.50/$1.00 USD) - 2025/01/22 21:46:18 WET [2025/01/22 16:46:18 ET]
Table 'Ajax III' 6-max Seat #5 is the button
Seat 6: franco232315 ($152.43 in chips) is sitting out
Seat 1: vadjkeee ($136.50 in chips) 
Seat 2: michasia ($100 in chips) 
Seat 3: Iospirate ($113.55 in chips) 
Seat 4: Trojanovich ($141.15 in chips) 
Seat 5: henri789 ($166.84 in chips) 
vadjkeee: posts small blind $0.50
michasia: posts big blind $1
*** HOLE CARDS ***
Iospirate: folds 
Trojanovich: raises $1.50 to $2.50
henri789: folds 
vadjkeee: folds 
michasia: folds 
Uncalled bet ($1.50) returned to Trojanovich
Trojanovich collected $2.50 from pot
Trojanovich: doesn't show hand 
*** SUMMARY ***
Total pot $2.50 | Rake $0 
Seat 6: franco232315
Seat 1: vadjkeee (small blind) folded before Flop
Seat 2: michasia (big blind) folded before Flop
Seat 3: Iospirate folded before Flop (didn't bet)
Seat 4: Trojanovich collected ($2.50)
Seat 5: henri789 (button) folded before Flop (didn't bet)



PokerStars Hand #254506346017:  Hold'em No Limit ($0.50/$1.00 USD) - 2025/01/22 21:46:37 WET [2025/01/22 16:46:37 ET]
Table 'Ajax III' 6-max Seat #1 is the button
Seat 6: franco232315 ($152.43 in chips) is sitting out
Seat 1: vadjkeee ($136 in chips) 
Seat 2: michasia ($100 in chips) 
Seat 3: Iospirate ($113.55 in chips) 
Seat 4: Trojanovich ($142.65 in chips) 
Seat 5: henri789 ($166.84 in chips) 
michasia: posts small blind $0.50
Iospirate: posts big blind $1
franco232315: sits out 
*** HOLE CARDS ***
Trojanovich: folds 
henri789: raises $1.20 to $2.20
vadjkeee: folds 
michasia: folds 
Iospirate: calls $1.20
*** FLOP *** [Qh 6d Qc]
Iospirate: checks 
henri789: bets $1.21
Iospirate: calls $1.21
*** TURN *** [Qh 6d Qc] [4s]
Iospirate: checks 
henri789: checks 
*** RIVER *** [Qh 6d Qc 4s] [7h]
Iospirate: bets $6.95
henri789: folds 
Uncalled bet ($6.95) returned to Iospirate
Iospirate collected $6.95 from pot
Iospirate: doesn't show hand 
*** SUMMARY ***
Total pot $7.32 | Rake $0.37 
Board [Qh 6d Qc 4s 7h]
Seat 6: franco232315
Seat 1: vadjkeee (button) folded before Flop (didn't bet)
Seat 2: michasia (small blind) folded before Flop
Seat 3: Iospirate (big blind) collected ($6.95)
Seat 4: Trojanovich folded before Flop (didn't bet)
Seat 5: henri789 folded on the River



PokerStars Hand #254506364499:  Hold'em No Limit ($0.50/$1.00 USD) - 2025/01/22 21:47:42 WET [2025/01/22 16:47:42 ET]
Table 'Ajax III' 6-max Seat #2 is the button
Seat 6: franco232315 ($152.43 in chips) is sitting out
Seat 1: vadjkeee ($136 in chips) 
Seat 2: michasia ($100 in chips) 
Seat 3: Iospirate ($117.09 in chips) 
Seat 4: Trojanovich ($142.65 in chips) 
Seat 5: henri789 ($163.43 in chips) 
Iospirate: posts small blind $0.50
Trojanovich: posts big blind $1
franco232315: sits out 
*** HOLE CARDS ***
henri789: folds 
vadjkeee: raises $2 to $3
michasia: folds 
Iospirate: folds 
Trojanovich: folds 
Uncalled bet ($2) returned to vadjkeee
vadjkeee collected $2.50 from pot
vadjkeee: doesn't show hand 
*** SUMMARY ***
Total pot $2.50 | Rake $0 
Seat 6: franco232315
Seat 1: vadjkeee collected ($2.50)
Seat 2: michasia (button) folded before Flop (didn't bet)
Seat 3: Iospirate (small blind) folded before Flop
Seat 4: Trojanovich (big blind) folded before Flop
Seat 5: henri789 folded before Flop (didn't bet)



PokerStars Hand #254506368600:  Hold'em No Limit ($0.50/$1.00 USD) - 2025/01/22 21:47:57 WET [2025/01/22 16:47:57 ET]
Table 'Ajax III' 6-max Seat #3 is the button
Seat 6: franco232315 ($152.43 in chips) is sitting out
Seat 1: vadjkeee ($137.50 in chips) 
Seat 2: michasia ($100 in chips) 
Seat 3: Iospirate ($116.59 in chips) 
Seat 4: Trojanovich ($141.65 in chips) 
Seat 5: henri789 ($163.43 in chips) 
Trojanovich: posts small blind $0.50
henri789: posts big blind $1
franco232315: sits out 
*** HOLE CARDS ***
vadjkeee: folds 
michasia: raises $1.80 to $2.80
Iospirate: folds 
Trojanovich: folds 
henri789: calls $1.80
*** FLOP *** [4s Kd Ts]
henri789: checks 
michasia: bets $3.87
henri789: folds 
Uncalled bet ($3.87) returned to michasia
michasia collected $5.80 from pot
michasia: doesn't show hand 
*** SUMMARY ***
Total pot $6.10 | Rake $0.30 
Board [4s Kd Ts]
Seat 6: franco232315
Seat 1: vadjkeee folded before Flop (didn't bet)
Seat 2: michasia collected ($5.80)
Seat 3: Iospirate (button) folded before Flop (didn't bet)
Seat 4: Trojanovich (small blind) folded before Flop
Seat 5: henri789 (big blind) folded on the Flop



PokerStars Hand #254506376219:  Hold'em No Limit ($0.50/$1.00 USD) - 2025/01/22 21:48:23 WET [2025/01/22 16:48:23 ET]
Table 'Ajax III' 6-max Seat #4 is the button
Seat 1: vadjkeee ($137.50 in chips) 
Seat 2: michasia ($103 in chips) 
Seat 3: Iospirate ($116.59 in chips) 
Seat 4: Trojanovich ($141.15 in chips) 
Seat 5: henri789 ($160.63 in chips) 
Seat 6: franco232315 ($152.43 in chips) 
henri789: posts small blind $0.50
franco232315: posts big blind $1
*** HOLE CARDS ***
vadjkeee: raises $1.50 to $2.50
michasia: folds 
Iospirate: folds 
Trojanovich: folds 
henri789: folds 
franco232315: folds 
Uncalled bet ($1.50) returned to vadjkeee
vadjkeee collected $2.50 from pot
vadjkeee: doesn't show hand 
*** SUMMARY ***
Total pot $2.50 | Rake $0 
Seat 1: vadjkeee collected ($2.50)
Seat 2: michasia folded before Flop (didn't bet)
Seat 3: Iospirate folded before Flop (didn't bet)
Seat 4: Trojanovich (button) folded before Flop (didn't bet)
Seat 5: henri789 (small blind) folded before Flop
Seat 6: franco232315 (big blind) folded before Flop



PokerStars Hand #254506381097:  Hold'em No Limit ($0.50/$1.00 USD) - 2025/01/22 21:48:41 WET [2025/01/22 16:48:41 ET]
Table 'Ajax III' 6-max Seat #5 is the button
Seat 1: vadjkeee ($139 in chips) 
Seat 2: michasia ($103 in chips) 
Seat 3: Iospirate ($116.59 in chips) 
Seat 4: Trojanovich ($141.15 in chips) 
Seat 5: henri789 ($160.13 in chips) 
Seat 6: franco232315 ($151.43 in chips) 
franco232315: posts small blind $0.50
vadjkeee: posts big blind $1
*** HOLE CARDS ***
michasia: folds 
Iospirate: calls $1
Trojanovich: folds 
henri789: folds 
franco232315: folds 
vadjkeee: checks 
*** FLOP *** [7c Jc Kc]
vadjkeee: checks 
Iospirate: checks 
*** TURN *** [7c Jc Kc] [4h]
vadjkeee: checks 
Iospirate: checks 
*** RIVER *** [7c Jc Kc 4h] [3d]
vadjkeee: checks 
Iospirate: bets $2
vadjkeee: folds 
Uncalled bet ($2) returned to Iospirate
Iospirate collected $2.38 from pot
Iospirate: doesn't show hand 
*** SUMMARY ***
Total pot $2.50 | Rake $0.12 
Board [7c Jc Kc 4h 3d]
Seat 1: vadjkeee (big blind) folded on the River
Seat 2: michasia folded before Flop (didn't bet)
Seat 3: Iospirate collected ($2.38)
Seat 4: Trojanovich folded before Flop (didn't bet)
Seat 5: henri789 (button) folded before Flop (didn't bet)
Seat 6: franco232315 (small blind) folded before Flop



PokerStars Hand #254506392110:  Hold'em No Limit ($0.50/$1.00 USD) - 2025/01/22 21:49:19 WET [2025/01/22 16:49:19 ET]
Table 'Ajax III' 6-max Seat #6 is the button
Seat 1: vadjkeee ($138 in chips) 
Seat 2: michasia ($103 in chips) 
Seat 3: Iospirate ($117.97 in chips) 
Seat 4: Trojanovich ($141.15 in chips) 
Seat 5: henri789 ($160.13 in chips) 
Seat 6: franco232315 ($150.93 in chips) 
vadjkeee: posts small blind $0.50
michasia: posts big blind $1
*** HOLE CARDS ***
Iospirate: folds 
Trojanovich: folds 
henri789: raises $1.20 to $2.20
franco232315: folds 
vadjkeee: folds 
michasia: folds 
Uncalled bet ($1.20) returned to henri789
henri789 collected $2.50 from pot
henri789: doesn't show hand 
*** SUMMARY ***
Total pot $2.50 | Rake $0 
Seat 1: vadjkeee (small blind) folded before Flop
Seat 2: michasia (big blind) folded before Flop
Seat 3: Iospirate folded before Flop (didn't bet)
Seat 4: Trojanovich folded before Flop (didn't bet)
Seat 5: henri789 collected ($2.50)
Seat 6: franco232315 (button) folded before Flop (didn't bet)



PokerStars Hand #254506397631:  Hold'em No Limit ($0.50/$1.00 USD) - 2025/01/22 21:49:39 WET [2025/01/22 16:49:39 ET]
Table 'Ajax III' 6-max Seat #1 is the button
Seat 1: vadjkeee ($137.50 in chips) 
Seat 2: michasia ($102 in chips) 
Seat 3: Iospirate ($117.97 in chips) 
Seat 4: Trojanovich ($141.15 in chips) 
Seat 5: henri789 ($161.63 in chips) 
Seat 6: franco232315 ($150.93 in chips) 
michasia: posts small blind $0.50
Iospirate: posts big blind $1
*** HOLE CARDS ***
Trojanovich: folds 
henri789: folds 
franco232315: folds 
vadjkeee: folds 
michasia: folds 
Uncalled bet ($0.50) returned to Iospirate
Iospirate collected $1 from pot
Iospirate: doesn't show hand 
*** SUMMARY ***
Total pot $1 | Rake $0 
Seat 1: vadjkeee (button) folded before Flop (didn't bet)
Seat 2: michasia (small blind) folded before Flop
Seat 3: Iospirate (big blind) collected ($1)
Seat 4: Trojanovich folded before Flop (didn't bet)
Seat 5: henri789 folded before Flop (didn't bet)
Seat 6: franco232315 folded before Flop (didn't bet)



PokerStars Hand #254506400088:  Hold'em No Limit ($0.50/$1.00 USD) - 2025/01/22 21:49:47 WET [2025/01/22 16:49:47 ET]
Table 'Ajax III' 6-max Seat #2 is the button
Seat 1: vadjkeee ($137.50 in chips) 
Seat 2: michasia ($101.50 in chips) 
Seat 3: Iospirate ($118.47 in chips) 
Seat 4: Trojanovich ($141.15 in chips) 
Seat 5: henri789 ($161.63 in chips) 
Seat 6: franco232315 ($150.93 in chips) 
Iospirate: posts small blind $0.50
Trojanovich: posts big blind $1
*** HOLE CARDS ***
henri789: folds 
franco232315: folds 
vadjkeee: folds 
michasia: folds 
Iospirate: folds 
Uncalled bet ($0.50) returned to Trojanovich
Trojanovich collected $1 from pot
Trojanovich: doesn't show hand 
*** SUMMARY ***
Total pot $1 | Rake $0 
Seat 1: vadjkeee folded before Flop (didn't bet)
Seat 2: michasia (button) folded before Flop (didn't bet)
Seat 3: Iospirate (small blind) folded before Flop
Seat 4: Trojanovich (big blind) collected ($1)
Seat 5: henri789 folded before Flop (didn't bet)
Seat 6: franco232315 folded before Flop (didn't bet)



PokerStars Hand #254506404981:  Hold'em No Limit ($0.50/$1.00 USD) - 2025/01/22 21:50:05 WET [2025/01/22 16:50:05 ET]
Table 'Ajax III' 6-max Seat #3 is the button
Seat 1: vadjkeee ($137.50 in chips) 
Seat 2: michasia ($101.50 in chips) 
Seat 3: Iospirate ($117.97 in chips) 
Seat 4: Trojanovich ($141.65 in chips) 
Seat 5: henri789 ($161.63 in chips) 
Seat 6: franco232315 ($150.93 in chips) 
Trojanovich: posts small blind $0.50
henri789: posts big blind $1
*** HOLE CARDS ***
franco232315: folds 
vadjkeee: folds 
michasia: raises $1.80 to $2.80
Iospirate: folds 
Trojanovich: folds 
henri789: folds 
Uncalled bet ($1.80) returned to michasia
michasia collected $2.50 from pot
michasia: doesn't show hand 
*** SUMMARY ***
Total pot $2.50 | Rake $0 
Seat 1: vadjkeee folded before Flop (didn't bet)
Seat 2: michasia collected ($2.50)
Seat 3: Iospirate (button) folded before Flop (didn't bet)
Seat 4: Trojanovich (small blind) folded before Flop
Seat 5: henri789 (big blind) folded before Flop
Seat 6: franco232315 folded before Flop (didn't bet)



PokerStars Hand #254506408751:  Hold'em No Limit ($0.50/$1.00 USD) - 2025/01/22 21:50:18 WET [2025/01/22 16:50:18 ET]
Table 'Ajax III' 6-max Seat #4 is the button
Seat 1: vadjkeee ($137.50 in chips) 
Seat 2: michasia ($103 in chips) 
Seat 3: Iospirate ($117.97 in chips) 
Seat 4: Trojanovich ($141.15 in chips) 
Seat 5: henri789 ($160.63 in chips) 
Seat 6: franco232315 ($150.93 in chips) 
henri789: posts small blind $0.50
franco232315: posts big blind $1
*** HOLE CARDS ***
vadjkeee: folds 
michasia: folds 
Iospirate: folds 
Trojanovich: raises $1.50 to $2.50
henri789: folds 
franco232315: folds 
Uncalled bet ($1.50) returned to Trojanovich
Trojanovich collected $2.50 from pot
Trojanovich: doesn't show hand 
*** SUMMARY ***
Total pot $2.50 | Rake $0 
Seat 1: vadjkeee folded before Flop (didn't bet)
Seat 2: michasia folded before Flop (didn't bet)
Seat 3: Iospirate folded before Flop (didn't bet)
Seat 4: Trojanovich (button) collected ($2.50)
Seat 5: henri789 (small blind) folded before Flop
Seat 6: franco232315 (big blind) folded before Flop



PokerStars Hand #254506411926:  Hold'em No Limit ($0.50/$1.00 USD) - 2025/01/22 21:50:30 WET [2025/01/22 16:50:30 ET]
Table 'Ajax III' 6-max Seat #5 is the button
Seat 1: vadjkeee ($137.50 in chips) 
Seat 2: michasia ($103 in chips) 
Seat 3: Iospirate ($117.97 in chips) 
Seat 4: Trojanovich ($142.65 in chips) 
Seat 5: henri789 ($160.13 in chips) 
Seat 6: franco232315 ($149.93 in chips) 
franco232315: posts small blind $0.50
vadjkeee: posts big blind $1
*** HOLE CARDS ***
michasia: folds 
Iospirate: folds 
Trojanovich: folds 
henri789: raises $1.20 to $2.20
franco232315: folds 
vadjkeee: folds 
Uncalled bet ($1.20) returned to henri789
henri789 collected $2.50 from pot
henri789: doesn't show hand 
*** SUMMARY ***
Total pot $2.50 | Rake $0 
Seat 1: vadjkeee (big blind) folded before Flop
Seat 2: michasia folded before Flop (didn't bet)
Seat 3: Iospirate folded before Flop (didn't bet)
Seat 4: Trojanovich folded before Flop (didn't bet)
Seat 5: henri789 (button) collected ($2.50)
Seat 6: franco232315 (small blind) folded before Flop



PokerStars Hand #254506417506:  Hold'em No Limit ($0.50/$1.00 USD) - 2025/01/22 21:50:50 WET [2025/01/22 16:50:50 ET]
Table 'Ajax III' 6-max Seat #6 is the button
Seat 1: vadjkeee ($136.50 in chips) 
Seat 2: michasia ($103 in chips) 
Seat 3: Iospirate ($117.97 in chips) 
Seat 4: Trojanovich ($142.65 in chips) 
Seat 5: henri789 ($161.63 in chips) 
Seat 6: franco232315 ($149.43 in chips) 
vadjkeee: posts small blind $0.50
michasia: posts big blind $1
*** HOLE CARDS ***
Iospirate: folds 
Trojanovich: folds 
henri789: folds 
franco232315: raises $1.50 to $2.50
vadjkeee: folds 
michasia: calls $1.50
*** FLOP *** [9h 5c 2s]
michasia: checks 
franco232315: bets $2.61
michasia: calls $2.61
*** TURN *** [9h 5c 2s] [Kh]
michasia: checks 
franco232315: bets $15.27
michasia: folds 
Uncalled bet ($15.27) returned to franco232315
franco232315 collected $10.18 from pot
franco232315: doesn't show hand 
*** SUMMARY ***
Total pot $10.72 | Rake $0.54 
Board [9h 5c 2s Kh]
Seat 1: vadjkeee (small blind) folded before Flop
Seat 2: michasia (big blind) folded on the Turn
Seat 3: Iospirate folded before Flop (didn't bet)
Seat 4: Trojanovich folded before Flop (didn't bet)
Seat 5: henri789 folded before Flop (didn't bet)
Seat 6: franco232315 (button) collected ($10.18)



PokerStars Hand #254506430711:  Hold'em No Limit ($0.50/$1.00 USD) - 2025/01/22 21:51:37 WET [2025/01/22 16:51:37 ET]
Table 'Ajax III' 6-max Seat #1 is the button
Seat 1: vadjkeee ($136 in chips) 
Seat 2: michasia ($100 in chips) 
Seat 3: Iospirate ($117.97 in chips) 
Seat 4: Trojanovich ($142.65 in chips) 
Seat 5: henri789 ($161.63 in chips) 
Seat 6: franco232315 ($154.50 in chips) 
michasia: posts small blind $0.50
Iospirate: posts big blind $1
*** HOLE CARDS ***
Trojanovich: folds 
henri789: folds 
franco232315: folds 
vadjkeee: folds 
michasia: folds 
Uncalled bet ($0.50) returned to Iospirate
Iospirate collected $1 from pot
Iospirate: doesn't show hand 
*** SUMMARY ***
Total pot $1 | Rake $0 
Seat 1: vadjkeee (button) folded before Flop (didn't bet)
Seat 2: michasia (small blind) folded before Flop
Seat 3: Iospirate (big blind) collected ($1)
Seat 4: Trojanovich folded before Flop (didn't bet)
Seat 5: henri789 folded before Flop (didn't bet)
Seat 6: franco232315 folded before Flop (didn't bet)



PokerStars Hand #254506434938:  Hold'em No Limit ($0.50/$1.00 USD) - 2025/01/22 21:51:52 WET [2025/01/22 16:51:52 ET]
Table 'Ajax III' 6-max Seat #2 is the button
Seat 1: vadjkeee ($136 in chips) 
Seat 2: michasia ($100 in chips) 
Seat 3: Iospirate ($118.47 in chips) 
Seat 4: Trojanovich ($142.65 in chips) 
Seat 5: henri789 ($161.63 in chips) 
Seat 6: franco232315 ($154.50 in chips) 
Iospirate: posts small blind $0.50
Trojanovich: posts big blind $1
*** HOLE CARDS ***
henri789: folds 
franco232315: folds 
vadjkeee: raises $2 to $3
michasia: folds 
Iospirate: calls $2.50
Trojanovich: folds 
*** FLOP *** [5h Ad Ac]
Iospirate: checks 
vadjkeee: bets $1.66
Iospirate: calls $1.66
*** TURN *** [5h Ad Ac] [Ts]
Iospirate: checks 
vadjkeee: bets $11
Iospirate: folds 
Uncalled bet ($11) returned to vadjkeee
vadjkeee collected $9.80 from pot
vadjkeee: doesn't show hand 
*** SUMMARY ***
Total pot $10.32 | Rake $0.52 
Board [5h Ad Ac Ts]
Seat 1: vadjkeee collected ($9.80)
Seat 2: michasia (button) folded before Flop (didn't bet)
Seat 3: Iospirate (small blind) folded on the Turn
Seat 4: Trojanovich (big blind) folded before Flop
Seat 5: henri789 folded before Flop (didn't bet)
Seat 6: franco232315 folded before Flop (didn't bet)



PokerStars Hand #254506446740:  Hold'em No Limit ($0.50/$1.00 USD) - 2025/01/22 21:52:34 WET [2025/01/22 16:52:34 ET]
Table 'Ajax III' 6-max Seat #3 is the button
Seat 1: vadjkeee ($141.14 in chips) 
Seat 2: michasia ($100 in chips) 
Seat 3: Iospirate ($113.81 in chips) 
Seat 4: Trojanovich ($141.65 in chips) 
Seat 5: henri789 ($161.63 in chips) 
Seat 6: franco232315 ($154.50 in chips) 
Trojanovich: posts small blind $0.50
henri789: posts big blind $1
*** HOLE CARDS ***
franco232315: folds 
vadjkeee: folds 
michasia: raises $1.80 to $2.80
Iospirate: folds 
Trojanovich: raises $8.70 to $11.50
henri789: folds 
michasia: calls $8.70
*** FLOP *** [Ah 4s 5c]
Trojanovich: checks 
michasia: checks 
*** TURN *** [Ah 4s 5c] [Js]
Trojanovich: bets $17.10
michasia: calls $17.10
*** RIVER *** [Ah 4s 5c Js] [Ad]
Trojanovich: bets $113.05 and is all-in
michasia: folds 
Uncalled bet ($113.05) returned to Trojanovich
Trojanovich collected $55.70 from pot
Trojanovich: doesn't show hand 
*** SUMMARY ***
Total pot $58.20 | Rake $2.50 
Board [Ah 4s 5c Js Ad]
Seat 1: vadjkeee folded before Flop (didn't bet)
Seat 2: michasia folded on the River
Seat 3: Iospirate (button) folded before Flop (didn't bet)
Seat 4: Trojanovich (small blind) collected ($55.70)
Seat 5: henri789 (big blind) folded before Flop
Seat 6: franco232315 folded before Flop (didn't bet)



PokerStars Hand #254506465057:  Hold'em No Limit ($0.50/$1.00 USD) - 2025/01/22 21:53:40 WET [2025/01/22 16:53:40 ET]
Table 'Ajax III' 6-max Seat #4 is the button
Seat 1: vadjkeee ($141.14 in chips) 
Seat 2: michasia ($100 in chips) 
Seat 3: Iospirate ($113.81 in chips) 
Seat 4: Trojanovich ($168.75 in chips) 
Seat 5: henri789 ($160.63 in chips) 
Seat 6: franco232315 ($154.50 in chips) 
henri789: posts small blind $0.50
franco232315: posts big blind $1
*** HOLE CARDS ***
vadjkeee: folds 
michasia: raises $1.60 to $2.60
Iospirate: folds 
Trojanovich: folds 
henri789: folds 
franco232315: folds 
Uncalled bet ($1.60) returned to michasia
michasia collected $2.50 from pot
michasia: doesn't show hand 
*** SUMMARY ***
Total pot $2.50 | Rake $0 
Seat 1: vadjkeee folded before Flop (didn't bet)
Seat 2: michasia collected ($2.50)
Seat 3: Iospirate folded before Flop (didn't bet)
Seat 4: Trojanovich (button) folded before Flop (didn't bet)
Seat 5: henri789 (small blind) folded before Flop
Seat 6: franco232315 (big blind) folded before Flop



PokerStars Hand #254506469380:  Hold'em No Limit ($0.50/$1.00 USD) - 2025/01/22 21:53:56 WET [2025/01/22 16:53:56 ET]
Table 'Ajax III' 6-max Seat #5 is the button
Seat 1: vadjkeee ($141.14 in chips) 
Seat 2: michasia ($101.50 in chips) 
Seat 3: Iospirate ($113.81 in chips) 
Seat 4: Trojanovich ($168.75 in chips) 
Seat 5: henri789 ($160.13 in chips) 
Seat 6: franco232315 ($153.50 in chips) 
franco232315: posts small blind $0.50
vadjkeee: posts big blind $1
*** HOLE CARDS ***
michasia: folds 
Iospirate: calls $1
Trojanovich: folds 
henri789: folds 
franco232315: folds 
vadjkeee: checks 
*** FLOP *** [5s 7d Th]
vadjkeee: checks 
Iospirate: checks 
*** TURN *** [5s 7d Th] [Ts]
vadjkeee: bets $1.78
Iospirate: folds 
Uncalled bet ($1.78) returned to vadjkeee
vadjkeee collected $2.38 from pot
vadjkeee: doesn't show hand 
*** SUMMARY ***
Total pot $2.50 | Rake $0.12 
Board [5s 7d Th Ts]
Seat 1: vadjkeee (big blind) collected ($2.38)
Seat 2: michasia folded before Flop (didn't bet)
Seat 3: Iospirate folded on the Turn
Seat 4: Trojanovich folded before Flop (didn't bet)
Seat 5: henri789 (button) folded before Flop (didn't bet)
Seat 6: franco232315 (small blind) folded before Flop



PokerStars Hand #254506476570:  Hold'em No Limit ($0.50/$1.00 USD) - 2025/01/22 21:54:22 WET [2025/01/22 16:54:22 ET]
Table 'Ajax III' 6-max Seat #6 is the button
Seat 1: vadjkeee ($142.52 in chips) 
Seat 2: michasia ($101.50 in chips) 
Seat 3: Iospirate ($112.81 in chips) 
Seat 4: Trojanovich ($168.75 in chips) 
Seat 5: henri789 ($160.13 in chips) 
Seat 6: franco232315 ($153 in chips) 
vadjkeee: posts small blind $0.50
michasia: posts big blind $1
*** HOLE CARDS ***
Iospirate: folds 
Trojanovich: folds 
henri789: folds 
franco232315: raises $1.50 to $2.50
vadjkeee: folds 
michasia: folds 
Uncalled bet ($1.50) returned to franco232315
franco232315 collected $2.50 from pot
franco232315: doesn't show hand 
*** SUMMARY ***
Total pot $2.50 | Rake $0 
Seat 1: vadjkeee (small blind) folded before Flop
Seat 2: michasia (big blind) folded before Flop
Seat 3: Iospirate folded before Flop (didn't bet)
Seat 4: Trojanovich folded before Flop (didn't bet)
Seat 5: henri789 folded before Flop (didn't bet)
Seat 6: franco232315 (button) collected ($2.50)



PokerStars Hand #254506480055:  Hold'em No Limit ($0.50/$1.00 USD) - 2025/01/22 21:54:34 WET [2025/01/22 16:54:34 ET]
Table 'Ajax III' 6-max Seat #1 is the button
Seat 1: vadjkeee ($142.02 in chips) 
Seat 2: michasia ($100.50 in chips) 
Seat 3: Iospirate ($112.81 in chips) 
Seat 4: Trojanovich ($168.75 in chips) 
Seat 5: henri789 ($160.13 in chips) 
Seat 6: franco232315 ($154.50 in chips) 
michasia: posts small blind $0.50
Iospirate: posts big blind $1
*** HOLE CARDS ***
Trojanovich: raises $1.50 to $2.50
henri789: folds 
franco232315: folds 
vadjkeee: calls $2.50
michasia: calls $2
Iospirate: folds 
*** FLOP *** [8h Kh 7s]
michasia: checks 
Trojanovich: checks 
vadjkeee: bets $2.67
michasia: folds 
Trojanovich: raises $4.83 to $7.50
vadjkeee: calls $4.83
*** TURN *** [8h Kh 7s] [9c]
Trojanovich: checks 
vadjkeee: checks 
*** RIVER *** [8h Kh 7s 9c] [4d]
Trojanovich: checks 
vadjkeee: checks 
*** SHOW DOWN ***
Trojanovich: shows [Td 9d] (a pair of Nines)
vadjkeee: shows [Ts Th] (a pair of Tens)
vadjkeee collected $22.32 from pot
*** SUMMARY ***
Total pot $23.50 | Rake $1.18 
Board [8h Kh 7s 9c 4d]
Seat 1: vadjkeee (button) showed [Ts Th] and won ($22.32) with a pair of Tens
Seat 2: michasia (small blind) folded on the Flop
Seat 3: Iospirate (big blind) folded before Flop
Seat 4: Trojanovich showed [Td 9d] and lost with a pair of Nines
Seat 5: henri789 folded before Flop (didn't bet)
Seat 6: franco232315 folded before Flop (didn't bet)



PokerStars Hand #254506502952:  Hold'em No Limit ($0.50/$1.00 USD) - 2025/01/22 21:56:13 WET [2025/01/22 16:56:13 ET]
Table 'Ajax III' 6-max Seat #2 is the button
Seat 1: vadjkeee ($154.34 in chips) 
Seat 2: michasia ($100 in chips) 
Seat 3: Iospirate ($111.81 in chips) 
Seat 4: Trojanovich ($158.75 in chips) 
Seat 5: henri789 ($160.13 in chips) 
Seat 6: franco232315 ($154.50 in chips) 
Iospirate: posts small blind $0.50
Trojanovich: posts big blind $1
*** HOLE CARDS ***
henri789: folds 
franco232315: raises $1.20 to $2.20
vadjkeee: folds 
michasia: folds 
Iospirate: folds 
Trojanovich: folds 
Uncalled bet ($1.20) returned to franco232315
franco232315 collected $2.50 from pot
franco232315: doesn't show hand 
*** SUMMARY ***
Total pot $2.50 | Rake $0 
Seat 1: vadjkeee folded before Flop (didn't bet)
Seat 2: michasia (button) folded before Flop (didn't bet)
Seat 3: Iospirate (small blind) folded before Flop
Seat 4: Trojanovich (big blind) folded before Flop
Seat 5: henri789 folded before Flop (didn't bet)
Seat 6: franco232315 collected ($2.50)



PokerStars Hand #254506505545:  Hold'em No Limit ($0.50/$1.00 USD) - 2025/01/22 21:56:26 WET [2025/01/22 16:56:26 ET]
Table 'Ajax III' 6-max Seat #3 is the button
Seat 1: vadjkeee ($154.34 in chips) 
Seat 2: michasia ($100 in chips) 
Seat 3: Iospirate ($111.31 in chips) 
Seat 4: Trojanovich ($157.75 in chips) 
Seat 5: henri789 ($160.13 in chips) 
Seat 6: franco232315 ($156 in chips) 
Trojanovich: posts small blind $0.50
henri789: posts big blind $1
*** HOLE CARDS ***
franco232315: raises $1.20 to $2.20
vadjkeee: folds 
michasia: raises $4.40 to $6.60
Iospirate: folds 
Trojanovich: folds 
henri789: folds 
franco232315: calls $4.40
*** FLOP *** [Ah 2c Kd]
franco232315: checks 
michasia: bets $4.61
franco232315: folds 
Uncalled bet ($4.61) returned to michasia
michasia collected $13.96 from pot
michasia: doesn't show hand 
*** SUMMARY ***
Total pot $14.70 | Rake $0.74 
Board [Ah 2c Kd]
Seat 1: vadjkeee folded before Flop (didn't bet)
Seat 2: michasia collected ($13.96)
Seat 3: Iospirate (button) folded before Flop (didn't bet)
Seat 4: Trojanovich (small blind) folded before Flop
Seat 5: henri789 (big blind) folded before Flop
Seat 6: franco232315 folded on the Flop



PokerStars Hand #254506513688:  Hold'em No Limit ($0.50/$1.00 USD) - 2025/01/22 21:57:06 WET [2025/01/22 16:57:06 ET]
Table 'Ajax III' 6-max Seat #4 is the button
Seat 1: vadjkeee ($154.34 in chips) 
Seat 2: michasia ($107.36 in chips) 
Seat 3: Iospirate ($111.31 in chips) 
Seat 4: Trojanovich ($157.25 in chips) 
Seat 5: henri789 ($159.13 in chips) 
Seat 6: franco232315 ($149.40 in chips) 
henri789: posts small blind $0.50
franco232315: posts big blind $1
*** HOLE CARDS ***
vadjkeee: folds 
michasia: folds 
Iospirate: calls $1
Trojanovich: folds 
henri789: raises $4 to $5
franco232315: calls $4
Iospirate: calls $4
*** FLOP *** [2h 7d Qh]
henri789: checks 
franco232315: checks 
Iospirate: checks 
*** TURN *** [2h 7d Qh] [2c]
henri789: bets $10.69
vadjkeee leaves the table
franco232315: calls $10.69
Iospirate: folds 
*** RIVER *** [2h 7d Qh 2c] [3s]
amitnain00012 joins the table at seat #1 
amitnain00012 is disconnected 
henri789: bets $34.56
franco232315: folds 
Uncalled bet ($34.56) returned to henri789
henri789 collected $34.56 from pot
henri789: doesn't show hand 
*** SUMMARY ***
Total pot $36.38 | Rake $1.82 
Board [2h 7d Qh 2c 3s]
Seat 1: vadjkeee folded before Flop (didn't bet)
Seat 2: michasia folded before Flop (didn't bet)
Seat 3: Iospirate folded on the Turn
Seat 4: Trojanovich (button) folded before Flop (didn't bet)
Seat 5: henri789 (small blind) collected ($34.56)
Seat 6: franco232315 (big blind) folded on the River



PokerStars Hand #254506536809:  Hold'em No Limit ($0.50/$1.00 USD) - 2025/01/22 21:58:59 WET [2025/01/22 16:58:59 ET]
Table 'Ajax III' 6-max Seat #5 is the button
Seat 1: amitnain00012 ($56.12 in chips) 
Seat 2: michasia ($107.36 in chips) 
Seat 3: Iospirate ($106.31 in chips) 
Seat 4: Trojanovich ($157.25 in chips) 
Seat 5: henri789 ($178 in chips) 
Seat 6: franco232315 ($133.71 in chips) 
franco232315: posts small blind $0.50
amitnain00012: posts big blind $1
*** HOLE CARDS ***
michasia: folds 
Iospirate: calls $1
Trojanovich: folds 
henri789: folds 
franco232315: raises $4 to $5
amitnain00012: calls $4
Iospirate: calls $4
*** FLOP *** [3d 9d 7c]
franco232315: checks 
amitnain00012: bets $2
Iospirate: calls $2
franco232315: calls $2
*** TURN *** [3d 9d 7c] [3c]
franco232315: checks 
amitnain00012: bets $2
Iospirate: folds 
franco232315: calls $2
*** RIVER *** [3d 9d 7c 3c] [Qd]
franco232315: checks 
amitnain00012: checks 
*** SHOW DOWN ***
franco232315: shows [Ah Th] (a pair of Threes)
amitnain00012: shows [4c 9c] (two pair, Nines and Threes)
amitnain00012 collected $23.75 from pot
*** SUMMARY ***
Total pot $25 | Rake $1.25 
Board [3d 9d 7c 3c Qd]
Seat 1: amitnain00012 (big blind) showed [4c 9c] and won ($23.75) with two pair, Nines and Threes
Seat 2: michasia folded before Flop (didn't bet)
Seat 3: Iospirate folded on the Turn
Seat 4: Trojanovich folded before Flop (didn't bet)
Seat 5: henri789 (button) folded before Flop (didn't bet)
Seat 6: franco232315 (small blind) showed [Ah Th] and lost with a pair of Threes



PokerStars Hand #254506551988:  Hold'em No Limit ($0.50/$1.00 USD) - 2025/01/22 22:00:13 WET [2025/01/22 17:00:13 ET]
Table 'Ajax III' 6-max Seat #6 is the button
Seat 1: amitnain00012 ($70.87 in chips) 
Seat 2: michasia ($107.36 in chips) 
Seat 3: Iospirate ($99.31 in chips) 
Seat 4: Trojanovich ($157.25 in chips) 
Seat 5: henri789 ($178 in chips) 
Seat 6: franco232315 ($124.71 in chips) 
amitnain00012: posts small blind $0.50
michasia: posts big blind $1
*** HOLE CARDS ***
Iospirate: folds 
Trojanovich: folds 
henri789: folds 
franco232315: raises $1.50 to $2.50
amitnain00012: calls $2
michasia: raises $11.50 to $14
franco232315: folds 
amitnain00012: folds 
Uncalled bet ($11.50) returned to michasia
michasia collected $7.50 from pot
michasia: doesn't show hand 
*** SUMMARY ***
Total pot $7.50 | Rake $0 
Seat 1: amitnain00012 (small blind) folded before Flop
Seat 2: michasia (big blind) collected ($7.50)
Seat 3: Iospirate folded before Flop (didn't bet)
Seat 4: Trojanovich folded before Flop (didn't bet)
Seat 5: henri789 folded before Flop (didn't bet)
Seat 6: franco232315 (button) folded before Flop



PokerStars Hand #254506557472:  Hold'em No Limit ($0.50/$1.00 USD) - 2025/01/22 22:00:38 WET [2025/01/22 17:00:38 ET]
Table 'Ajax III' 6-max Seat #1 is the button
Seat 1: amitnain00012 ($68.37 in chips) 
Seat 2: michasia ($112.36 in chips) 
Seat 3: Iospirate ($99.31 in chips) 
Seat 4: Trojanovich ($157.25 in chips) 
Seat 5: henri789 ($178 in chips) 
Seat 6: franco232315 ($122.21 in chips) 
michasia: posts small blind $0.50
Iospirate: posts big blind $1
*** HOLE CARDS ***
Trojanovich: folds 
henri789: folds 
franco232315: folds 
amitnain00012: calls $1
michasia: folds 
Iospirate: checks 
*** FLOP *** [8d Jd 2h]
Iospirate: checks 
amitnain00012: checks 
*** TURN *** [8d Jd 2h] [Kc]
Iospirate: checks 
amitnain00012: bets $2
Iospirate: folds 
Uncalled bet ($2) returned to amitnain00012
amitnain00012 collected $2.38 from pot
*** SUMMARY ***
Total pot $2.50 | Rake $0.12 
Board [8d Jd 2h Kc]
Seat 1: amitnain00012 (button) collected ($2.38)
Seat 2: michasia (small blind) folded before Flop
Seat 3: Iospirate (big blind) folded on the Turn
Seat 4: Trojanovich folded before Flop (didn't bet)
Seat 5: henri789 folded before Flop (didn't bet)
Seat 6: franco232315 folded before Flop (didn't bet)



PokerStars Hand #254506563176:  Hold'em No Limit ($0.50/$1.00 USD) - 2025/01/22 22:01:04 WET [2025/01/22 17:01:04 ET]
Table 'Ajax III' 6-max Seat #2 is the button
Seat 1: amitnain00012 ($69.75 in chips) 
Seat 2: michasia ($111.86 in chips) 
Seat 3: Iospirate ($98.31 in chips) 
Seat 4: Trojanovich ($157.25 in chips) 
Seat 5: henri789 ($178 in chips) 
Seat 6: franco232315 ($122.21 in chips) 
Iospirate: posts small blind $0.50
Trojanovich: posts big blind $1
*** HOLE CARDS ***
henri789: folds 
franco232315: folds 
amitnain00012: raises $1 to $2
michasia: folds 
Iospirate: folds 
Trojanovich: folds 
Uncalled bet ($1) returned to amitnain00012
amitnain00012 collected $2.50 from pot
*** SUMMARY ***
Total pot $2.50 | Rake $0 
Seat 1: amitnain00012 collected ($2.50)
Seat 2: michasia (button) folded before Flop (didn't bet)
Seat 3: Iospirate (small blind) folded before Flop
Seat 4: Trojanovich (big blind) folded before Flop
Seat 5: henri789 folded before Flop (didn't bet)
Seat 6: franco232315 folded before Flop (didn't bet)



PokerStars Hand #254506567934:  Hold'em No Limit ($0.50/$1.00 USD) - 2025/01/22 22:01:23 WET [2025/01/22 17:01:23 ET]
Table 'Ajax III' 6-max Seat #3 is the button
Seat 1: amitnain00012 ($71.25 in chips) 
Seat 2: michasia ($111.86 in chips) 
Seat 3: Iospirate ($97.81 in chips) 
Seat 4: Trojanovich ($156.25 in chips) 
Seat 5: henri789 ($178 in chips) 
Seat 6: franco232315 ($122.21 in chips) 
Trojanovich: posts small blind $0.50
henri789: posts big blind $1
*** HOLE CARDS ***
franco232315: folds 
amitnain00012: folds 
michasia: folds 
Iospirate: folds 
Trojanovich: raises $2 to $3
henri789: folds 
Uncalled bet ($2) returned to Trojanovich
Trojanovich collected $2 from pot
Trojanovich: doesn't show hand 
*** SUMMARY ***
Total pot $2 | Rake $0 
Seat 1: amitnain00012 folded before Flop (didn't bet)
Seat 2: michasia folded before Flop (didn't bet)
Seat 3: Iospirate (button) folded before Flop (didn't bet)
Seat 4: Trojanovich (small blind) collected ($2)
Seat 5: henri789 (big blind) folded before Flop
Seat 6: franco232315 folded before Flop (didn't bet)



PokerStars Hand #254506572651:  Hold'em No Limit ($0.50/$1.00 USD) - 2025/01/22 22:01:41 WET [2025/01/22 17:01:41 ET]
Table 'Ajax III' 6-max Seat #4 is the button
Seat 1: amitnain00012 ($71.25 in chips) 
Seat 2: michasia ($111.86 in chips) 
Seat 3: Iospirate ($97.81 in chips) 
Seat 4: Trojanovich ($157.25 in chips) 
Seat 5: henri789 ($177 in chips) 
Seat 6: franco232315 ($122.21 in chips) 
henri789: posts small blind $0.50
franco232315: posts big blind $1
*** HOLE CARDS ***
amitnain00012: raises $1 to $2
michasia: folds 
Iospirate: folds 
Trojanovich: raises $3.50 to $5.50
henri789: folds 
franco232315: folds 
amitnain00012: calls $3.50
*** FLOP *** [Ts 6s 4h]
amitnain00012: bets $3
Trojanovich: calls $3
*** TURN *** [Ts 6s 4h] [Qd]
amitnain00012: bets $3
Trojanovich: calls $3
*** RIVER *** [Ts 6s 4h Qd] [2c]
amitnain00012: bets $6
Trojanovich: calls $6
*** SHOW DOWN ***
amitnain00012: shows [Ks 2s] (a pair of Deuces)
Trojanovich: shows [9h Th] (a pair of Tens)
Trojanovich collected $34.68 from pot
*** SUMMARY ***
Total pot $36.50 | Rake $1.82 
Board [Ts 6s 4h Qd 2c]
Seat 1: amitnain00012 showed [Ks 2s] and lost with a pair of Deuces
Seat 2: michasia folded before Flop (didn't bet)
Seat 3: Iospirate folded before Flop (didn't bet)
Seat 4: Trojanovich (button) showed [9h Th] and won ($34.68) with a pair of Tens
Seat 5: henri789 (small blind) folded before Flop
Seat 6: franco232315 (big blind) folded before Flop



PokerStars Hand #254506585883:  Hold'em No Limit ($0.50/$1.00 USD) - 2025/01/22 22:02:30 WET [2025/01/22 17:02:30 ET]
Table 'Ajax III' 6-max Seat #5 is the button
Seat 1: amitnain00012 ($53.75 in chips) 
Seat 2: michasia ($111.86 in chips) 
Seat 3: Iospirate ($97.81 in chips) 
Seat 4: Trojanovich ($174.43 in chips) 
Seat 5: henri789 ($176.50 in chips) 
Seat 6: franco232315 ($121.21 in chips) 
franco232315: posts small blind $0.50
amitnain00012: posts big blind $1
*** HOLE CARDS ***
michasia: raises $1.60 to $2.60
Iospirate: folds 
Trojanovich: folds 
henri789: folds 
franco232315: folds 
amitnain00012: calls $1.60
*** FLOP *** [Qh 9d 7h]
amitnain00012: bets $4
michasia: raises $8 to $12
amitnain00012: calls $8
*** TURN *** [Qh 9d 7h] [Kh]
amitnain00012: bets $9
michasia: folds 
Uncalled bet ($9) returned to amitnain00012
amitnain00012 collected $28.22 from pot
*** SUMMARY ***
Total pot $29.70 | Rake $1.48 
Board [Qh 9d 7h Kh]
Seat 1: amitnain00012 (big blind) collected ($28.22)
Seat 2: michasia folded on the Turn
Seat 3: Iospirate folded before Flop (didn't bet)
Seat 4: Trojanovich folded before Flop (didn't bet)
Seat 5: henri789 (button) folded before Flop (didn't bet)
Seat 6: franco232315 (small blind) folded before Flop



PokerStars Hand #254506598348:  Hold'em No Limit ($0.50/$1.00 USD) - 2025/01/22 22:03:15 WET [2025/01/22 17:03:15 ET]
Table 'Ajax III' 6-max Seat #6 is the button
Seat 1: amitnain00012 ($67.37 in chips) 
Seat 2: michasia ($100 in chips) 
Seat 3: Iospirate ($97.81 in chips) 
Seat 4: Trojanovich ($174.43 in chips) 
Seat 5: henri789 ($176.50 in chips) 
Seat 6: franco232315 ($120.71 in chips) 
amitnain00012: posts small blind $0.50
michasia: posts big blind $1
*** HOLE CARDS ***
Iospirate: calls $1
Trojanovich: folds 
henri789: folds 
franco232315: folds 
amitnain00012: calls $0.50
michasia: raises $4 to $5
Iospirate: calls $4
amitnain00012: folds 
*** FLOP *** [5d Ah 8d]
michasia: checks 
Iospirate: checks 
*** TURN *** [5d Ah 8d] [9h]
michasia: checks 
Iospirate: bets $6
michasia: calls $6
*** RIVER *** [5d Ah 8d 9h] [Ad]
michasia: checks 
Iospirate: bets $86.81 and is all-in
michasia: folds 
Uncalled bet ($86.81) returned to Iospirate
Iospirate collected $21.85 from pot
Iospirate: doesn't show hand 
*** SUMMARY ***
Total pot $23 | Rake $1.15 
Board [5d Ah 8d 9h Ad]
Seat 1: amitnain00012 (small blind) folded before Flop
Seat 2: michasia (big blind) folded on the River
Seat 3: Iospirate collected ($21.85)
Seat 4: Trojanovich folded before Flop (didn't bet)
Seat 5: henri789 folded before Flop (didn't bet)
Seat 6: franco232315 (button) folded before Flop (didn't bet)



PokerStars Hand #254506612409:  Hold'em No Limit ($0.50/$1.00 USD) - 2025/01/22 22:04:06 WET [2025/01/22 17:04:06 ET]
Table 'Ajax III' 6-max Seat #1 is the button
Seat 1: amitnain00012 ($66.37 in chips) 
Seat 2: michasia ($100 in chips) 
Seat 3: Iospirate ($108.66 in chips) 
Seat 4: Trojanovich ($174.43 in chips) 
Seat 5: henri789 ($176.50 in chips) 
Seat 6: franco232315 ($120.71 in chips) 
michasia: posts small blind $0.50
Iospirate: posts big blind $1
*** HOLE CARDS ***
Trojanovich: folds 
henri789: folds 
franco232315: folds 
amitnain00012: calls $1
michasia: folds 
Iospirate: checks 
*** FLOP *** [3h 2d 5h]
Iospirate: checks 
amitnain00012: checks 
*** TURN *** [3h 2d 5h] [Tc]
Iospirate: checks 
amitnain00012: checks 
*** RIVER *** [3h 2d 5h Tc] [9h]
Iospirate: checks 
amitnain00012: checks 
*** SHOW DOWN ***
Iospirate: shows [Qs 6c] (high card Queen)
amitnain00012: shows [Ks Ad] (high card Ace)
amitnain00012 collected $2.38 from pot
*** SUMMARY ***
Total pot $2.50 | Rake $0.12 
Board [3h 2d 5h Tc 9h]
Seat 1: amitnain00012 (button) showed [Ks Ad] and won ($2.38) with high card Ace
Seat 2: michasia (small blind) folded before Flop
Seat 3: Iospirate (big blind) showed [Qs 6c] and lost with high card Queen
Seat 4: Trojanovich folded before Flop (didn't bet)
Seat 5: henri789 folded before Flop (didn't bet)
Seat 6: franco232315 folded before Flop (didn't bet)



PokerStars Hand #254506622812:  Hold'em No Limit ($0.50/$1.00 USD) - 2025/01/22 22:04:43 WET [2025/01/22 17:04:43 ET]
Table 'Ajax III' 6-max Seat #2 is the button
Seat 1: amitnain00012 ($67.75 in chips) 
Seat 2: michasia ($100 in chips) 
Seat 3: Iospirate ($107.66 in chips) 
Seat 4: Trojanovich ($174.43 in chips) 
Seat 5: henri789 ($176.50 in chips) 
Seat 6: franco232315 ($120.71 in chips) 
Iospirate: posts small blind $0.50
Trojanovich: posts big blind $1
*** HOLE CARDS ***
henri789: folds 
franco232315: folds 
amitnain00012: calls $1
michasia: folds 
Iospirate: folds 
Trojanovich: checks 
*** FLOP *** [6h 7h 4s]
Trojanovich: checks 
amitnain00012: bets $2
Trojanovich: calls $2
*** TURN *** [6h 7h 4s] [Kh]
Trojanovich: checks 
amitnain00012: bets $2
Trojanovich: folds 
Uncalled bet ($2) returned to amitnain00012
amitnain00012 collected $6.18 from pot
*** SUMMARY ***
Total pot $6.50 | Rake $0.32 
Board [6h 7h 4s Kh]
Seat 1: amitnain00012 collected ($6.18)
Seat 2: michasia (button) folded before Flop (didn't bet)
Seat 3: Iospirate (small blind) folded before Flop
Seat 4: Trojanovich (big blind) folded on the Turn
Seat 5: henri789 folded before Flop (didn't bet)
Seat 6: franco232315 folded before Flop (didn't bet)



PokerStars Hand #254506633920:  Hold'em No Limit ($0.50/$1.00 USD) - 2025/01/22 22:05:23 WET [2025/01/22 17:05:23 ET]
Table 'Ajax III' 6-max Seat #3 is the button
Seat 1: amitnain00012 ($70.93 in chips) 
Seat 2: michasia ($100 in chips) 
Seat 3: Iospirate ($107.16 in chips) 
Seat 4: Trojanovich ($171.43 in chips) 
Seat 5: henri789 ($176.50 in chips) 
Seat 6: franco232315 ($120.71 in chips) 
Trojanovich: posts small blind $0.50
henri789: posts big blind $1
*** HOLE CARDS ***
franco232315: folds 
amitnain00012: calls $1
michasia: folds 
franco232315 leaves the table
Iospirate: folds 
Trojanovich: folds 
henri789: checks 
*** FLOP *** [Jc 8d 6d]
henri789: checks 
amitnain00012: bets $1
xcinaz joins the table at seat #6 
henri789: calls $1
*** TURN *** [Jc 8d 6d] [As]
henri789: checks 
amitnain00012: checks 
*** RIVER *** [Jc 8d 6d As] [6s]
henri789: bets $3.50
amitnain00012: calls $3.50
*** SHOW DOWN ***
henri789: shows [3h 6c] (three of a kind, Sixes)
amitnain00012: mucks hand 
henri789 collected $10.92 from pot
*** SUMMARY ***
Total pot $11.50 | Rake $0.58 
Board [Jc 8d 6d As 6s]
Seat 1: amitnain00012 mucked
Seat 2: michasia folded before Flop (didn't bet)
Seat 3: Iospirate (button) folded before Flop (didn't bet)
Seat 4: Trojanovich (small blind) folded before Flop
Seat 5: henri789 (big blind) showed [3h 6c] and won ($10.92) with three of a kind, Sixes
Seat 6: franco232315 folded before Flop (didn't bet)



PokerStars Hand #254506646054:  Hold'em No Limit ($0.50/$1.00 USD) - 2025/01/22 22:06:06 WET [2025/01/22 17:06:06 ET]
Table 'Ajax III' 6-max Seat #4 is the button
Seat 1: amitnain00012 ($65.43 in chips) 
Seat 2: michasia ($100 in chips) 
Seat 3: Iospirate ($107.16 in chips) 
Seat 4: Trojanovich ($170.93 in chips) 
Seat 5: henri789 ($181.92 in chips) 
Seat 6: xcinaz ($100 in chips) 
henri789: posts small blind $0.50
xcinaz: posts big blind $1
*** HOLE CARDS ***
amitnain00012 is disconnected 
amitnain00012 has timed out while disconnected
amitnain00012: folds 
michasia: raises $1.60 to $2.60
Iospirate: calls $2.60
Trojanovich: folds 
henri789: folds 
xcinaz: folds 
*** FLOP *** [9h 5h Ad]
michasia: checks 
Iospirate: checks 
*** TURN *** [9h 5h Ad] [7d]
michasia: checks 
Iospirate: checks 
*** RIVER *** [9h 5h Ad 7d] [5d]
michasia: checks 
Iospirate: checks 
*** SHOW DOWN ***
michasia: shows [5c 4c] (three of a kind, Fives)
Iospirate: mucks hand 
michasia collected $6.36 from pot
*** SUMMARY ***
Total pot $6.70 | Rake $0.34 
Board [9h 5h Ad 7d 5d]
Seat 1: amitnain00012 folded before Flop (didn't bet)
Seat 2: michasia showed [5c 4c] and won ($6.36) with three of a kind, Fives
Seat 3: Iospirate mucked
Seat 4: Trojanovich (button) folded before Flop (didn't bet)
Seat 5: henri789 (small blind) folded before Flop
Seat 6: xcinaz (big blind) folded before Flop



PokerStars Hand #254506667214:  Hold'em No Limit ($0.50/$1.00 USD) - 2025/01/22 22:07:22 WET [2025/01/22 17:07:22 ET]
Table 'Ajax III' 6-max Seat #5 is the button
Seat 1: amitnain00012 ($65.43 in chips) 
Seat 2: michasia ($103.76 in chips) 
Seat 3: Iospirate ($104.56 in chips) 
Seat 4: Trojanovich ($170.93 in chips) 
Seat 5: henri789 ($181.42 in chips) 
Seat 6: xcinaz ($100 in chips) 
xcinaz: posts small blind $0.50
amitnain00012: posts big blind $1
*** HOLE CARDS ***
michasia: folds 
Iospirate: folds 
Trojanovich: folds 
henri789: raises $1.20 to $2.20
xcinaz: raises $9.30 to $11.50
amitnain00012: folds 
henri789: folds 
Uncalled bet ($9.30) returned to xcinaz
xcinaz collected $5.40 from pot
xcinaz: doesn't show hand 
*** SUMMARY ***
Total pot $5.40 | Rake $0 
Seat 1: amitnain00012 (big blind) folded before Flop
Seat 2: michasia folded before Flop (didn't bet)
Seat 3: Iospirate folded before Flop (didn't bet)
Seat 4: Trojanovich folded before Flop (didn't bet)
Seat 5: henri789 (button) folded before Flop
Seat 6: xcinaz (small blind) collected ($5.40)



PokerStars Hand #254506676803:  Hold'em No Limit ($0.50/$1.00 USD) - 2025/01/22 22:07:55 WET [2025/01/22 17:07:55 ET]
Table 'Ajax III' 6-max Seat #6 is the button
Seat 1: amitnain00012 ($64.43 in chips) 
Seat 2: michasia ($103.76 in chips) 
Seat 3: Iospirate ($104.56 in chips) 
Seat 4: Trojanovich ($170.93 in chips) 
Seat 5: henri789 ($179.22 in chips) 
Seat 6: xcinaz ($103.20 in chips) 
amitnain00012: posts small blind $0.50
michasia: posts big blind $1
*** HOLE CARDS ***
Iospirate: folds 
Trojanovich: folds 
henri789: raises $1.20 to $2.20
xcinaz: folds 
amitnain00012: calls $1.70
michasia: folds 
*** FLOP *** [Kc Ts 9c]
amitnain00012: checks 
henri789: bets $2.51
amitnain00012: calls $2.51
*** TURN *** [Kc Ts 9c] [4d]
amitnain00012: checks 
henri789: bets $9.90
amitnain00012: calls $9.90
*** RIVER *** [Kc Ts 9c 4d] [6d]
amitnain00012: checks 
henri789: bets $55
amitnain00012: folds 
Uncalled bet ($55) returned to henri789
henri789 collected $28.71 from pot
henri789: doesn't show hand 
*** SUMMARY ***
Total pot $30.22 | Rake $1.51 
Board [Kc Ts 9c 4d 6d]
Seat 1: amitnain00012 (small blind) folded on the River
Seat 2: michasia (big blind) folded before Flop
Seat 3: Iospirate folded before Flop (didn't bet)
Seat 4: Trojanovich folded before Flop (didn't bet)
Seat 5: henri789 collected ($28.71)
Seat 6: xcinaz (button) folded before Flop (didn't bet)



PokerStars Hand #254506700456:  Hold'em No Limit ($0.50/$1.00 USD) - 2025/01/22 22:09:18 WET [2025/01/22 17:09:18 ET]
Table 'Ajax III' 6-max Seat #1 is the button
Seat 1: amitnain00012 ($49.82 in chips) 
Seat 2: michasia ($102.76 in chips) 
Seat 3: Iospirate ($104.56 in chips) 
Seat 4: Trojanovich ($170.93 in chips) 
Seat 5: henri789 ($193.32 in chips) 
Seat 6: xcinaz ($103.20 in chips) 
michasia: posts small blind $0.50
Iospirate: posts big blind $1
*** HOLE CARDS ***
Trojanovich: folds 
henri789: folds 
xcinaz: folds 
amitnain00012: folds 
michasia: raises $2 to $3
Iospirate: folds 
Uncalled bet ($2) returned to michasia
michasia collected $2 from pot
michasia: doesn't show hand 
*** SUMMARY ***
Total pot $2 | Rake $0 
Seat 1: amitnain00012 (button) folded before Flop (didn't bet)
Seat 2: michasia (small blind) collected ($2)
Seat 3: Iospirate (big blind) folded before Flop
Seat 4: Trojanovich folded before Flop (didn't bet)
Seat 5: henri789 folded before Flop (didn't bet)
Seat 6: xcinaz folded before Flop (didn't bet)



PokerStars Hand #254506704007:  Hold'em No Limit ($0.50/$1.00 USD) - 2025/01/22 22:09:31 WET [2025/01/22 17:09:31 ET]
Table 'Ajax III' 6-max Seat #2 is the button
Seat 1: amitnain00012 ($49.82 in chips) 
Seat 2: michasia ($103.76 in chips) 
Seat 3: Iospirate ($103.56 in chips) 
Seat 4: Trojanovich ($170.93 in chips) 
Seat 5: henri789 ($193.32 in chips) 
Seat 6: xcinaz ($103.20 in chips) 
Iospirate: posts small blind $0.50
Trojanovich: posts big blind $1
*** HOLE CARDS ***
henri789: folds 
xcinaz: folds 
amitnain00012: calls $1
michasia: raises $2.50 to $3.50
Iospirate: calls $3
Trojanovich: folds 
amitnain00012: calls $2.50
*** FLOP *** [6s Kc Tc]
Iospirate: checks 
amitnain00012: checks 
michasia: checks 
*** TURN *** [6s Kc Tc] [Qs]
Iospirate: checks 
amitnain00012: bets $3
michasia: folds 
Iospirate: calls $3
*** RIVER *** [6s Kc Tc Qs] [8c]
Iospirate: checks 
amitnain00012: bets $3
Iospirate: folds 
Uncalled bet ($3) returned to amitnain00012
amitnain00012 collected $16.62 from pot
*** SUMMARY ***
Total pot $17.50 | Rake $0.88 
Board [6s Kc Tc Qs 8c]
Seat 1: amitnain00012 collected ($16.62)
Seat 2: michasia (button) folded on the Turn
Seat 3: Iospirate (small blind) folded on the River
Seat 4: Trojanovich (big blind) folded before Flop
Seat 5: henri789 folded before Flop (didn't bet)
Seat 6: xcinaz folded before Flop (didn't bet)



PokerStars Hand #254506718864:  Hold'em No Limit ($0.50/$1.00 USD) - 2025/01/22 22:10:23 WET [2025/01/22 17:10:23 ET]
Table 'Ajax III' 6-max Seat #3 is the button
Seat 1: amitnain00012 ($59.94 in chips) 
Seat 2: michasia ($100.26 in chips) 
Seat 3: Iospirate ($97.06 in chips) 
Seat 4: Trojanovich ($169.93 in chips) 
Seat 5: henri789 ($193.32 in chips) 
Seat 6: xcinaz ($103.20 in chips) 
Trojanovich: posts small blind $0.50
henri789: posts big blind $1
*** HOLE CARDS ***
xcinaz: folds 
amitnain00012: calls $1
michasia: folds 
Iospirate: calls $1
Trojanovich: folds 
henri789: checks 
*** FLOP *** [9c 5s 7h]
henri789: checks 
amitnain00012: bets $1
Iospirate: calls $1
henri789: folds 
*** TURN *** [9c 5s 7h] [Jd]
amitnain00012: bets $2
Iospirate: calls $2
*** RIVER *** [9c 5s 7h Jd] [3s]
amitnain00012: bets $4
Iospirate: folds 
Uncalled bet ($4) returned to amitnain00012
amitnain00012 collected $9.02 from pot
*** SUMMARY ***
Total pot $9.50 | Rake $0.48 
Board [9c 5s 7h Jd 3s]
Seat 1: amitnain00012 collected ($9.02)
Seat 2: michasia folded before Flop (didn't bet)
Seat 3: Iospirate (button) folded on the River
Seat 4: Trojanovich (small blind) folded before Flop
Seat 5: henri789 (big blind) folded on the Flop
Seat 6: xcinaz folded before Flop (didn't bet)



PokerStars Hand #254506730020:  Hold'em No Limit ($0.50/$1.00 USD) - 2025/01/22 22:11:02 WET [2025/01/22 17:11:02 ET]
Table 'Ajax III' 6-max Seat #4 is the button
Seat 1: amitnain00012 ($64.96 in chips) 
Seat 2: michasia ($100.26 in chips) 
Seat 3: Iospirate ($93.06 in chips) 
Seat 4: Trojanovich ($169.43 in chips) 
Seat 5: henri789 ($192.32 in chips) 
Seat 6: xcinaz ($103.20 in chips) 
henri789: posts small blind $0.50
xcinaz: posts big blind $1
*** HOLE CARDS ***
amitnain00012: calls $1
michasia: folds 
Iospirate: calls $1
Trojanovich: raises $3 to $4
henri789: calls $3.50
xcinaz: folds 
amitnain00012: calls $3
Iospirate: calls $3
*** FLOP *** [2s 5c 5d]
henri789: checks 
amitnain00012: checks 
Iospirate: checks 
Trojanovich: bets $5.33
henri789: folds 
amitnain00012: folds 
Iospirate: raises $9.67 to $15
Trojanovich: calls $9.67
*** TURN *** [2s 5c 5d] [3h]
Iospirate: bets $41
Trojanovich: folds 
Uncalled bet ($41) returned to Iospirate
Iospirate collected $44.65 from pot
Iospirate: doesn't show hand 
*** SUMMARY ***
Total pot $47 | Rake $2.35 
Board [2s 5c 5d 3h]
Seat 1: amitnain00012 folded on the Flop
Seat 2: michasia folded before Flop (didn't bet)
Seat 3: Iospirate collected ($44.65)
Seat 4: Trojanovich (button) folded on the Turn
Seat 5: henri789 (small blind) folded on the Flop
Seat 6: xcinaz (big blind) folded before Flop



PokerStars Hand #254506754223:  Hold'em No Limit ($0.50/$1.00 USD) - 2025/01/22 22:12:27 WET [2025/01/22 17:12:27 ET]
Table 'Ajax III' 6-max Seat #5 is the button
Seat 1: amitnain00012 ($60.96 in chips) 
Seat 2: michasia ($100.26 in chips) 
Seat 3: Iospirate ($118.71 in chips) 
Seat 4: Trojanovich ($150.43 in chips) 
Seat 5: henri789 ($188.32 in chips) 
Seat 6: xcinaz ($102.20 in chips) 
xcinaz: posts small blind $0.50
amitnain00012: posts big blind $1
*** HOLE CARDS ***
michasia: folds 
Iospirate: folds 
Trojanovich: folds 
henri789: folds 
xcinaz: folds 
Uncalled bet ($0.50) returned to amitnain00012
amitnain00012 collected $1 from pot
*** SUMMARY ***
Total pot $1 | Rake $0 
Seat 1: amitnain00012 (big blind) collected ($1)
Seat 2: michasia folded before Flop (didn't bet)
Seat 3: Iospirate folded before Flop (didn't bet)
Seat 4: Trojanovich folded before Flop (didn't bet)
Seat 5: henri789 (button) folded before Flop (didn't bet)
Seat 6: xcinaz (small blind) folded before Flop



PokerStars Hand #254506758266:  Hold'em No Limit ($0.50/$1.00 USD) - 2025/01/22 22:12:42 WET [2025/01/22 17:12:42 ET]
Table 'Ajax III' 6-max Seat #6 is the button
Seat 1: amitnain00012 ($61.46 in chips) 
Seat 2: michasia ($100.26 in chips) 
Seat 3: Iospirate ($118.71 in chips) 
Seat 4: Trojanovich ($150.43 in chips) 
Seat 5: henri789 ($188.32 in chips) 
Seat 6: xcinaz ($101.70 in chips) 
amitnain00012: posts small blind $0.50
michasia: posts big blind $1
*** HOLE CARDS ***
Iospirate: folds 
Trojanovich: folds 
henri789: folds 
xcinaz: raises $1.50 to $2.50
amitnain00012: calls $2
michasia: folds 
*** FLOP *** [3d 8s 9d]
amitnain00012: checks 
xcinaz: checks 
*** TURN *** [3d 8s 9d] [Ad]
amitnain00012: bets $3
xcinaz: folds 
Uncalled bet ($3) returned to amitnain00012
amitnain00012 collected $5.70 from pot
*** SUMMARY ***
Total pot $6 | Rake $0.30 
Board [3d 8s 9d Ad]
Seat 1: amitnain00012 (small blind) collected ($5.70)
Seat 2: michasia (big blind) folded before Flop
Seat 3: Iospirate folded before Flop (didn't bet)
Seat 4: Trojanovich folded before Flop (didn't bet)
Seat 5: henri789 folded before Flop (didn't bet)
Seat 6: xcinaz (button) folded on the Turn



PokerStars Hand #254506770702:  Hold'em No Limit ($0.50/$1.00 USD) - 2025/01/22 22:13:26 WET [2025/01/22 17:13:26 ET]
Table 'Ajax III' 6-max Seat #1 is the button
Seat 1: amitnain00012 ($64.66 in chips) 
Seat 2: michasia ($100 in chips) 
Seat 3: Iospirate ($118.71 in chips) 
Seat 4: Trojanovich ($150.43 in chips) 
Seat 5: henri789 ($188.32 in chips) 
Seat 6: xcinaz ($100 in chips) 
michasia: posts small blind $0.50
Iospirate: posts big blind $1
*** HOLE CARDS ***
Trojanovich: folds 
henri789: folds 
xcinaz: folds 
amitnain00012: calls $1
michasia: folds 
Iospirate: checks 
*** FLOP *** [5c Kh 9s]
Iospirate: checks 
amitnain00012: bets $1
Iospirate: folds 
Uncalled bet ($1) returned to amitnain00012
amitnain00012 collected $2.38 from pot
*** SUMMARY ***
Total pot $2.50 | Rake $0.12 
Board [5c Kh 9s]
Seat 1: amitnain00012 (button) collected ($2.38)
Seat 2: michasia (small blind) folded before Flop
Seat 3: Iospirate (big blind) folded on the Flop
Seat 4: Trojanovich folded before Flop (didn't bet)
Seat 5: henri789 folded before Flop (didn't bet)
Seat 6: xcinaz folded before Flop (didn't bet)



PokerStars Hand #254506778571:  Hold'em No Limit ($0.50/$1.00 USD) - 2025/01/22 22:13:53 WET [2025/01/22 17:13:53 ET]
Table 'Ajax III' 6-max Seat #2 is the button
Seat 1: amitnain00012 ($66.04 in chips) 
Seat 2: michasia ($100 in chips) 
Seat 3: Iospirate ($117.71 in chips) 
Seat 4: Trojanovich ($150.43 in chips) 
Seat 5: henri789 ($188.32 in chips) 
Seat 6: xcinaz ($100 in chips) 
Iospirate: posts small blind $0.50
Trojanovich: posts big blind $1
*** HOLE CARDS ***
henri789: folds 
xcinaz: folds 
amitnain00012: folds 
michasia: folds 
Iospirate: folds 
Uncalled bet ($0.50) returned to Trojanovich
Trojanovich collected $1 from pot
Trojanovich: doesn't show hand 
*** SUMMARY ***
Total pot $1 | Rake $0 
Seat 1: amitnain00012 folded before Flop (didn't bet)
Seat 2: michasia (button) folded before Flop (didn't bet)
Seat 3: Iospirate (small blind) folded before Flop
Seat 4: Trojanovich (big blind) collected ($1)
Seat 5: henri789 folded before Flop (didn't bet)
Seat 6: xcinaz folded before Flop (didn't bet)



PokerStars Hand #254506782766:  Hold'em No Limit ($0.50/$1.00 USD) - 2025/01/22 22:14:08 WET [2025/01/22 17:14:08 ET]
Table 'Ajax III' 6-max Seat #3 is the button
Seat 1: amitnain00012 ($66.04 in chips) 
Seat 2: michasia ($100 in chips) 
Seat 3: Iospirate ($117.21 in chips) 
Seat 4: Trojanovich ($150.93 in chips) 
Seat 5: henri789 ($188.32 in chips) 
Seat 6: xcinaz ($100 in chips) 
Trojanovich: posts small blind $0.50
henri789: posts big blind $1
*** HOLE CARDS ***
xcinaz: folds 
amitnain00012: raises $1 to $2
michasia: folds 
Iospirate: folds 
Trojanovich: folds 
henri789: calls $1
*** FLOP *** [Qh 3d Ks]
henri789: checks 
amitnain00012: bets $2
henri789: folds 
Uncalled bet ($2) returned to amitnain00012
amitnain00012 collected $4.28 from pot
*** SUMMARY ***
Total pot $4.50 | Rake $0.22 
Board [Qh 3d Ks]
Seat 1: amitnain00012 collected ($4.28)
Seat 2: michasia folded before Flop (didn't bet)
Seat 3: Iospirate (button) folded before Flop (didn't bet)
Seat 4: Trojanovich (small blind) folded before Flop
Seat 5: henri789 (big blind) folded on the Flop
Seat 6: xcinaz folded before Flop (didn't bet)



PokerStars Hand #254506794938:  Hold'em No Limit ($0.50/$1.00 USD) - 2025/01/22 22:14:51 WET [2025/01/22 17:14:51 ET]
Table 'Ajax III' 6-max Seat #4 is the button
Seat 1: amitnain00012 ($68.32 in chips) 
Seat 2: michasia ($100 in chips) 
Seat 3: Iospirate ($117.21 in chips) 
Seat 4: Trojanovich ($150.43 in chips) 
Seat 5: henri789 ($186.32 in chips) 
Seat 6: xcinaz ($100 in chips) 
henri789: posts small blind $0.50
xcinaz: posts big blind $1
*** HOLE CARDS ***
amitnain00012: raises $1 to $2
michasia: folds 
Iospirate: folds 
Trojanovich: folds 
henri789: folds 
xcinaz: folds 
Uncalled bet ($1) returned to amitnain00012
amitnain00012 collected $2.50 from pot
*** SUMMARY ***
Total pot $2.50 | Rake $0 
Seat 1: amitnain00012 collected ($2.50)
Seat 2: michasia folded before Flop (didn't bet)
Seat 3: Iospirate folded before Flop (didn't bet)
Seat 4: Trojanovich (button) folded before Flop (didn't bet)
Seat 5: henri789 (small blind) folded before Flop
Seat 6: xcinaz (big blind) folded before Flop



PokerStars Hand #254506801615:  Hold'em No Limit ($0.50/$1.00 USD) - 2025/01/22 22:15:14 WET [2025/01/22 17:15:14 ET]
Table 'Ajax III' 6-max Seat #5 is the button
Seat 1: amitnain00012 ($69.82 in chips) 
Seat 2: michasia ($100 in chips) 
Seat 3: Iospirate ($117.21 in chips) 
Seat 4: Trojanovich ($150.43 in chips) 
Seat 5: henri789 ($185.82 in chips) 
Seat 6: xcinaz ($100 in chips) 
xcinaz: posts small blind $0.50
amitnain00012: posts big blind $1
*** HOLE CARDS ***
michasia: folds 
Iospirate: folds 
Trojanovich: folds 
henri789: raises $1.20 to $2.20
xcinaz: folds 
amitnain00012: calls $1.20
*** FLOP *** [6h Kd 8d]
amitnain00012: bets $2
henri789: raises $4.24 to $6.24
amitnain00012: folds 
Uncalled bet ($4.24) returned to henri789
henri789 collected $8.46 from pot
henri789: doesn't show hand 
*** SUMMARY ***
Total pot $8.90 | Rake $0.44 
Board [6h Kd 8d]
Seat 1: amitnain00012 (big blind) folded on the Flop
Seat 2: michasia folded before Flop (didn't bet)
Seat 3: Iospirate folded before Flop (didn't bet)
Seat 4: Trojanovich folded before Flop (didn't bet)
Seat 5: henri789 (button) collected ($8.46)
Seat 6: xcinaz (small blind) folded before Flop



PokerStars Hand #254506812631:  Hold'em No Limit ($0.50/$1.00 USD) - 2025/01/22 22:15:54 WET [2025/01/22 17:15:54 ET]
Table 'Ajax III' 6-max Seat #6 is the button
Seat 1: amitnain00012 ($65.62 in chips) 
Seat 2: michasia ($100 in chips) 
Seat 3: Iospirate ($117.21 in chips) 
Seat 4: Trojanovich ($150.43 in chips) 
Seat 5: henri789 ($190.08 in chips) 
Seat 6: xcinaz ($100 in chips) 
amitnain00012: posts small blind $0.50
michasia: posts big blind $1
*** HOLE CARDS ***
Iospirate: folds 
Trojanovich: folds 
henri789: folds 
xcinaz: raises $1.50 to $2.50
amitnain00012: calls $2
michasia: folds 
*** FLOP *** [As Ts 6d]
amitnain00012: checks 
xcinaz: bets $1.43
amitnain00012: raises $1.43 to $2.86
xcinaz: calls $1.43
*** TURN *** [As Ts 6d] [Qh]
amitnain00012: bets $4
xcinaz: calls $4
*** RIVER *** [As Ts 6d Qh] [Kh]
amitnain00012: bets $8
xcinaz: folds 
Uncalled bet ($8) returned to amitnain00012
amitnain00012 collected $18.73 from pot
*** SUMMARY ***
Total pot $19.72 | Rake $0.99 
Board [As Ts 6d Qh Kh]
Seat 1: amitnain00012 (small blind) collected ($18.73)
Seat 2: michasia (big blind) folded before Flop
Seat 3: Iospirate folded before Flop (didn't bet)
Seat 4: Trojanovich folded before Flop (didn't bet)
Seat 5: henri789 folded before Flop (didn't bet)
Seat 6: xcinaz (button) folded on the River



PokerStars Hand #254506828476:  Hold'em No Limit ($0.50/$1.00 USD) - 2025/01/22 22:16:49 WET [2025/01/22 17:16:49 ET]
Table 'Ajax III' 6-max Seat #1 is the button
Seat 1: amitnain00012 ($74.99 in chips) 
Seat 2: michasia ($100 in chips) 
Seat 3: Iospirate ($117.21 in chips) 
Seat 4: Trojanovich ($150.43 in chips) 
Seat 5: henri789 ($190.08 in chips) 
Seat 6: xcinaz ($100 in chips) 
michasia: posts small blind $0.50
Iospirate: posts big blind $1
*** HOLE CARDS ***
Trojanovich: folds 
henri789: folds 
xcinaz: folds 
amitnain00012: calls $1
michasia: raises $4 to $5
Iospirate: folds 
amitnain00012: calls $4
*** FLOP *** [4c Qh 5h]
michasia: checks 
amitnain00012: bets $3
michasia: calls $3
*** TURN *** [4c Qh 5h] [8s]
michasia: checks 
amitnain00012: bets $4
michasia: calls $4
*** RIVER *** [4c Qh 5h 8s] [Js]
michasia: checks 
amitnain00012: bets $4
michasia: calls $4
*** SHOW DOWN ***
amitnain00012: shows [8c As] (a pair of Eights)
michasia: shows [9d Qd] (a pair of Queens)
michasia collected $31.35 from pot
*** SUMMARY ***
Total pot $33 | Rake $1.65 
Board [4c Qh 5h 8s Js]
Seat 1: amitnain00012 (button) showed [8c As] and lost with a pair of Eights
Seat 2: michasia (small blind) showed [9d Qd] and won ($31.35) with a pair of Queens
Seat 3: Iospirate (big blind) folded before Flop
Seat 4: Trojanovich folded before Flop (didn't bet)
Seat 5: henri789 folded before Flop (didn't bet)
Seat 6: xcinaz folded before Flop (didn't bet)



PokerStars Hand #254506838437:  Hold'em No Limit ($0.50/$1.00 USD) - 2025/01/22 22:17:24 WET [2025/01/22 17:17:24 ET]
Table 'Ajax III' 6-max Seat #2 is the button
Seat 1: amitnain00012 ($58.99 in chips) 
Seat 2: michasia ($115.35 in chips) 
Seat 3: Iospirate ($116.21 in chips) 
Seat 4: Trojanovich ($150.43 in chips) 
Seat 5: henri789 ($190.08 in chips) 
Seat 6: xcinaz ($100 in chips) 
Iospirate: posts small blind $0.50
Trojanovich: posts big blind $1
*** HOLE CARDS ***
henri789: folds 
xcinaz: folds 
amitnain00012: calls $1
michasia: raises $2.50 to $3.50
Iospirate: calls $3
Trojanovich: folds 
amitnain00012: calls $2.50
*** FLOP *** [Qd Th Td]
Iospirate: checks 
amitnain00012: checks 
michasia: checks 
*** TURN *** [Qd Th Td] [6s]
Iospirate: checks 
amitnain00012: checks 
michasia: checks 
*** RIVER *** [Qd Th Td 6s] [3h]
Iospirate: checks 
amitnain00012: bets $2
michasia: calls $2
Iospirate: folds 
*** SHOW DOWN ***
amitnain00012: shows [5h 3c] (two pair, Tens and Threes)
michasia: mucks hand 
amitnain00012 collected $14.72 from pot
*** SUMMARY ***
Total pot $15.50 | Rake $0.78 
Board [Qd Th Td 6s 3h]
Seat 1: amitnain00012 showed [5h 3c] and won ($14.72) with two pair, Tens and Threes
Seat 2: michasia (button) mucked
Seat 3: Iospirate (small blind) folded on the River
Seat 4: Trojanovich (big blind) folded before Flop
Seat 5: henri789 folded before Flop (didn't bet)
Seat 6: xcinaz folded before Flop (didn't bet)



PokerStars Hand #254506852167:  Hold'em No Limit ($0.50/$1.00 USD) - 2025/01/22 22:18:13 WET [2025/01/22 17:18:13 ET]
Table 'Ajax III' 6-max Seat #3 is the button
Seat 1: amitnain00012 ($68.21 in chips) 
Seat 2: michasia ($109.85 in chips) 
Seat 3: Iospirate ($112.71 in chips) 
Seat 4: Trojanovich ($149.43 in chips) 
Seat 5: henri789 ($190.08 in chips) 
Seat 6: xcinaz ($100 in chips) 
Trojanovich: posts small blind $0.50
henri789: posts big blind $1
*** HOLE CARDS ***
xcinaz: folds 
amitnain00012: calls $1
michasia: folds 
Iospirate: folds 
Trojanovich: folds 
henri789: raises $4 to $5
amitnain00012: folds 
Uncalled bet ($4) returned to henri789
henri789 collected $2.50 from pot
henri789: doesn't show hand 
*** SUMMARY ***
Total pot $2.50 | Rake $0 
Seat 1: amitnain00012 folded before Flop
Seat 2: michasia folded before Flop (didn't bet)
Seat 3: Iospirate (button) folded before Flop (didn't bet)
Seat 4: Trojanovich (small blind) folded before Flop
Seat 5: henri789 (big blind) collected ($2.50)
Seat 6: xcinaz folded before Flop (didn't bet)



PokerStars Hand #254506864451:  Hold'em No Limit ($0.50/$1.00 USD) - 2025/01/22 22:18:56 WET [2025/01/22 17:18:56 ET]
Table 'Ajax III' 6-max Seat #4 is the button
Seat 1: amitnain00012 ($67.21 in chips) 
Seat 2: michasia ($109.85 in chips) 
Seat 3: Iospirate ($112.71 in chips) 
Seat 4: Trojanovich ($148.93 in chips) 
Seat 5: henri789 ($191.58 in chips) 
Seat 6: xcinaz ($100 in chips) 
henri789: posts small blind $0.50
xcinaz: posts big blind $1
*** HOLE CARDS ***
amitnain00012: folds 
michasia: folds 
Iospirate: folds 
Trojanovich: raises $1.50 to $2.50
henri789: folds 
xcinaz: folds 
Uncalled bet ($1.50) returned to Trojanovich
Trojanovich collected $2.50 from pot
Trojanovich: doesn't show hand 
*** SUMMARY ***
Total pot $2.50 | Rake $0 
Seat 1: amitnain00012 folded before Flop (didn't bet)
Seat 2: michasia folded before Flop (didn't bet)
Seat 3: Iospirate folded before Flop (didn't bet)
Seat 4: Trojanovich (button) collected ($2.50)
Seat 5: henri789 (small blind) folded before Flop
Seat 6: xcinaz (big blind) folded before Flop



PokerStars Hand #254506867967:  Hold'em No Limit ($0.50/$1.00 USD) - 2025/01/22 22:19:09 WET [2025/01/22 17:19:09 ET]
Table 'Ajax III' 6-max Seat #5 is the button
Seat 1: amitnain00012 ($67.21 in chips) 
Seat 2: michasia ($109.85 in chips) 
Seat 3: Iospirate ($112.71 in chips) 
Seat 4: Trojanovich ($150.43 in chips) 
Seat 5: henri789 ($191.08 in chips) 
Seat 6: xcinaz ($100 in chips) 
xcinaz: posts small blind $0.50
amitnain00012: posts big blind $1
*** HOLE CARDS ***
michasia: folds 
Iospirate: folds 
Trojanovich: folds 
henri789: folds 
xcinaz: folds 
Uncalled bet ($0.50) returned to amitnain00012
amitnain00012 collected $1 from pot
*** SUMMARY ***
Total pot $1 | Rake $0 
Seat 1: amitnain00012 (big blind) collected ($1)
Seat 2: michasia folded before Flop (didn't bet)
Seat 3: Iospirate folded before Flop (didn't bet)
Seat 4: Trojanovich folded before Flop (didn't bet)
Seat 5: henri789 (button) folded before Flop (didn't bet)
Seat 6: xcinaz (small blind) folded before Flop



PokerStars Hand #254506870934:  Hold'em No Limit ($0.50/$1.00 USD) - 2025/01/22 22:19:19 WET [2025/01/22 17:19:19 ET]
Table 'Ajax III' 6-max Seat #6 is the button
Seat 1: amitnain00012 ($67.71 in chips) 
Seat 2: michasia ($109.85 in chips) 
Seat 3: Iospirate ($112.71 in chips) 
Seat 4: Trojanovich ($150.43 in chips) 
Seat 5: henri789 ($191.08 in chips) 
Seat 6: xcinaz ($100 in chips) 
amitnain00012: posts small blind $0.50
michasia: posts big blind $1
*** HOLE CARDS ***
Iospirate: folds 
Trojanovich: folds 
henri789: folds 
xcinaz: raises $1.50 to $2.50
amitnain00012: calls $2
michasia: calls $1.50
*** FLOP *** [5d 8c 9c]
amitnain00012: bets $2
michasia: calls $2
xcinaz: calls $2
*** TURN *** [5d 8c 9c] [4h]
amitnain00012: bets $2
michasia: calls $2
xcinaz: folds 
*** RIVER *** [5d 8c 9c 4h] [Ks]
amitnain00012: bets $2
michasia: calls $2
*** SHOW DOWN ***
amitnain00012: shows [Js Ad] (high card Ace)
michasia: shows [6s 6h] (a pair of Sixes)
michasia collected $20.42 from pot
*** SUMMARY ***
Total pot $21.50 | Rake $1.08 
Board [5d 8c 9c 4h Ks]
Seat 1: amitnain00012 (small blind) showed [Js Ad] and lost with high card Ace
Seat 2: michasia (big blind) showed [6s 6h] and won ($20.42) with a pair of Sixes
Seat 3: Iospirate folded before Flop (didn't bet)
Seat 4: Trojanovich folded before Flop (didn't bet)
Seat 5: henri789 folded before Flop (didn't bet)
Seat 6: xcinaz (button) folded on the Turn



PokerStars Hand #254506882922:  Hold'em No Limit ($0.50/$1.00 USD) - 2025/01/22 22:20:02 WET [2025/01/22 17:20:02 ET]
Table 'Ajax III' 6-max Seat #1 is the button
Seat 1: amitnain00012 ($59.21 in chips) 
Seat 2: michasia ($121.77 in chips) 
Seat 3: Iospirate ($112.71 in chips) 
Seat 4: Trojanovich ($150.43 in chips) 
Seat 5: henri789 ($191.08 in chips) 
Seat 6: xcinaz ($100 in chips) 
michasia: posts small blind $0.50
Iospirate: posts big blind $1
*** HOLE CARDS ***
Trojanovich: folds 
henri789: folds 
xcinaz: folds 
amitnain00012: calls $1
michasia: raises $4 to $5
Iospirate: folds 
amitnain00012: calls $4
*** FLOP *** [3c Qc 5c]
michasia: checks 
amitnain00012: bets $4
michasia: folds 
Uncalled bet ($4) returned to amitnain00012
amitnain00012 collected $10.45 from pot
*** SUMMARY ***
Total pot $11 | Rake $0.55 
Board [3c Qc 5c]
Seat 1: amitnain00012 (button) collected ($10.45)
Seat 2: michasia (small blind) folded on the Flop
Seat 3: Iospirate (big blind) folded before Flop
Seat 4: Trojanovich folded before Flop (didn't bet)
Seat 5: henri789 folded before Flop (didn't bet)
Seat 6: xcinaz folded before Flop (didn't bet)



PokerStars Hand #254506894730:  Hold'em No Limit ($0.50/$1.00 USD) - 2025/01/22 22:20:45 WET [2025/01/22 17:20:45 ET]
Table 'Ajax III' 6-max Seat #2 is the button
Seat 1: amitnain00012 ($64.66 in chips) 
Seat 2: michasia ($116.77 in chips) 
Seat 3: Iospirate ($111.71 in chips) 
Seat 4: Trojanovich ($150.43 in chips) 
Seat 5: henri789 ($191.08 in chips) 
Seat 6: xcinaz ($100 in chips) 
Iospirate: posts small blind $0.50
Trojanovich: posts big blind $1
*** HOLE CARDS ***
henri789: folds 
xcinaz: raises $1 to $2
amitnain00012: folds 
michasia: folds 
Iospirate: folds 
Trojanovich: calls $1
*** FLOP *** [6s Qh 5s]
Trojanovich: checks 
xcinaz: bets $1.07
Trojanovich: folds 
Uncalled bet ($1.07) returned to xcinaz
xcinaz collected $4.28 from pot
xcinaz: doesn't show hand 
*** SUMMARY ***
Total pot $4.50 | Rake $0.22 
Board [6s Qh 5s]
Seat 1: amitnain00012 folded before Flop (didn't bet)
Seat 2: michasia (button) folded before Flop (didn't bet)
Seat 3: Iospirate (small blind) folded before Flop
Seat 4: Trojanovich (big blind) folded on the Flop
Seat 5: henri789 folded before Flop (didn't bet)
Seat 6: xcinaz collected ($4.28)



PokerStars Hand #254506904025:  Hold'em No Limit ($0.50/$1.00 USD) - 2025/01/22 22:21:18 WET [2025/01/22 17:21:18 ET]
Table 'Ajax III' 6-max Seat #3 is the button
Seat 1: amitnain00012 ($64.66 in chips) 
Seat 2: michasia ($116.77 in chips) 
Seat 3: Iospirate ($111.21 in chips) 
Seat 4: Trojanovich ($148.43 in chips) 
Seat 5: henri789 ($191.08 in chips) 
Seat 6: xcinaz ($102.28 in chips) 
Trojanovich: posts small blind $0.50
henri789: posts big blind $1
*** HOLE CARDS ***
xcinaz: folds 
amitnain00012: folds 
michasia: folds 
Iospirate: raises $1 to $2
Trojanovich: raises $6 to $8
henri789: folds 
Iospirate: folds 
Uncalled bet ($6) returned to Trojanovich
Trojanovich collected $5 from pot
Trojanovich: doesn't show hand 
*** SUMMARY ***
Total pot $5 | Rake $0 
Seat 1: amitnain00012 folded before Flop (didn't bet)
Seat 2: michasia folded before Flop (didn't bet)
Seat 3: Iospirate (button) folded before Flop
Seat 4: Trojanovich (small blind) collected ($5)
Seat 5: henri789 (big blind) folded before Flop
Seat 6: xcinaz folded before Flop (didn't bet)



PokerStars Hand #254506912784:  Hold'em No Limit ($0.50/$1.00 USD) - 2025/01/22 22:21:49 WET [2025/01/22 17:21:49 ET]
Table 'Ajax III' 6-max Seat #4 is the button
Seat 1: amitnain00012 ($64.66 in chips) 
Seat 2: michasia ($116.77 in chips) 
Seat 3: Iospirate ($109.21 in chips) 
Seat 4: Trojanovich ($151.43 in chips) 
Seat 5: henri789 ($190.08 in chips) 
Seat 6: xcinaz ($102.28 in chips) 
henri789: posts small blind $0.50
xcinaz: posts big blind $1
*** HOLE CARDS ***
amitnain00012: calls $1
michasia: folds 
Iospirate: raises $1 to $2
Trojanovich: folds 
henri789: calls $1.50
xcinaz: folds 
amitnain00012: calls $1
*** FLOP *** [2c Kd Kh]
henri789: checks 
amitnain00012: checks 
Iospirate: checks 
*** TURN *** [2c Kd Kh] [Th]
henri789: checks 
amitnain00012: bets $2
Iospirate: calls $2
henri789: calls $2
*** RIVER *** [2c Kd Kh Th] [9s]
henri789: checks 
amitnain00012: bets $4
Iospirate: folds 
henri789: calls $4
*** SHOW DOWN ***
amitnain00012: shows [6d Jh] (a pair of Kings)
henri789: shows [8d Td] (two pair, Kings and Tens)
henri789 collected $19.95 from pot
*** SUMMARY ***
Total pot $21 | Rake $1.05 
Board [2c Kd Kh Th 9s]
Seat 1: amitnain00012 showed [6d Jh] and lost with a pair of Kings
Seat 2: michasia folded before Flop (didn't bet)
Seat 3: Iospirate folded on the River
Seat 4: Trojanovich (button) folded before Flop (didn't bet)
Seat 5: henri789 (small blind) showed [8d Td] and won ($19.95) with two pair, Kings and Tens
Seat 6: xcinaz (big blind) folded before Flop



PokerStars Hand #254506933413:  Hold'em No Limit ($0.50/$1.00 USD) - 2025/01/22 22:23:04 WET [2025/01/22 17:23:04 ET]
Table 'Ajax III' 6-max Seat #5 is the button
Seat 1: amitnain00012 ($56.66 in chips) 
Seat 2: michasia ($116.77 in chips) 
Seat 3: Iospirate ($105.21 in chips) 
Seat 4: Trojanovich ($151.43 in chips) 
Seat 5: henri789 ($202.03 in chips) 
Seat 6: xcinaz ($101.28 in chips) 
xcinaz: posts small blind $0.50
amitnain00012: posts big blind $1
*** HOLE CARDS ***
michasia: raises $1.60 to $2.60
Iospirate: folds 
Trojanovich: raises $4.90 to $7.50
henri789: folds 
xcinaz: folds 
amitnain00012: folds 
michasia: calls $4.90
*** FLOP *** [2s 6s Qd]
michasia: checks 
Trojanovich: bets $5.17
michasia: calls $5.17
*** TURN *** [2s 6s Qd] [Ks]
michasia: checks 
Trojanovich: checks 
*** RIVER *** [2s 6s Qd Ks] [Td]
michasia: bets $17
Trojanovich: raises $121.76 to $138.76 and is all-in
michasia: folds 
Uncalled bet ($121.76) returned to Trojanovich
Trojanovich collected $58.34 from pot
Trojanovich: doesn't show hand 
*** SUMMARY ***
Total pot $60.84 | Rake $2.50 
Board [2s 6s Qd Ks Td]
Seat 1: amitnain00012 (big blind) folded before Flop
Seat 2: michasia folded on the River
Seat 3: Iospirate folded before Flop (didn't bet)
Seat 4: Trojanovich collected ($58.34)
Seat 5: henri789 (button) folded before Flop (didn't bet)
Seat 6: xcinaz (small blind) folded before Flop



PokerStars Hand #254506962616:  Hold'em No Limit ($0.50/$1.00 USD) - 2025/01/22 22:24:48 WET [2025/01/22 17:24:48 ET]
Table 'Ajax III' 6-max Seat #6 is the button
Seat 3: Iospirate ($105.21 in chips) is sitting out
Seat 1: amitnain00012 ($55.66 in chips) 
Seat 2: michasia ($100 in chips) 
Seat 4: Trojanovich ($180.10 in chips) 
Seat 5: henri789 ($202.03 in chips) 
Seat 6: xcinaz ($100.78 in chips) 
amitnain00012: posts small blind $0.50
michasia: posts big blind $1
*** HOLE CARDS ***
Trojanovich: folds 
henri789: folds 
xcinaz: raises $1.50 to $2.50
amitnain00012: calls $2
michasia: raises $11.50 to $14
xcinaz: folds 
amitnain00012: folds 
Uncalled bet ($11.50) returned to michasia
michasia collected $7.50 from pot
michasia: doesn't show hand 
*** SUMMARY ***
Total pot $7.50 | Rake $0 
Seat 3: Iospirate
Seat 1: amitnain00012 (small blind) folded before Flop
Seat 2: michasia (big blind) collected ($7.50)
Seat 4: Trojanovich folded before Flop (didn't bet)
Seat 5: henri789 folded before Flop (didn't bet)
Seat 6: xcinaz (button) folded before Flop



PokerStars Hand #254506966952:  Hold'em No Limit ($0.50/$1.00 USD) - 2025/01/22 22:25:03 WET [2025/01/22 17:25:03 ET]
Table 'Ajax III' 6-max Seat #1 is the button
Seat 3: Iospirate ($105.21 in chips) is sitting out
Seat 1: amitnain00012 ($53.16 in chips) 
Seat 2: michasia ($105 in chips) 
Seat 4: Trojanovich ($180.10 in chips) 
Seat 5: henri789 ($202.03 in chips) 
Seat 6: xcinaz ($100 in chips) 
michasia: posts small blind $0.50
Trojanovich: posts big blind $1
*** HOLE CARDS ***
henri789: folds 
xcinaz: raises $1.20 to $2.20
amitnain00012: calls $2.20
michasia: folds 
Trojanovich: calls $1.20
*** FLOP *** [5s 5c 9d]
Trojanovich: checks 
xcinaz: checks 
amitnain00012: checks 
*** TURN *** [5s 5c 9d] [4s]
Trojanovich: bets $10.11
xcinaz: folds 
amitnain00012: folds 
Uncalled bet ($10.11) returned to Trojanovich
Trojanovich collected $6.74 from pot
Trojanovich: doesn't show hand 
*** SUMMARY ***
Total pot $7.10 | Rake $0.36 
Board [5s 5c 9d 4s]
Seat 3: Iospirate
Seat 1: amitnain00012 (button) folded on the Turn
Seat 2: michasia (small blind) folded before Flop
Seat 4: Trojanovich (big blind) collected ($6.74)
Seat 5: henri789 folded before Flop (didn't bet)
Seat 6: xcinaz folded on the Turn



PokerStars Hand #254506977972:  Hold'em No Limit ($0.50/$1.00 USD) - 2025/01/22 22:25:43 WET [2025/01/22 17:25:43 ET]
Table 'Ajax III' 6-max Seat #2 is the button
Seat 3: Iospirate ($105.21 in chips) is sitting out
Seat 1: amitnain00012 ($50.96 in chips) 
Seat 2: michasia ($104.50 in chips) 
Seat 4: Trojanovich ($184.64 in chips) 
Seat 5: henri789 ($202.03 in chips) 
Seat 6: xcinaz ($100 in chips) 
Trojanovich: posts small blind $0.50
henri789: posts big blind $1
*** HOLE CARDS ***
xcinaz: folds 
amitnain00012: raises $1 to $2
michasia: folds 
Trojanovich: folds 
henri789: calls $1
*** FLOP *** [3s 3d Jd]
henri789: checks 
amitnain00012: bets $2
henri789: folds 
Uncalled bet ($2) returned to amitnain00012
amitnain00012 collected $4.28 from pot
*** SUMMARY ***
Total pot $4.50 | Rake $0.22 
Board [3s 3d Jd]
Seat 3: Iospirate
Seat 1: amitnain00012 collected ($4.28)
Seat 2: michasia (button) folded before Flop (didn't bet)
Seat 4: Trojanovich (small blind) folded before Flop
Seat 5: henri789 (big blind) folded on the Flop
Seat 6: xcinaz folded before Flop (didn't bet)



PokerStars Hand #254506983250:  Hold'em No Limit ($0.50/$1.00 USD) - 2025/01/22 22:26:01 WET [2025/01/22 17:26:01 ET]
Table 'Ajax III' 6-max Seat #4 is the button
Seat 3: Iospirate ($105.21 in chips) is sitting out
Seat 1: amitnain00012 ($53.24 in chips) 
Seat 2: michasia ($104.50 in chips) 
Seat 4: Trojanovich ($184.14 in chips) 
Seat 5: henri789 ($200.03 in chips) 
Seat 6: xcinaz ($100 in chips) 
henri789: posts small blind $0.50
xcinaz: posts big blind $1
Iospirate: sits out 
*** HOLE CARDS ***
amitnain00012: raises $1 to $2
michasia: folds 
Trojanovich: raises $4.50 to $6.50
henri789: folds 
xcinaz: folds 
amitnain00012: calls $4.50
*** FLOP *** [Qd Ac 5h]
amitnain00012: checks 
Trojanovich: bets $4.55
amitnain00012: calls $4.55
*** TURN *** [Qd Ac 5h] [Jh]
amitnain00012: checks 
Trojanovich: bets $11.21
amitnain00012: calls $11.21
*** RIVER *** [Qd Ac 5h Jh] [Td]
amitnain00012: checks 
Trojanovich: bets $32.79
amitnain00012: calls $30.98 and is all-in
Uncalled bet ($1.81) returned to Trojanovich
*** SHOW DOWN ***
Trojanovich: shows [Kc Ah] (a straight, Ten to Ace)
amitnain00012: shows [8d Ad] (a pair of Aces)
Trojanovich collected $105.48 from pot
*** SUMMARY ***
Total pot $107.98 | Rake $2.50 
Board [Qd Ac 5h Jh Td]
Seat 3: Iospirate
Seat 1: amitnain00012 showed [8d Ad] and lost with a pair of Aces
Seat 2: michasia folded before Flop (didn't bet)
Seat 4: Trojanovich (button) showed [Kc Ah] and won ($105.48) with a straight, Ten to Ace
Seat 5: henri789 (small blind) folded before Flop
Seat 6: xcinaz (big blind) folded before Flop



PokerStars Hand #254507000440:  Hold'em No Limit ($0.50/$1.00 USD) - 2025/01/22 22:27:02 WET [2025/01/22 17:27:02 ET]
Table 'Ajax III' 6-max Seat #5 is the button
Seat 1: amitnain00012 ($0 in chips) is sitting out
Seat 2: michasia ($104.50 in chips) 
Seat 3: Iospirate ($105.21 in chips) 
Seat 4: Trojanovich ($236.38 in chips) 
Seat 5: henri789 ($199.53 in chips) 
Seat 6: xcinaz ($100 in chips) 
xcinaz: posts small blind $0.50
michasia: posts big blind $1
Iospirate: posts small & big blinds $1.50
*** HOLE CARDS ***
Iospirate: checks 
Trojanovich: folds 
henri789: raises $3 to $4
amitnain00012 leaves the table
xcinaz: folds 
michasia: folds 
Iospirate: folds 
Uncalled bet ($3) returned to henri789
henri789 collected $4 from pot
henri789: doesn't show hand 
*** SUMMARY ***
Total pot $4 | Rake $0 
Seat 1: amitnain00012
Seat 2: michasia (big blind) folded before Flop
Seat 3: Iospirate folded before Flop (didn't bet)
Seat 4: Trojanovich folded before Flop (didn't bet)
Seat 5: henri789 (button) collected ($4)
Seat 6: xcinaz (small blind) folded before Flop



PokerStars Hand #254507007345:  Hold'em No Limit ($0.50/$1.00 USD) - 2025/01/22 22:27:27 WET [2025/01/22 17:27:27 ET]
Table 'Ajax III' 6-max Seat #6 is the button
Seat 2: michasia ($103.50 in chips) 
Seat 3: Iospirate ($103.71 in chips) 
Seat 4: Trojanovich ($236.38 in chips) 
Seat 5: henri789 ($202.53 in chips) 
Seat 6: xcinaz ($100 in chips) 
michasia: posts small blind $0.50
Iospirate: posts big blind $1
*** HOLE CARDS ***
Trojanovich: folds 
henri789: raises $1.20 to $2.20
xcinaz: folds 
michasia: folds 
Iospirate: calls $1.20
*** FLOP *** [7s 8d 8h]
Iospirate: checks 
henri789: bets $1.54
Iospirate: calls $1.54
*** TURN *** [7s 8d 8h] [7d]
Iospirate: checks 
mr.Jckpot joins the table at seat #1 
henri789: checks 
*** RIVER *** [7s 8d 8h 7d] [3c]
Iospirate: checks 
henri789: checks 
*** SHOW DOWN ***
Iospirate: shows [Qd Jd] (two pair, Eights and Sevens)
henri789: shows [Ad Td] (two pair, Eights and Sevens - Ace kicker)
henri789 collected $7.58 from pot
*** SUMMARY ***
Total pot $7.98 | Rake $0.40 
Board [7s 8d 8h 7d 3c]
Seat 2: michasia (small blind) folded before Flop
Seat 3: Iospirate (big blind) showed [Qd Jd] and lost with two pair, Eights and Sevens
Seat 4: Trojanovich folded before Flop (didn't bet)
Seat 5: henri789 showed [Ad Td] and won ($7.58) with two pair, Eights and Sevens
Seat 6: xcinaz (button) folded before Flop (didn't bet)



PokerStars Hand #254507021803:  Hold'em No Limit ($0.50/$1.00 USD) - 2025/01/22 22:28:19 WET [2025/01/22 17:28:19 ET]
Table 'Ajax III' 6-max Seat #2 is the button
Seat 1: mr.Jckpot ($100 in chips) is sitting out
Seat 2: michasia ($103 in chips) 
Seat 3: Iospirate ($99.97 in chips) 
Seat 4: Trojanovich ($236.38 in chips) 
Seat 5: henri789 ($206.37 in chips) 
Seat 6: xcinaz ($100 in chips) 
Iospirate: posts small blind $0.50
Trojanovich: posts big blind $1
mr.Jckpot: sits out 
*** HOLE CARDS ***
henri789: folds 
xcinaz: raises $1.20 to $2.20
michasia: folds 
Iospirate: folds 
Trojanovich: folds 
Uncalled bet ($1.20) returned to xcinaz
xcinaz collected $2.50 from pot
xcinaz: doesn't show hand 
*** SUMMARY ***
Total pot $2.50 | Rake $0 
Seat 1: mr.Jckpot
Seat 2: michasia (button) folded before Flop (didn't bet)
Seat 3: Iospirate (small blind) folded before Flop
Seat 4: Trojanovich (big blind) folded before Flop
Seat 5: henri789 folded before Flop (didn't bet)
Seat 6: xcinaz collected ($2.50)



PokerStars Hand #254507025510:  Hold'em No Limit ($0.50/$1.00 USD) - 2025/01/22 22:28:32 WET [2025/01/22 17:28:32 ET]
Table 'Ajax III' 6-max Seat #3 is the button
Seat 1: mr.Jckpot ($100 in chips) is sitting out
Seat 2: michasia ($103 in chips) 
Seat 3: Iospirate ($99.47 in chips) 
Seat 4: Trojanovich ($235.38 in chips) 
Seat 5: henri789 ($206.37 in chips) 
Seat 6: xcinaz ($101.50 in chips) 
Trojanovich: posts small blind $0.50
henri789: posts big blind $1
mr.Jckpot: sits out 
*** HOLE CARDS ***
xcinaz: folds 
michasia: folds 
Iospirate: folds 
Trojanovich: raises $2 to $3
henri789: raises $6 to $9
Trojanovich: calls $6
*** FLOP *** [6c Kh 5c]
Trojanovich: checks 
henri789: bets $8.38
Trojanovich: calls $8.38
*** TURN *** [6c Kh 5c] [2h]
Trojanovich: checks 
henri789: bets $24.77
Trojanovich: folds 
Uncalled bet ($24.77) returned to henri789
henri789 collected $33.02 from pot
henri789: doesn't show hand 
*** SUMMARY ***
Total pot $34.76 | Rake $1.74 
Board [6c Kh 5c 2h]
Seat 1: mr.Jckpot
Seat 2: michasia folded before Flop (didn't bet)
Seat 3: Iospirate (button) folded before Flop (didn't bet)
Seat 4: Trojanovich (small blind) folded on the Turn
Seat 5: henri789 (big blind) collected ($33.02)
Seat 6: xcinaz folded before Flop (didn't bet)



PokerStars Hand #254507049689:  Hold'em No Limit ($0.50/$1.00 USD) - 2025/01/22 22:29:59 WET [2025/01/22 17:29:59 ET]
Table 'Ajax III' 6-max Seat #4 is the button
Seat 1: mr.Jckpot ($100 in chips) is sitting out
Seat 2: michasia ($103 in chips) 
Seat 3: Iospirate ($99.47 in chips) 
Seat 4: Trojanovich ($218 in chips) 
Seat 5: henri789 ($222.01 in chips) 
Seat 6: xcinaz ($101.50 in chips) 
henri789: posts small blind $0.50
xcinaz: posts big blind $1
mr.Jckpot: sits out 
*** HOLE CARDS ***
michasia: folds 
Iospirate: calls $1
Trojanovich: folds 
henri789: raises $4 to $5
xcinaz: folds 
Iospirate: calls $4
*** FLOP *** [Ks 7d Jc]
henri789: checks 
Iospirate: checks 
*** TURN *** [Ks 7d Jc] [6s]
henri789: bets $7.84
Iospirate: folds 
Uncalled bet ($7.84) returned to henri789
henri789 collected $10.45 from pot
henri789: doesn't show hand 
*** SUMMARY ***
Total pot $11 | Rake $0.55 
Board [Ks 7d Jc 6s]
Seat 1: mr.Jckpot
Seat 2: michasia folded before Flop (didn't bet)
Seat 3: Iospirate folded on the Turn
Seat 4: Trojanovich (button) folded before Flop (didn't bet)
Seat 5: henri789 (small blind) collected ($10.45)
Seat 6: xcinaz (big blind) folded before Flop



PokerStars Hand #254507062424:  Hold'em No Limit ($0.50/$1.00 USD) - 2025/01/22 22:30:44 WET [2025/01/22 17:30:44 ET]
Table 'Ajax III' 6-max Seat #5 is the button
Seat 1: mr.Jckpot ($100 in chips) 
Seat 2: michasia ($103 in chips) 
Seat 3: Iospirate ($94.47 in chips) 
Seat 4: Trojanovich ($218 in chips) 
Seat 5: henri789 ($227.46 in chips) 
Seat 6: xcinaz ($100.50 in chips) 
xcinaz: posts small blind $0.50
mr.Jckpot: posts big blind $1
*** HOLE CARDS ***
michasia: folds 
Iospirate has timed out
Iospirate: folds 
Trojanovich: folds 
henri789: folds 
xcinaz: folds 
Uncalled bet ($0.50) returned to mr.Jckpot
mr.Jckpot collected $1 from pot
mr.Jckpot: doesn't show hand 
*** SUMMARY ***
Total pot $1 | Rake $0 
Seat 1: mr.Jckpot (big blind) collected ($1)
Seat 2: michasia folded before Flop (didn't bet)
Seat 3: Iospirate folded before Flop (didn't bet)
Seat 4: Trojanovich folded before Flop (didn't bet)
Seat 5: henri789 (button) folded before Flop (didn't bet)
Seat 6: xcinaz (small blind) folded before Flop



PokerStars Hand #254507070999:  Hold'em No Limit ($0.50/$1.00 USD) - 2025/01/22 22:31:15 WET [2025/01/22 17:31:15 ET]
Table 'Ajax III' 6-max Seat #6 is the button
Seat 3: Iospirate ($94.47 in chips) is sitting out
Seat 1: mr.Jckpot ($100.50 in chips) 
Seat 2: michasia ($103 in chips) 
Seat 4: Trojanovich ($218 in chips) 
Seat 5: henri789 ($227.46 in chips) 
Seat 6: xcinaz ($100 in chips) 
mr.Jckpot: posts small blind $0.50
michasia: posts big blind $1
*** HOLE CARDS ***
Trojanovich: folds 
henri789: folds 
xcinaz: folds 
mr.Jckpot: folds 
Uncalled bet ($0.50) returned to michasia
michasia collected $1 from pot
michasia: doesn't show hand 
*** SUMMARY ***
Total pot $1 | Rake $0 
Seat 3: Iospirate
Seat 1: mr.Jckpot (small blind) folded before Flop
Seat 2: michasia (big blind) collected ($1)
Seat 4: Trojanovich folded before Flop (didn't bet)
Seat 5: henri789 folded before Flop (didn't bet)
Seat 6: xcinaz (button) folded before Flop (didn't bet)



PokerStars Hand #254507074025:  Hold'em No Limit ($0.50/$1.00 USD) - 2025/01/22 22:31:27 WET [2025/01/22 17:31:27 ET]
Table 'Ajax III' 6-max Seat #1 is the button
Seat 1: mr.Jckpot ($100 in chips) 
Seat 2: michasia ($103.50 in chips) 
Seat 3: Iospirate ($94.47 in chips) 
Seat 4: Trojanovich ($218 in chips) 
Seat 5: henri789 ($227.46 in chips) 
Seat 6: xcinaz ($100 in chips) 
michasia: posts small blind $0.50
Iospirate: posts big blind $1
*** HOLE CARDS ***
Trojanovich: folds 
henri789: folds 
xcinaz: folds 
mr.Jckpot: folds 
michasia: raises $2 to $3
Iospirate: folds 
Uncalled bet ($2) returned to michasia
michasia collected $2 from pot
michasia: doesn't show hand 
*** SUMMARY ***
Total pot $2 | Rake $0 
Seat 1: mr.Jckpot (button) folded before Flop (didn't bet)
Seat 2: michasia (small blind) collected ($2)
Seat 3: Iospirate (big blind) folded before Flop
Seat 4: Trojanovich folded before Flop (didn't bet)
Seat 5: henri789 folded before Flop (didn't bet)
Seat 6: xcinaz folded before Flop (didn't bet)



PokerStars Hand #254507080098:  Hold'em No Limit ($0.50/$1.00 USD) - 2025/01/22 22:31:48 WET [2025/01/22 17:31:48 ET]
Table 'Ajax III' 6-max Seat #2 is the button
Seat 1: mr.Jckpot ($100 in chips) 
Seat 2: michasia ($104.50 in chips) 
Seat 3: Iospirate ($100 in chips) 
Seat 4: Trojanovich ($218 in chips) 
Seat 5: henri789 ($227.46 in chips) 
Seat 6: xcinaz ($100 in chips) 
Iospirate: posts small blind $0.50
Trojanovich: posts big blind $1
*** HOLE CARDS ***
henri789: folds 
xcinaz: folds 
mr.Jckpot: raises $1.50 to $2.50
michasia: folds 
Iospirate: folds 
Trojanovich: folds 
Uncalled bet ($1.50) returned to mr.Jckpot
mr.Jckpot collected $2.50 from pot
mr.Jckpot: doesn't show hand 
*** SUMMARY ***
Total pot $2.50 | Rake $0 
Seat 1: mr.Jckpot collected ($2.50)
Seat 2: michasia (button) folded before Flop (didn't bet)
Seat 3: Iospirate (small blind) folded before Flop
Seat 4: Trojanovich (big blind) folded before Flop
Seat 5: henri789 folded before Flop (didn't bet)
Seat 6: xcinaz folded before Flop (didn't bet)



PokerStars Hand #254507083744:  Hold'em No Limit ($0.50/$1.00 USD) - 2025/01/22 22:32:02 WET [2025/01/22 17:32:02 ET]
Table 'Ajax III' 6-max Seat #3 is the button
Seat 1: mr.Jckpot ($101.50 in chips) 
Seat 2: michasia ($104.50 in chips) 
Seat 3: Iospirate ($99.50 in chips) 
Seat 4: Trojanovich ($217 in chips) 
Seat 5: henri789 ($227.46 in chips) 
Seat 6: xcinaz ($100 in chips) 
Trojanovich: posts small blind $0.50
henri789: posts big blind $1
*** HOLE CARDS ***
xcinaz: folds 
mr.Jckpot: folds 
michasia: folds 
Iospirate: raises $1 to $2
Trojanovich: folds 
henri789: folds 
Uncalled bet ($1) returned to Iospirate
Iospirate collected $2.50 from pot
Iospirate: doesn't show hand 
*** SUMMARY ***
Total pot $2.50 | Rake $0 
Seat 1: mr.Jckpot folded before Flop (didn't bet)
Seat 2: michasia folded before Flop (didn't bet)
Seat 3: Iospirate (button) collected ($2.50)
Seat 4: Trojanovich (small blind) folded before Flop
Seat 5: henri789 (big blind) folded before Flop
Seat 6: xcinaz folded before Flop (didn't bet)



PokerStars Hand #254507087262:  Hold'em No Limit ($0.50/$1.00 USD) - 2025/01/22 22:32:15 WET [2025/01/22 17:32:15 ET]
Table 'Ajax III' 6-max Seat #4 is the button
Seat 1: mr.Jckpot ($101.50 in chips) 
Seat 2: michasia ($104.50 in chips) 
Seat 3: Iospirate ($101 in chips) 
Seat 4: Trojanovich ($216.50 in chips) 
Seat 5: henri789 ($226.46 in chips) 
Seat 6: xcinaz ($100 in chips) 
henri789: posts small blind $0.50
xcinaz: posts big blind $1
*** HOLE CARDS ***
mr.Jckpot: folds 
michasia: folds 
Iospirate: folds 
Trojanovich: folds 
henri789: raises $2 to $3
xcinaz: folds 
Uncalled bet ($2) returned to henri789
henri789 collected $2 from pot
henri789: doesn't show hand 
*** SUMMARY ***
Total pot $2 | Rake $0 
Seat 1: mr.Jckpot folded before Flop (didn't bet)
Seat 2: michasia folded before Flop (didn't bet)
Seat 3: Iospirate folded before Flop (didn't bet)
Seat 4: Trojanovich (button) folded before Flop (didn't bet)
Seat 5: henri789 (small blind) collected ($2)
Seat 6: xcinaz (big blind) folded before Flop



PokerStars Hand #254507092442:  Hold'em No Limit ($0.50/$1.00 USD) - 2025/01/22 22:32:34 WET [2025/01/22 17:32:34 ET]
Table 'Ajax III' 6-max Seat #5 is the button
Seat 1: mr.Jckpot ($101.50 in chips) 
Seat 2: michasia ($104.50 in chips) 
Seat 3: Iospirate ($101 in chips) 
Seat 4: Trojanovich ($216.50 in chips) 
Seat 5: henri789 ($227.46 in chips) 
Seat 6: xcinaz ($100 in chips) 
xcinaz: posts small blind $0.50
mr.Jckpot: posts big blind $1
*** HOLE CARDS ***
michasia: folds 
Iospirate: folds 
Trojanovich: folds 
henri789: raises $1.20 to $2.20
xcinaz: folds 
mr.Jckpot: folds 
Uncalled bet ($1.20) returned to henri789
henri789 collected $2.50 from pot
henri789: doesn't show hand 
*** SUMMARY ***
Total pot $2.50 | Rake $0 
Seat 1: mr.Jckpot (big blind) folded before Flop
Seat 2: michasia folded before Flop (didn't bet)
Seat 3: Iospirate folded before Flop (didn't bet)
Seat 4: Trojanovich folded before Flop (didn't bet)
Seat 5: henri789 (button) collected ($2.50)
Seat 6: xcinaz (small blind) folded before Flop



PokerStars Hand #254507097315:  Hold'em No Limit ($0.50/$1.00 USD) - 2025/01/22 22:32:51 WET [2025/01/22 17:32:51 ET]
Table 'Ajax III' 6-max Seat #6 is the button
Seat 1: mr.Jckpot ($100.50 in chips) 
Seat 2: michasia ($104.50 in chips) 
Seat 3: Iospirate ($101 in chips) 
Seat 4: Trojanovich ($216.50 in chips) 
Seat 5: henri789 ($228.96 in chips) 
Seat 6: xcinaz ($100 in chips) 
mr.Jckpot: posts small blind $0.50
michasia: posts big blind $1
*** HOLE CARDS ***
Iospirate: folds 
Trojanovich: folds 
henri789: folds 
xcinaz: folds 
mr.Jckpot: folds 
Uncalled bet ($0.50) returned to michasia
michasia collected $1 from pot
michasia: doesn't show hand 
*** SUMMARY ***
Total pot $1 | Rake $0 
Seat 1: mr.Jckpot (small blind) folded before Flop
Seat 2: michasia (big blind) collected ($1)
Seat 3: Iospirate folded before Flop (didn't bet)
Seat 4: Trojanovich folded before Flop (didn't bet)
Seat 5: henri789 folded before Flop (didn't bet)
Seat 6: xcinaz (button) folded before Flop (didn't bet)



PokerStars Hand #254507099733:  Hold'em No Limit ($0.50/$1.00 USD) - 2025/01/22 22:33:00 WET [2025/01/22 17:33:00 ET]
Table 'Ajax III' 6-max Seat #1 is the button
Seat 1: mr.Jckpot ($100 in chips) 
Seat 2: michasia ($105 in chips) 
Seat 3: Iospirate ($101 in chips) 
Seat 4: Trojanovich ($216.50 in chips) 
Seat 5: henri789 ($228.96 in chips) 
Seat 6: xcinaz ($100 in chips) 
michasia: posts small blind $0.50
Iospirate: posts big blind $1
*** HOLE CARDS ***
Trojanovich: raises $1.50 to $2.50
henri789: folds 
xcinaz: raises $5.50 to $8
mr.Jckpot: folds 
michasia: folds 
Iospirate: folds 
Trojanovich: folds 
Uncalled bet ($5.50) returned to xcinaz
xcinaz collected $6.50 from pot
xcinaz: doesn't show hand 
*** SUMMARY ***
Total pot $6.50 | Rake $0 
Seat 1: mr.Jckpot (button) folded before Flop (didn't bet)
Seat 2: michasia (small blind) folded before Flop
Seat 3: Iospirate (big blind) folded before Flop
Seat 4: Trojanovich folded before Flop
Seat 5: henri789 folded before Flop (didn't bet)
Seat 6: xcinaz collected ($6.50)



PokerStars Hand #254507103137:  Hold'em No Limit ($0.50/$1.00 USD) - 2025/01/22 22:33:13 WET [2025/01/22 17:33:13 ET]
Table 'Ajax III' 6-max Seat #2 is the button
Seat 1: mr.Jckpot ($100 in chips) 
Seat 2: michasia ($104.50 in chips) 
Seat 3: Iospirate ($100 in chips) 
Seat 4: Trojanovich ($214 in chips) 
Seat 5: henri789 ($228.96 in chips) 
Seat 6: xcinaz ($104 in chips) 
Iospirate: posts small blind $0.50
Trojanovich: posts big blind $1
*** HOLE CARDS ***
henri789: folds 
xcinaz: folds 
mr.Jckpot: raises $1.50 to $2.50
michasia: folds 
Iospirate: raises $1.50 to $4
Trojanovich: folds 
mr.Jckpot: raises $10 to $14
Iospirate: raises $30 to $44
mr.Jckpot: raises $30 to $74
Iospirate: raises $26 to $100 and is all-in
mr.Jckpot: calls $26 and is all-in
*** FLOP *** [3c Qc Qs]
*** TURN *** [3c Qc Qs] [5s]
*** RIVER *** [3c Qc Qs 5s] [5d]
*** SHOW DOWN ***
Iospirate: shows [Kc Ad] (two pair, Queens and Fives)
mr.Jckpot: shows [Ah As] (two pair, Aces and Queens)
mr.Jckpot collected $198.50 from pot
*** SUMMARY ***
Total pot $201 | Rake $2.50 
Board [3c Qc Qs 5s 5d]
Seat 1: mr.Jckpot showed [Ah As] and won ($198.50) with two pair, Aces and Queens
Seat 2: michasia (button) folded before Flop (didn't bet)
Seat 3: Iospirate (small blind) showed [Kc Ad] and lost with two pair, Queens and Fives
Seat 4: Trojanovich (big blind) folded before Flop
Seat 5: henri789 folded before Flop (didn't bet)
Seat 6: xcinaz folded before Flop (didn't bet)



PokerStars Hand #254507114853:  Hold'em No Limit ($0.50/$1.00 USD) - 2025/01/22 22:33:56 WET [2025/01/22 17:33:56 ET]
Table 'Ajax III' 6-max Seat #4 is the button
Seat 3: Iospirate ($0 in chips) is sitting out
Seat 1: mr.Jckpot ($198.50 in chips) 
Seat 2: michasia ($104.50 in chips) 
Seat 4: Trojanovich ($213 in chips) 
Seat 5: henri789 ($228.96 in chips) 
Seat 6: xcinaz ($104 in chips) 
henri789: posts small blind $0.50
xcinaz: posts big blind $1
*** HOLE CARDS ***
mr.Jckpot: folds 
michasia: folds 
Trojanovich: folds 
henri789: raises $2 to $3
xcinaz: folds 
Uncalled bet ($2) returned to henri789
henri789 collected $2 from pot
henri789: doesn't show hand 
*** SUMMARY ***
Total pot $2 | Rake $0 
Seat 3: Iospirate
Seat 1: mr.Jckpot folded before Flop (didn't bet)
Seat 2: michasia folded before Flop (didn't bet)
Seat 4: Trojanovich (button) folded before Flop (didn't bet)
Seat 5: henri789 (small blind) collected ($2)
Seat 6: xcinaz (big blind) folded before Flop



PokerStars Hand #254507121678:  Hold'em No Limit ($0.50/$1.00 USD) - 2025/01/22 22:34:21 WET [2025/01/22 17:34:21 ET]
Table 'Ajax III' 6-max Seat #5 is the button
Seat 1: mr.Jckpot ($198.50 in chips) 
Seat 2: michasia ($104.50 in chips) 
Seat 3: Iospirate ($42.74 in chips) 
Seat 4: Trojanovich ($213 in chips) 
Seat 5: henri789 ($229.96 in chips) 
Seat 6: xcinaz ($103 in chips) 
xcinaz: posts small blind $0.50
mr.Jckpot: posts big blind $1
*** HOLE CARDS ***
michasia: folds 
Iospirate: calls $1
Trojanovich: folds 
henri789: folds 
xcinaz: folds 
mr.Jckpot: checks 
*** FLOP *** [Ts 5s Ah]
mr.Jckpot: checks 
Iospirate: checks 
*** TURN *** [Ts 5s Ah] [8c]
mr.Jckpot: bets $2.38
Iospirate: calls $2.38
*** RIVER *** [Ts 5s Ah 8c] [4c]
mr.Jckpot: bets $6.90
Iospirate: folds 
Uncalled bet ($6.90) returned to mr.Jckpot
mr.Jckpot collected $6.90 from pot
mr.Jckpot: doesn't show hand 
*** SUMMARY ***
Total pot $7.26 | Rake $0.36 
Board [Ts 5s Ah 8c 4c]
Seat 1: mr.Jckpot (big blind) collected ($6.90)
Seat 2: michasia folded before Flop (didn't bet)
Seat 3: Iospirate folded on the River
Seat 4: Trojanovich folded before Flop (didn't bet)
Seat 5: henri789 (button) folded before Flop (didn't bet)
Seat 6: xcinaz (small blind) folded before Flop



PokerStars Hand #254507130563:  Hold'em No Limit ($0.50/$1.00 USD) - 2025/01/22 22:34:54 WET [2025/01/22 17:34:54 ET]
Table 'Ajax III' 6-max Seat #6 is the button
Seat 1: mr.Jckpot ($202.02 in chips) 
Seat 2: michasia ($104.50 in chips) 
Seat 3: Iospirate ($39.36 in chips) 
Seat 4: Trojanovich ($213 in chips) 
Seat 5: henri789 ($229.96 in chips) 
Seat 6: xcinaz ($102.50 in chips) 
mr.Jckpot: posts small blind $0.50
michasia: posts big blind $1
*** HOLE CARDS ***
Iospirate: folds 
Trojanovich: folds 
henri789: folds 
xcinaz: folds 
mr.Jckpot: folds 
Uncalled bet ($0.50) returned to michasia
michasia collected $1 from pot
michasia: doesn't show hand 
*** SUMMARY ***
Total pot $1 | Rake $0 
Seat 1: mr.Jckpot (small blind) folded before Flop
Seat 2: michasia (big blind) collected ($1)
Seat 3: Iospirate folded before Flop (didn't bet)
Seat 4: Trojanovich folded before Flop (didn't bet)
Seat 5: henri789 folded before Flop (didn't bet)
Seat 6: xcinaz (button) folded before Flop (didn't bet)



PokerStars Hand #254507133700:  Hold'em No Limit ($0.50/$1.00 USD) - 2025/01/22 22:35:05 WET [2025/01/22 17:35:05 ET]
Table 'Ajax III' 6-max Seat #1 is the button
Seat 1: mr.Jckpot ($201.52 in chips) 
Seat 2: michasia ($105 in chips) 
Seat 3: Iospirate ($39.36 in chips) 
Seat 4: Trojanovich ($213 in chips) 
Seat 5: henri789 ($229.96 in chips) 
Seat 6: xcinaz ($102.50 in chips) 
michasia: posts small blind $0.50
Iospirate: posts big blind $1
*** HOLE CARDS ***
Trojanovich: folds 
henri789: folds 
xcinaz: folds 
mr.Jckpot: folds 
michasia: folds 
Uncalled bet ($0.50) returned to Iospirate
Iospirate collected $1 from pot
Iospirate: doesn't show hand 
*** SUMMARY ***
Total pot $1 | Rake $0 
Seat 1: mr.Jckpot (button) folded before Flop (didn't bet)
Seat 2: michasia (small blind) folded before Flop
Seat 3: Iospirate (big blind) collected ($1)
Seat 4: Trojanovich folded before Flop (didn't bet)
Seat 5: henri789 folded before Flop (didn't bet)
Seat 6: xcinaz folded before Flop (didn't bet)



PokerStars Hand #254507135805:  Hold'em No Limit ($0.50/$1.00 USD) - 2025/01/22 22:35:13 WET [2025/01/22 17:35:13 ET]
Table 'Ajax III' 6-max Seat #2 is the button
Seat 1: mr.Jckpot ($201.52 in chips) 
Seat 2: michasia ($104.50 in chips) 
Seat 3: Iospirate ($39.86 in chips) 
Seat 4: Trojanovich ($213 in chips) 
Seat 5: henri789 ($229.96 in chips) 
Seat 6: xcinaz ($102.50 in chips) 
Iospirate: posts small blind $0.50
Trojanovich: posts big blind $1
*** HOLE CARDS ***
henri789: raises $1.20 to $2.20
xcinaz: folds 
mr.Jckpot: folds 
michasia: folds 
Iospirate: folds 
Trojanovich: folds 
Uncalled bet ($1.20) returned to henri789
henri789 collected $2.50 from pot
henri789: doesn't show hand 
*** SUMMARY ***
Total pot $2.50 | Rake $0 
Seat 1: mr.Jckpot folded before Flop (didn't bet)
Seat 2: michasia (button) folded before Flop (didn't bet)
Seat 3: Iospirate (small blind) folded before Flop
Seat 4: Trojanovich (big blind) folded before Flop
Seat 5: henri789 collected ($2.50)
Seat 6: xcinaz folded before Flop (didn't bet)



PokerStars Hand #254507140775:  Hold'em No Limit ($0.50/$1.00 USD) - 2025/01/22 22:35:32 WET [2025/01/22 17:35:32 ET]
Table 'Ajax III' 6-max Seat #3 is the button
Seat 1: mr.Jckpot ($201.52 in chips) 
Seat 2: michasia ($104.50 in chips) 
Seat 3: Iospirate ($39.36 in chips) 
Seat 4: Trojanovich ($212 in chips) 
Seat 5: henri789 ($231.46 in chips) 
Seat 6: xcinaz ($102.50 in chips) 
Trojanovich: posts small blind $0.50
henri789: posts big blind $1
*** HOLE CARDS ***
xcinaz: folds 
mr.Jckpot: folds 
michasia: folds 
Iospirate: folds 
Trojanovich: raises $2 to $3
henri789: calls $2
*** FLOP *** [Kd 4h 3c]
Trojanovich: bets $1.88
henri789: calls $1.88
*** TURN *** [Kd 4h 3c] [5c]
Trojanovich: checks 
henri789: checks 
*** RIVER *** [Kd 4h 3c 5c] [6h]
Trojanovich: checks 
henri789: checks 
*** SHOW DOWN ***
Trojanovich: shows [8c Td] (high card King)
henri789: shows [4s Ac] (a pair of Fours)
henri789 collected $9.27 from pot
*** SUMMARY ***
Total pot $9.76 | Rake $0.49 
Board [Kd 4h 3c 5c 6h]
Seat 1: mr.Jckpot folded before Flop (didn't bet)
Seat 2: michasia folded before Flop (didn't bet)
Seat 3: Iospirate (button) folded before Flop (didn't bet)
Seat 4: Trojanovich (small blind) showed [8c Td] and lost with high card King
Seat 5: henri789 (big blind) showed [4s Ac] and won ($9.27) with a pair of Fours
Seat 6: xcinaz folded before Flop (didn't bet)



PokerStars Hand #254507160411:  Hold'em No Limit ($0.50/$1.00 USD) - 2025/01/22 22:36:45 WET [2025/01/22 17:36:45 ET]
Table 'Ajax III' 6-max Seat #4 is the button
Seat 1: mr.Jckpot ($201.52 in chips) 
Seat 2: michasia ($104.50 in chips) 
Seat 3: Iospirate ($39.36 in chips) 
Seat 4: Trojanovich ($207.12 in chips) 
Seat 5: henri789 ($235.85 in chips) 
Seat 6: xcinaz ($102.50 in chips) 
henri789: posts small blind $0.50
xcinaz: posts big blind $1
*** HOLE CARDS ***
mr.Jckpot: raises $1.50 to $2.50
michasia: folds 
Iospirate: folds 
Trojanovich: folds 
henri789: raises $9.50 to $12
xcinaz: folds 
mr.Jckpot: calls $9.50
*** FLOP *** [Jh As 7s]
henri789: bets $9.50
mr.Jckpot: calls $9.50
*** TURN *** [Jh As 7s] [5h]
henri789: bets $31.35
mr.Jckpot: folds 
Uncalled bet ($31.35) returned to henri789
henri789 collected $41.80 from pot
henri789: doesn't show hand 
*** SUMMARY ***
Total pot $44 | Rake $2.20 
Board [Jh As 7s 5h]
Seat 1: mr.Jckpot folded on the Turn
Seat 2: michasia folded before Flop (didn't bet)
Seat 3: Iospirate folded before Flop (didn't bet)
Seat 4: Trojanovich (button) folded before Flop (didn't bet)
Seat 5: henri789 (small blind) collected ($41.80)
Seat 6: xcinaz (big blind) folded before Flop



PokerStars Hand #254507175419:  Hold'em No Limit ($0.50/$1.00 USD) - 2025/01/22 22:37:40 WET [2025/01/22 17:37:40 ET]
Table 'Ajax III' 6-max Seat #5 is the button
Seat 1: mr.Jckpot ($180.02 in chips) 
Seat 2: michasia ($104.50 in chips) 
Seat 3: Iospirate ($39.36 in chips) 
Seat 4: Trojanovich ($207.12 in chips) 
Seat 5: henri789 ($256.15 in chips) 
Seat 6: xcinaz ($101.50 in chips) 
xcinaz: posts small blind $0.50
mr.Jckpot: posts big blind $1
*** HOLE CARDS ***
michasia: folds 
Iospirate: raises $1 to $2
Trojanovich: folds 
henri789: folds 
xcinaz: folds 
mr.Jckpot: calls $1
*** FLOP *** [Js 9s 5h]
mr.Jckpot: checks 
Iospirate: bets $4.28
mr.Jckpot: folds 
Uncalled bet ($4.28) returned to Iospirate
Iospirate collected $4.28 from pot
Iospirate: doesn't show hand 
*** SUMMARY ***
Total pot $4.50 | Rake $0.22 
Board [Js 9s 5h]
Seat 1: mr.Jckpot (big blind) folded on the Flop
Seat 2: michasia folded before Flop (didn't bet)
Seat 3: Iospirate collected ($4.28)
Seat 4: Trojanovich folded before Flop (didn't bet)
Seat 5: henri789 (button) folded before Flop (didn't bet)
Seat 6: xcinaz (small blind) folded before Flop



PokerStars Hand #254507181624:  Hold'em No Limit ($0.50/$1.00 USD) - 2025/01/22 22:38:03 WET [2025/01/22 17:38:03 ET]
Table 'Ajax III' 6-max Seat #6 is the button
Seat 1: mr.Jckpot ($178.02 in chips) 
Seat 2: michasia ($104.50 in chips) 
Seat 3: Iospirate ($41.64 in chips) 
Seat 4: Trojanovich ($207.12 in chips) 
Seat 5: henri789 ($256.15 in chips) 
Seat 6: xcinaz ($101 in chips) 
mr.Jckpot: posts small blind $0.50
michasia: posts big blind $1
*** HOLE CARDS ***
Iospirate: calls $1
Trojanovich: folds 
henri789: folds 
xcinaz: raises $3 to $4
mr.Jckpot: folds 
michasia: folds 
Iospirate: calls $3
*** FLOP *** [Jh Ks 2h]
Iospirate: checks 
xcinaz: bets $2.98
Iospirate: calls $2.98
*** TURN *** [Jh Ks 2h] [5h]
Iospirate: checks 
xcinaz: bets $11.02
Iospirate: folds 
Uncalled bet ($11.02) returned to xcinaz
xcinaz collected $14.69 from pot
xcinaz: doesn't show hand 
*** SUMMARY ***
Total pot $15.46 | Rake $0.77 
Board [Jh Ks 2h 5h]
Seat 1: mr.Jckpot (small blind) folded before Flop
Seat 2: michasia (big blind) folded before Flop
Seat 3: Iospirate folded on the Turn
Seat 4: Trojanovich folded before Flop (didn't bet)
Seat 5: henri789 folded before Flop (didn't bet)
Seat 6: xcinaz (button) collected ($14.69)



PokerStars Hand #254507198617:  Hold'em No Limit ($0.50/$1.00 USD) - 2025/01/22 22:39:05 WET [2025/01/22 17:39:05 ET]
Table 'Ajax III' 6-max Seat #1 is the button
Seat 1: mr.Jckpot ($177.52 in chips) 
Seat 2: michasia ($103.50 in chips) 
Seat 3: Iospirate ($34.66 in chips) 
Seat 4: Trojanovich ($207.12 in chips) 
Seat 5: henri789 ($256.15 in chips) 
Seat 6: xcinaz ($108.71 in chips) 
michasia: posts small blind $0.50
Iospirate: posts big blind $1
*** HOLE CARDS ***
Trojanovich: folds 
henri789: folds 
xcinaz: folds 
mr.Jckpot: folds 
michasia: folds 
Uncalled bet ($0.50) returned to Iospirate
Iospirate collected $1 from pot
Iospirate: doesn't show hand 
*** SUMMARY ***
Total pot $1 | Rake $0 
Seat 1: mr.Jckpot (button) folded before Flop (didn't bet)
Seat 2: michasia (small blind) folded before Flop
Seat 3: Iospirate (big blind) collected ($1)
Seat 4: Trojanovich folded before Flop (didn't bet)
Seat 5: henri789 folded before Flop (didn't bet)
Seat 6: xcinaz folded before Flop (didn't bet)



PokerStars Hand #254507201762:  Hold'em No Limit ($0.50/$1.00 USD) - 2025/01/22 22:39:17 WET [2025/01/22 17:39:17 ET]
Table 'Ajax III' 6-max Seat #2 is the button
Seat 1: mr.Jckpot ($177.52 in chips) 
Seat 2: michasia ($103 in chips) 
Seat 3: Iospirate ($35.16 in chips) 
Seat 4: Trojanovich ($207.12 in chips) 
Seat 5: henri789 ($256.15 in chips) 
Seat 6: xcinaz ($108.71 in chips) 
Iospirate: posts small blind $0.50
Trojanovich: posts big blind $1
*** HOLE CARDS ***
henri789: folds 
xcinaz: folds 
mr.Jckpot: raises $1.50 to $2.50
michasia: raises $5 to $7.50
Iospirate: folds 
Trojanovich: folds 
mr.Jckpot: calls $5
*** FLOP *** [4h Kh 5s]
mr.Jckpot: checks 
michasia: bets $5.17
mr.Jckpot: calls $5.17
*** TURN *** [4h Kh 5s] [Kc]
mr.Jckpot: checks 
michasia: bets $17
mr.Jckpot: calls $17
*** RIVER *** [4h Kh 5s Kc] [9s]
mr.Jckpot: checks 
michasia: checks 
*** SHOW DOWN ***
mr.Jckpot: shows [Qh Ks] (three of a kind, Kings)
michasia: mucks hand 
mr.Jckpot collected $58.34 from pot
*** SUMMARY ***
Total pot $60.84 | Rake $2.50 
Board [4h Kh 5s Kc 9s]
Seat 1: mr.Jckpot showed [Qh Ks] and won ($58.34) with three of a kind, Kings
Seat 2: michasia (button) mucked
Seat 3: Iospirate (small blind) folded before Flop
Seat 4: Trojanovich (big blind) folded before Flop
Seat 5: henri789 folded before Flop (didn't bet)
Seat 6: xcinaz folded before Flop (didn't bet)



PokerStars Hand #254507215229:  Hold'em No Limit ($0.50/$1.00 USD) - 2025/01/22 22:40:06 WET [2025/01/22 17:40:06 ET]
Table 'Ajax III' 6-max Seat #3 is the button
Seat 1: mr.Jckpot ($206.19 in chips) 
Seat 2: michasia ($100 in chips) 
Seat 3: Iospirate ($34.66 in chips) 
Seat 4: Trojanovich ($206.12 in chips) 
Seat 5: henri789 ($256.15 in chips) 
Seat 6: xcinaz ($108.71 in chips) 
Trojanovich: posts small blind $0.50
henri789: posts big blind $1
*** HOLE CARDS ***
xcinaz: folds 
mr.Jckpot: folds 
michasia: folds 
Iospirate: calls $1
Trojanovich: folds 
henri789: checks 
*** FLOP *** [2h 6c 3h]
henri789: bets $1
Iospirate: folds 
Uncalled bet ($1) returned to henri789
henri789 collected $2.38 from pot
henri789: doesn't show hand 
*** SUMMARY ***
Total pot $2.50 | Rake $0.12 
Board [2h 6c 3h]
Seat 1: mr.Jckpot folded before Flop (didn't bet)
Seat 2: michasia folded before Flop (didn't bet)
Seat 3: Iospirate (button) folded on the Flop
Seat 4: Trojanovich (small blind) folded before Flop
Seat 5: henri789 (big blind) collected ($2.38)
Seat 6: xcinaz folded before Flop (didn't bet)



PokerStars Hand #254507220107:  Hold'em No Limit ($0.50/$1.00 USD) - 2025/01/22 22:40:24 WET [2025/01/22 17:40:24 ET]
Table 'Ajax III' 6-max Seat #4 is the button
Seat 6: xcinaz ($108.71 in chips) is sitting out
Seat 1: mr.Jckpot ($206.19 in chips) 
Seat 2: michasia ($100 in chips) 
Seat 3: Iospirate ($33.66 in chips) 
Seat 4: Trojanovich ($205.62 in chips) 
Seat 5: henri789 ($257.53 in chips) 
henri789: posts small blind $0.50
xcinaz: is sitting out 
mr.Jckpot: posts big blind $1
*** HOLE CARDS ***
michasia: folds 
Iospirate: folds 
Trojanovich: folds 
henri789: raises $2 to $3
mr.Jckpot: folds 
Uncalled bet ($2) returned to henri789
henri789 collected $2 from pot
henri789: doesn't show hand 
*** SUMMARY ***
Total pot $2 | Rake $0 
Seat 6: xcinaz
Seat 1: mr.Jckpot (big blind) folded before Flop
Seat 2: michasia folded before Flop (didn't bet)
Seat 3: Iospirate folded before Flop (didn't bet)
Seat 4: Trojanovich (button) folded before Flop (didn't bet)
Seat 5: henri789 (small blind) collected ($2)



PokerStars Hand #254507223950:  Hold'em No Limit ($0.50/$1.00 USD) - 2025/01/22 22:40:38 WET [2025/01/22 17:40:38 ET]
Table 'Ajax III' 6-max Seat #5 is the button
Seat 6: xcinaz ($108.71 in chips) is sitting out
Seat 1: mr.Jckpot ($205.19 in chips) 
Seat 2: michasia ($100 in chips) 
Seat 3: Iospirate ($33.66 in chips) 
Seat 4: Trojanovich ($205.62 in chips) 
Seat 5: henri789 ($258.53 in chips) 
mr.Jckpot: posts small blind $0.50
michasia: posts big blind $1
*** HOLE CARDS ***
Iospirate: folds 
Trojanovich: folds 
henri789: folds 
mr.Jckpot: folds 
Uncalled bet ($0.50) returned to michasia
michasia collected $1 from pot
michasia: doesn't show hand 
*** SUMMARY ***
Total pot $1 | Rake $0 
Seat 6: xcinaz
Seat 1: mr.Jckpot (small blind) folded before Flop
Seat 2: michasia (big blind) collected ($1)
Seat 3: Iospirate folded before Flop (didn't bet)
Seat 4: Trojanovich folded before Flop (didn't bet)
Seat 5: henri789 (button) folded before Flop (didn't bet)



PokerStars Hand #254507227460:  Hold'em No Limit ($0.50/$1.00 USD) - 2025/01/22 22:40:52 WET [2025/01/22 17:40:52 ET]
Table 'Ajax III' 6-max Seat #1 is the button
Seat 6: xcinaz ($108.71 in chips) is sitting out
Seat 1: mr.Jckpot ($204.69 in chips) 
Seat 2: michasia ($100.50 in chips) 
Seat 3: Iospirate ($33.66 in chips) 
Seat 4: Trojanovich ($205.62 in chips) 
Seat 5: henri789 ($258.53 in chips) 
michasia: posts small blind $0.50
Iospirate: posts big blind $1
*** HOLE CARDS ***
Trojanovich: folds 
henri789: folds 
mr.Jckpot: folds 
michasia: raises $2 to $3
Iospirate: folds 
Uncalled bet ($2) returned to michasia
michasia collected $2 from pot
michasia: doesn't show hand 
*** SUMMARY ***
Total pot $2 | Rake $0 
Seat 6: xcinaz
Seat 1: mr.Jckpot (button) folded before Flop (didn't bet)
Seat 2: michasia (small blind) collected ($2)
Seat 3: Iospirate (big blind) folded before Flop
Seat 4: Trojanovich folded before Flop (didn't bet)
Seat 5: henri789 folded before Flop (didn't bet)



PokerStars Hand #254507230073:  Hold'em No Limit ($0.50/$1.00 USD) - 2025/01/22 22:41:01 WET [2025/01/22 17:41:01 ET]
Table 'Ajax III' 6-max Seat #2 is the button
Seat 6: xcinaz ($108.71 in chips) is sitting out
Seat 1: mr.Jckpot ($204.69 in chips) 
Seat 2: michasia ($101.50 in chips) 
Seat 3: Iospirate ($32.66 in chips) 
Seat 4: Trojanovich ($205.62 in chips) 
Seat 5: henri789 ($258.53 in chips) 
Iospirate: posts small blind $0.50
Trojanovich: posts big blind $1
xcinaz: sits out 
*** HOLE CARDS ***
henri789: folds 
mr.Jckpot: raises $1.50 to $2.50
michasia: folds 
Iospirate: calls $2
Trojanovich: folds 
*** FLOP *** [Js 5h 3c]
Iospirate: checks 
mr.Jckpot: bets $1.88
Iospirate: folds 
Uncalled bet ($1.88) returned to mr.Jckpot
mr.Jckpot collected $5.70 from pot
mr.Jckpot: doesn't show hand 
*** SUMMARY ***
Total pot $6 | Rake $0.30 
Board [Js 5h 3c]
Seat 6: xcinaz
Seat 1: mr.Jckpot collected ($5.70)
Seat 2: michasia (button) folded before Flop (didn't bet)
Seat 3: Iospirate (small blind) folded on the Flop
Seat 4: Trojanovich (big blind) folded before Flop
Seat 5: henri789 folded before Flop (didn't bet)



PokerStars Hand #254507237422:  Hold'em No Limit ($0.50/$1.00 USD) - 2025/01/22 22:41:29 WET [2025/01/22 17:41:29 ET]
Table 'Ajax III' 6-max Seat #3 is the button
Seat 6: xcinaz ($108.71 in chips) is sitting out
Seat 1: mr.Jckpot ($207.89 in chips) 
Seat 2: michasia ($101.50 in chips) 
Seat 3: Iospirate ($30.16 in chips) 
Seat 4: Trojanovich ($204.62 in chips) 
Seat 5: henri789 ($258.53 in chips) 
Trojanovich: posts small blind $0.50
henri789: posts big blind $1
xcinaz: sits out 
*** HOLE CARDS ***
mr.Jckpot: folds 
michasia: raises $1.80 to $2.80
Iospirate: folds 
Trojanovich: folds 
henri789: folds 
Uncalled bet ($1.80) returned to michasia
michasia collected $2.50 from pot
michasia: doesn't show hand 
*** SUMMARY ***
Total pot $2.50 | Rake $0 
Seat 6: xcinaz
Seat 1: mr.Jckpot folded before Flop (didn't bet)
Seat 2: michasia collected ($2.50)
Seat 3: Iospirate (button) folded before Flop (didn't bet)
Seat 4: Trojanovich (small blind) folded before Flop
Seat 5: henri789 (big blind) folded before Flop



PokerStars Hand #254507240573:  Hold'em No Limit ($0.50/$1.00 USD) - 2025/01/22 22:41:41 WET [2025/01/22 17:41:41 ET]
Table 'Ajax III' 6-max Seat #4 is the button
Seat 1: mr.Jckpot ($207.89 in chips) 
Seat 2: michasia ($103 in chips) 
Seat 3: Iospirate ($30.16 in chips) 
Seat 4: Trojanovich ($204.12 in chips) 
Seat 5: henri789 ($257.53 in chips) 
Seat 6: xcinaz ($108.71 in chips) 
henri789: posts small blind $0.50
xcinaz: posts big blind $1
*** HOLE CARDS ***
mr.Jckpot: folds 
michasia: folds 
Iospirate: folds 
Trojanovich: raises $1.50 to $2.50
henri789: folds 
xcinaz: calls $1.50
*** FLOP *** [Jh 8s 6s]
xcinaz: checks 
Trojanovich: bets $3.92
xcinaz: folds 
Uncalled bet ($3.92) returned to Trojanovich
Trojanovich collected $5.22 from pot
Trojanovich: doesn't show hand 
*** SUMMARY ***
Total pot $5.50 | Rake $0.28 
Board [Jh 8s 6s]
Seat 1: mr.Jckpot folded before Flop (didn't bet)
Seat 2: michasia folded before Flop (didn't bet)
Seat 3: Iospirate folded before Flop (didn't bet)
Seat 4: Trojanovich (button) collected ($5.22)
Seat 5: henri789 (small blind) folded before Flop
Seat 6: xcinaz (big blind) folded on the Flop



PokerStars Hand #254507254047:  Hold'em No Limit ($0.50/$1.00 USD) - 2025/01/22 22:42:32 WET [2025/01/22 17:42:32 ET]
Table 'Ajax III' 6-max Seat #5 is the button
Seat 1: mr.Jckpot ($207.89 in chips) 
Seat 2: michasia ($103 in chips) 
Seat 3: Iospirate ($30.16 in chips) 
Seat 4: Trojanovich ($206.84 in chips) 
Seat 5: henri789 ($257.03 in chips) 
Seat 6: xcinaz ($106.21 in chips) 
xcinaz: posts small blind $0.50
mr.Jckpot: posts big blind $1
*** HOLE CARDS ***
michasia: folds 
Iospirate: calls $1
Trojanovich: folds 
henri789: folds 
xcinaz: folds 
mr.Jckpot: raises $2.50 to $3.50
Iospirate: calls $2.50
*** FLOP *** [Tc 8c 4d]
mr.Jckpot: checks 
Iospirate: checks 
*** TURN *** [Tc 8c 4d] [2h]
mr.Jckpot: checks 
Iospirate: bets $2
mr.Jckpot: folds 
Uncalled bet ($2) returned to Iospirate
Iospirate collected $7.12 from pot
Iospirate: doesn't show hand 
*** SUMMARY ***
Total pot $7.50 | Rake $0.38 
Board [Tc 8c 4d 2h]
Seat 1: mr.Jckpot (big blind) folded on the Turn
Seat 2: michasia folded before Flop (didn't bet)
Seat 3: Iospirate collected ($7.12)
Seat 4: Trojanovich folded before Flop (didn't bet)
Seat 5: henri789 (button) folded before Flop (didn't bet)
Seat 6: xcinaz (small blind) folded before Flop



PokerStars Hand #254507264647:  Hold'em No Limit ($0.50/$1.00 USD) - 2025/01/22 22:43:12 WET [2025/01/22 17:43:12 ET]
Table 'Ajax III' 6-max Seat #6 is the button
Seat 1: mr.Jckpot ($204.39 in chips) 
Seat 2: michasia ($103 in chips) 
Seat 3: Iospirate ($33.78 in chips) 
Seat 4: Trojanovich ($206.84 in chips) 
Seat 5: henri789 ($257.03 in chips) 
Seat 6: xcinaz ($105.71 in chips) 
mr.Jckpot: posts small blind $0.50
michasia: posts big blind $1
*** HOLE CARDS ***
Iospirate: folds 
Trojanovich: folds 
henri789: folds 
xcinaz: folds 
mr.Jckpot: raises $2 to $3
michasia: calls $2
*** FLOP *** [5d 7d 7s]
mr.Jckpot: checks 
michasia: bets $3.80
mr.Jckpot: folds 
Uncalled bet ($3.80) returned to michasia
michasia collected $5.70 from pot
michasia: doesn't show hand 
*** SUMMARY ***
Total pot $6 | Rake $0.30 
Board [5d 7d 7s]
Seat 1: mr.Jckpot (small blind) folded on the Flop
Seat 2: michasia (big blind) collected ($5.70)
Seat 3: Iospirate folded before Flop (didn't bet)
Seat 4: Trojanovich folded before Flop (didn't bet)
Seat 5: henri789 folded before Flop (didn't bet)
Seat 6: xcinaz (button) folded before Flop (didn't bet)



PokerStars Hand #254507271556:  Hold'em No Limit ($0.50/$1.00 USD) - 2025/01/22 22:43:37 WET [2025/01/22 17:43:37 ET]
Table 'Ajax III' 6-max Seat #1 is the button
Seat 1: mr.Jckpot ($201.39 in chips) 
Seat 2: michasia ($105.70 in chips) 
Seat 3: Iospirate ($33.78 in chips) 
Seat 4: Trojanovich ($206.84 in chips) 
Seat 5: henri789 ($257.03 in chips) 
Seat 6: xcinaz ($105.71 in chips) 
michasia: posts small blind $0.50
Iospirate: posts big blind $1
*** HOLE CARDS ***
Trojanovich: folds 
henri789: raises $1.20 to $2.20
xcinaz: folds 
mr.Jckpot: folds 
michasia: folds 
Iospirate: folds 
Uncalled bet ($1.20) returned to henri789
henri789 collected $2.50 from pot
henri789: doesn't show hand 
*** SUMMARY ***
Total pot $2.50 | Rake $0 
Seat 1: mr.Jckpot (button) folded before Flop (didn't bet)
Seat 2: michasia (small blind) folded before Flop
Seat 3: Iospirate (big blind) folded before Flop
Seat 4: Trojanovich folded before Flop (didn't bet)
Seat 5: henri789 collected ($2.50)
Seat 6: xcinaz folded before Flop (didn't bet)



PokerStars Hand #254507278705:  Hold'em No Limit ($0.50/$1.00 USD) - 2025/01/22 22:44:04 WET [2025/01/22 17:44:04 ET]
Table 'Ajax III' 6-max Seat #2 is the button
Seat 1: mr.Jckpot ($201.39 in chips) 
Seat 2: michasia ($105.20 in chips) 
Seat 3: Iospirate ($32.78 in chips) 
Seat 4: Trojanovich ($206.84 in chips) 
Seat 5: henri789 ($258.53 in chips) 
Seat 6: xcinaz ($105.71 in chips) 
Iospirate: posts small blind $0.50
Trojanovich: posts big blind $1
*** HOLE CARDS ***
henri789: folds 
xcinaz: folds 
mr.Jckpot: raises $1.50 to $2.50
michasia: folds 
Iospirate: folds 
Trojanovich: folds 
Uncalled bet ($1.50) returned to mr.Jckpot
mr.Jckpot collected $2.50 from pot
mr.Jckpot: doesn't show hand 
*** SUMMARY ***
Total pot $2.50 | Rake $0 
Seat 1: mr.Jckpot collected ($2.50)
Seat 2: michasia (button) folded before Flop (didn't bet)
Seat 3: Iospirate (small blind) folded before Flop
Seat 4: Trojanovich (big blind) folded before Flop
Seat 5: henri789 folded before Flop (didn't bet)
Seat 6: xcinaz folded before Flop (didn't bet)



PokerStars Hand #254507282186:  Hold'em No Limit ($0.50/$1.00 USD) - 2025/01/22 22:44:17 WET [2025/01/22 17:44:17 ET]
Table 'Ajax III' 6-max Seat #3 is the button
Seat 1: mr.Jckpot ($202.89 in chips) 
Seat 2: michasia ($105.20 in chips) 
Seat 3: Iospirate ($32.28 in chips) 
Seat 4: Trojanovich ($205.84 in chips) 
Seat 5: henri789 ($258.53 in chips) 
Seat 6: xcinaz ($105.71 in chips) 
Trojanovich: posts small blind $0.50
henri789: posts big blind $1
*** HOLE CARDS ***
xcinaz: raises $1 to $2
mr.Jckpot: folds 
michasia: raises $4 to $6
Iospirate: calls $6
Trojanovich: folds 
henri789: folds 
xcinaz: folds 
*** FLOP *** [3c 5s 9h]
michasia: checks 
Iospirate: bets $26.28 and is all-in
michasia: folds 
Uncalled bet ($26.28) returned to Iospirate
Iospirate collected $14.72 from pot
Iospirate: doesn't show hand 
*** SUMMARY ***
Total pot $15.50 | Rake $0.78 
Board [3c 5s 9h]
Seat 1: mr.Jckpot folded before Flop (didn't bet)
Seat 2: michasia folded on the Flop
Seat 3: Iospirate (button) collected ($14.72)
Seat 4: Trojanovich (small blind) folded before Flop
Seat 5: henri789 (big blind) folded before Flop
Seat 6: xcinaz folded before Flop



PokerStars Hand #254507291414:  Hold'em No Limit ($0.50/$1.00 USD) - 2025/01/22 22:44:52 WET [2025/01/22 17:44:52 ET]
Table 'Ajax III' 6-max Seat #4 is the button
Seat 1: mr.Jckpot ($202.89 in chips) 
Seat 2: michasia ($100 in chips) 
Seat 3: Iospirate ($41 in chips) 
Seat 4: Trojanovich ($205.34 in chips) 
Seat 5: henri789 ($257.53 in chips) 
Seat 6: xcinaz ($103.71 in chips) 
henri789: posts small blind $0.50
xcinaz: posts big blind $1
*** HOLE CARDS ***
mr.Jckpot: folds 
michasia: folds 
Iospirate: folds 
Trojanovich: folds 
henri789: raises $2 to $3
xcinaz: folds 
Uncalled bet ($2) returned to henri789
henri789 collected $2 from pot
henri789: doesn't show hand 
*** SUMMARY ***
Total pot $2 | Rake $0 
Seat 1: mr.Jckpot folded before Flop (didn't bet)
Seat 2: michasia folded before Flop (didn't bet)
Seat 3: Iospirate folded before Flop (didn't bet)
Seat 4: Trojanovich (button) folded before Flop (didn't bet)
Seat 5: henri789 (small blind) collected ($2)
Seat 6: xcinaz (big blind) folded before Flop



PokerStars Hand #254507297048:  Hold'em No Limit ($0.50/$1.00 USD) - 2025/01/22 22:45:13 WET [2025/01/22 17:45:13 ET]
Table 'Ajax III' 6-max Seat #5 is the button
Seat 1: mr.Jckpot ($202.89 in chips) 
Seat 2: michasia ($100 in chips) 
Seat 3: Iospirate ($41 in chips) 
Seat 4: Trojanovich ($205.34 in chips) 
Seat 5: henri789 ($258.53 in chips) 
Seat 6: xcinaz ($102.71 in chips) 
xcinaz: posts small blind $0.50
mr.Jckpot: posts big blind $1
*** HOLE CARDS ***
michasia: folds 
Iospirate: folds 
Trojanovich: folds 
henri789: folds 
xcinaz: raises $2 to $3
mr.Jckpot: folds 
Uncalled bet ($2) returned to xcinaz
xcinaz collected $2 from pot
xcinaz: doesn't show hand 
*** SUMMARY ***
Total pot $2 | Rake $0 
Seat 1: mr.Jckpot (big blind) folded before Flop
Seat 2: michasia folded before Flop (didn't bet)
Seat 3: Iospirate folded before Flop (didn't bet)
Seat 4: Trojanovich folded before Flop (didn't bet)
Seat 5: henri789 (button) folded before Flop (didn't bet)
Seat 6: xcinaz (small blind) collected ($2)



PokerStars Hand #254507302084:  Hold'em No Limit ($0.50/$1.00 USD) - 2025/01/22 22:45:32 WET [2025/01/22 17:45:32 ET]
Table 'Ajax III' 6-max Seat #6 is the button
Seat 1: mr.Jckpot ($201.89 in chips) 
Seat 2: michasia ($100 in chips) 
Seat 3: Iospirate ($41 in chips) 
Seat 4: Trojanovich ($205.34 in chips) 
Seat 5: henri789 ($258.53 in chips) 
Seat 6: xcinaz ($103.71 in chips) 
mr.Jckpot: posts small blind $0.50
michasia: posts big blind $1
*** HOLE CARDS ***
Iospirate: folds 
Trojanovich: folds 
henri789: raises $1.20 to $2.20
xcinaz: folds 
mr.Jckpot: folds 
michasia: calls $1.20
*** FLOP *** [2s 3h 9s]
michasia: checks 
henri789: bets $2.28
michasia: raises $4.56 to $6.84
henri789: calls $4.56
*** TURN *** [2s 3h 9s] [8d]
michasia: bets $22.06
henri789: folds 
Uncalled bet ($22.06) returned to michasia
michasia collected $17.65 from pot
michasia: doesn't show hand 
*** SUMMARY ***
Total pot $18.58 | Rake $0.93 
Board [2s 3h 9s 8d]
Seat 1: mr.Jckpot (small blind) folded before Flop
Seat 2: michasia (big blind) collected ($17.65)
Seat 3: Iospirate folded before Flop (didn't bet)
Seat 4: Trojanovich folded before Flop (didn't bet)
Seat 5: henri789 folded on the Turn
Seat 6: xcinaz (button) folded before Flop (didn't bet)



PokerStars Hand #254507316728:  Hold'em No Limit ($0.50/$1.00 USD) - 2025/01/22 22:46:27 WET [2025/01/22 17:46:27 ET]
Table 'Ajax III' 6-max Seat #1 is the button
Seat 1: mr.Jckpot ($201.39 in chips) 
Seat 2: michasia ($108.61 in chips) 
Seat 3: Iospirate ($41 in chips) 
Seat 4: Trojanovich ($205.34 in chips) 
Seat 5: henri789 ($249.49 in chips) 
Seat 6: xcinaz ($103.71 in chips) 
michasia: posts small blind $0.50
Iospirate: posts big blind $1
*** HOLE CARDS ***
Trojanovich: folds 
henri789: folds 
xcinaz: raises $1.20 to $2.20
mr.Jckpot: folds 
michasia: folds 
Iospirate: folds 
Uncalled bet ($1.20) returned to xcinaz
xcinaz collected $2.50 from pot
xcinaz: doesn't show hand 
*** SUMMARY ***
Total pot $2.50 | Rake $0 
Seat 1: mr.Jckpot (button) folded before Flop (didn't bet)
Seat 2: michasia (small blind) folded before Flop
Seat 3: Iospirate (big blind) folded before Flop
Seat 4: Trojanovich folded before Flop (didn't bet)
Seat 5: henri789 folded before Flop (didn't bet)
Seat 6: xcinaz collected ($2.50)



PokerStars Hand #254507321945:  Hold'em No Limit ($0.50/$1.00 USD) - 2025/01/22 22:46:46 WET [2025/01/22 17:46:46 ET]
Table 'Ajax III' 6-max Seat #2 is the button
Seat 1: mr.Jckpot ($201.39 in chips) 
Seat 2: michasia ($108.11 in chips) 
Seat 3: Iospirate ($40 in chips) 
Seat 4: Trojanovich ($205.34 in chips) 
Seat 5: henri789 ($249.49 in chips) 
Seat 6: xcinaz ($105.21 in chips) 
Iospirate: posts small blind $0.50
Trojanovich: posts big blind $1
*** HOLE CARDS ***
henri789: folds 
xcinaz: folds 
mr.Jckpot: raises $1.50 to $2.50
michasia: folds 
Iospirate: calls $2
Trojanovich: raises $10 to $12.50
mr.Jckpot: calls $10
Iospirate: folds 
*** FLOP *** [3c Td Qd]
Trojanovich: bets $8.62
mr.Jckpot: folds 
Uncalled bet ($8.62) returned to Trojanovich
Trojanovich collected $26.12 from pot
Trojanovich: doesn't show hand 
*** SUMMARY ***
Total pot $27.50 | Rake $1.38 
Board [3c Td Qd]
Seat 1: mr.Jckpot folded on the Flop
Seat 2: michasia (button) folded before Flop (didn't bet)
Seat 3: Iospirate (small blind) folded before Flop
Seat 4: Trojanovich (big blind) collected ($26.12)
Seat 5: henri789 folded before Flop (didn't bet)
Seat 6: xcinaz folded before Flop (didn't bet)



PokerStars Hand #254507330185:  Hold'em No Limit ($0.50/$1.00 USD) - 2025/01/22 22:47:16 WET [2025/01/22 17:47:16 ET]
Table 'Ajax III' 6-max Seat #3 is the button
Seat 1: mr.Jckpot ($188.89 in chips) 
Seat 2: michasia ($108.11 in chips) 
Seat 3: Iospirate ($37.50 in chips) 
Seat 4: Trojanovich ($218.96 in chips) 
Seat 5: henri789 ($249.49 in chips) 
Seat 6: xcinaz ($105.21 in chips) 
Trojanovich: posts small blind $0.50
henri789: posts big blind $1
*** HOLE CARDS ***
xcinaz: folds 
mr.Jckpot: folds 
michasia: folds 
Iospirate: folds 
Trojanovich: folds 
Uncalled bet ($0.50) returned to henri789
henri789 collected $1 from pot
henri789: doesn't show hand 
*** SUMMARY ***
Total pot $1 | Rake $0 
Seat 1: mr.Jckpot folded before Flop (didn't bet)
Seat 2: michasia folded before Flop (didn't bet)
Seat 3: Iospirate (button) folded before Flop (didn't bet)
Seat 4: Trojanovich (small blind) folded before Flop
Seat 5: henri789 (big blind) collected ($1)
Seat 6: xcinaz folded before Flop (didn't bet)



PokerStars Hand #254507333016:  Hold'em No Limit ($0.50/$1.00 USD) - 2025/01/22 22:47:27 WET [2025/01/22 17:47:27 ET]
Table 'Ajax III' 6-max Seat #4 is the button
Seat 1: mr.Jckpot ($188.89 in chips) 
Seat 2: michasia ($108.11 in chips) 
Seat 3: Iospirate ($37.50 in chips) 
Seat 4: Trojanovich ($218.46 in chips) 
Seat 5: henri789 ($249.99 in chips) 
Seat 6: xcinaz ($105.21 in chips) 
henri789: posts small blind $0.50
xcinaz: posts big blind $1
*** HOLE CARDS ***
mr.Jckpot: folds 
michasia: folds 
Iospirate: folds 
Trojanovich: folds 
henri789: raises $2 to $3
xcinaz: raises $6 to $9
henri789: folds 
Uncalled bet ($6) returned to xcinaz
xcinaz collected $6 from pot
xcinaz: doesn't show hand 
*** SUMMARY ***
Total pot $6 | Rake $0 
Seat 1: mr.Jckpot folded before Flop (didn't bet)
Seat 2: michasia folded before Flop (didn't bet)
Seat 3: Iospirate folded before Flop (didn't bet)
Seat 4: Trojanovich (button) folded before Flop (didn't bet)
Seat 5: henri789 (small blind) folded before Flop
Seat 6: xcinaz (big blind) collected ($6)



PokerStars Hand #254507339812:  Hold'em No Limit ($0.50/$1.00 USD) - 2025/01/22 22:47:52 WET [2025/01/22 17:47:52 ET]
Table 'Ajax III' 6-max Seat #5 is the button
Seat 1: mr.Jckpot ($188.89 in chips) 
Seat 2: michasia ($108.11 in chips) 
Seat 3: Iospirate ($37.50 in chips) 
Seat 4: Trojanovich ($218.46 in chips) 
Seat 5: henri789 ($246.99 in chips) 
Seat 6: xcinaz ($108.21 in chips) 
xcinaz: posts small blind $0.50
mr.Jckpot: posts big blind $1
*** HOLE CARDS ***
michasia: folds 
Iospirate: calls $1
Trojanovich: folds 
henri789: folds 
xcinaz: folds 
mr.Jckpot: checks 
*** FLOP *** [As 4s Tc]
mr.Jckpot: checks 
Iospirate: checks 
*** TURN *** [As 4s Tc] [Jd]
mr.Jckpot: checks 
Iospirate: checks 
*** RIVER *** [As 4s Tc Jd] [Ks]
mr.Jckpot: checks 
Iospirate: checks 
*** SHOW DOWN ***
mr.Jckpot: shows [3c 3h] (a pair of Threes)
Iospirate: shows [4h 5h] (a pair of Fours)
Iospirate collected $2.38 from pot
*** SUMMARY ***
Total pot $2.50 | Rake $0.12 
Board [As 4s Tc Jd Ks]
Seat 1: mr.Jckpot (big blind) showed [3c 3h] and lost with a pair of Threes
Seat 2: michasia folded before Flop (didn't bet)
Seat 3: Iospirate showed [4h 5h] and won ($2.38) with a pair of Fours
Seat 4: Trojanovich folded before Flop (didn't bet)
Seat 5: henri789 (button) folded before Flop (didn't bet)
Seat 6: xcinaz (small blind) folded before Flop



PokerStars Hand #254507349406:  Hold'em No Limit ($0.50/$1.00 USD) - 2025/01/22 22:48:27 WET [2025/01/22 17:48:27 ET]
Table 'Ajax III' 6-max Seat #6 is the button
Seat 1: mr.Jckpot ($187.89 in chips) 
Seat 2: michasia ($108.11 in chips) 
Seat 3: Iospirate ($38.88 in chips) 
Seat 4: Trojanovich ($218.46 in chips) 
Seat 5: henri789 ($246.99 in chips) 
Seat 6: xcinaz ($107.71 in chips) 
mr.Jckpot: posts small blind $0.50
michasia: posts big blind $1
*** HOLE CARDS ***
Iospirate: folds 
Trojanovich: folds 
henri789: raises $1.20 to $2.20
xcinaz: folds 
mr.Jckpot: folds 
michasia: folds 
Uncalled bet ($1.20) returned to henri789
henri789 collected $2.50 from pot
henri789: doesn't show hand 
*** SUMMARY ***
Total pot $2.50 | Rake $0 
Seat 1: mr.Jckpot (small blind) folded before Flop
Seat 2: michasia (big blind) folded before Flop
Seat 3: Iospirate folded before Flop (didn't bet)
Seat 4: Trojanovich folded before Flop (didn't bet)
Seat 5: henri789 collected ($2.50)
Seat 6: xcinaz (button) folded before Flop (didn't bet)



PokerStars Hand #254507354053:  Hold'em No Limit ($0.50/$1.00 USD) - 2025/01/22 22:48:45 WET [2025/01/22 17:48:45 ET]
Table 'Ajax III' 6-max Seat #1 is the button
Seat 1: mr.Jckpot ($187.39 in chips) 
Seat 2: michasia ($107.11 in chips) 
Seat 3: Iospirate ($38.88 in chips) 
Seat 4: Trojanovich ($218.46 in chips) 
Seat 5: henri789 ($248.49 in chips) 
Seat 6: xcinaz ($107.71 in chips) 
michasia: posts small blind $0.50
Iospirate: posts big blind $1
*** HOLE CARDS ***
Trojanovich: folds 
henri789: folds 
xcinaz: folds 
mr.Jckpot: folds 
michasia: folds 
Uncalled bet ($0.50) returned to Iospirate
Iospirate collected $1 from pot
Iospirate: doesn't show hand 
*** SUMMARY ***
Total pot $1 | Rake $0 
Seat 1: mr.Jckpot (button) folded before Flop (didn't bet)
Seat 2: michasia (small blind) folded before Flop
Seat 3: Iospirate (big blind) collected ($1)
Seat 4: Trojanovich folded before Flop (didn't bet)
Seat 5: henri789 folded before Flop (didn't bet)
Seat 6: xcinaz folded before Flop (didn't bet)



PokerStars Hand #254507358534:  Hold'em No Limit ($0.50/$1.00 USD) - 2025/01/22 22:49:02 WET [2025/01/22 17:49:02 ET]
Table 'Ajax III' 6-max Seat #2 is the button
Seat 1: mr.Jckpot ($187.39 in chips) 
Seat 2: michasia ($106.61 in chips) 
Seat 3: Iospirate ($39.38 in chips) 
Seat 4: Trojanovich ($218.46 in chips) 
Seat 5: henri789 ($248.49 in chips) 
Seat 6: xcinaz ($107.71 in chips) 
Iospirate: posts small blind $0.50
Trojanovich: posts big blind $1
*** HOLE CARDS ***
henri789: folds 
xcinaz: folds 
mr.Jckpot: folds 
michasia: folds 
Iospirate: raises $1 to $2
Trojanovich: calls $1
*** FLOP *** [Kh 6h Ac]
Iospirate: bets $3
Trojanovich: raises $6 to $9
Iospirate: raises $28.38 to $37.38 and is all-in
Trojanovich: calls $28.38
*** TURN *** [Kh 6h Ac] [Th]
*** RIVER *** [Kh 6h Ac Th] [9c]
*** SHOW DOWN ***
Iospirate: shows [Kc Kd] (three of a kind, Kings)
Trojanovich: shows [Ks 6s] (two pair, Kings and Sixes)
Iospirate collected $76.26 from pot
*** SUMMARY ***
Total pot $78.76 | Rake $2.50 
Board [Kh 6h Ac Th 9c]
Seat 1: mr.Jckpot folded before Flop (didn't bet)
Seat 2: michasia (button) folded before Flop (didn't bet)
Seat 3: Iospirate (small blind) showed [Kc Kd] and won ($76.26) with three of a kind, Kings
Seat 4: Trojanovich (big blind) showed [Ks 6s] and lost with two pair, Kings and Sixes
Seat 5: henri789 folded before Flop (didn't bet)
Seat 6: xcinaz folded before Flop (didn't bet)



PokerStars Hand #254507372119:  Hold'em No Limit ($0.50/$1.00 USD) - 2025/01/22 22:49:52 WET [2025/01/22 17:49:52 ET]
Table 'Ajax III' 6-max Seat #3 is the button
Seat 1: mr.Jckpot ($187.39 in chips) 
Seat 2: michasia ($106.61 in chips) 
Seat 3: Iospirate ($76.26 in chips) 
Seat 4: Trojanovich ($179.08 in chips) 
Seat 5: henri789 ($248.49 in chips) 
Seat 6: xcinaz ($107.71 in chips) 
Trojanovich: posts small blind $0.50
henri789: posts big blind $1
*** HOLE CARDS ***
xcinaz: folds 
mr.Jckpot: folds 
michasia: folds 
Iospirate: folds 
Trojanovich: folds 
Uncalled bet ($0.50) returned to henri789
henri789 collected $1 from pot
henri789: doesn't show hand 
*** SUMMARY ***
Total pot $1 | Rake $0 
Seat 1: mr.Jckpot folded before Flop (didn't bet)
Seat 2: michasia folded before Flop (didn't bet)
Seat 3: Iospirate (button) folded before Flop (didn't bet)
Seat 4: Trojanovich (small blind) folded before Flop
Seat 5: henri789 (big blind) collected ($1)
Seat 6: xcinaz folded before Flop (didn't bet)



PokerStars Hand #254507375137:  Hold'em No Limit ($0.50/$1.00 USD) - 2025/01/22 22:50:03 WET [2025/01/22 17:50:03 ET]
Table 'Ajax III' 6-max Seat #4 is the button
Seat 1: mr.Jckpot ($187.39 in chips) 
Seat 2: michasia ($106.61 in chips) 
Seat 3: Iospirate ($76.26 in chips) 
Seat 4: Trojanovich ($178.58 in chips) 
Seat 5: henri789 ($248.99 in chips) 
Seat 6: xcinaz ($107.71 in chips) 
henri789: posts small blind $0.50
xcinaz: posts big blind $1
*** HOLE CARDS ***
mr.Jckpot: folds 
michasia: raises $1.60 to $2.60
Iospirate: folds 
Trojanovich: folds 
henri789: folds 
xcinaz: folds 
Uncalled bet ($1.60) returned to michasia
michasia collected $2.50 from pot
michasia: doesn't show hand 
*** SUMMARY ***
Total pot $2.50 | Rake $0 
Seat 1: mr.Jckpot folded before Flop (didn't bet)
Seat 2: michasia collected ($2.50)
Seat 3: Iospirate folded before Flop (didn't bet)
Seat 4: Trojanovich (button) folded before Flop (didn't bet)
Seat 5: henri789 (small blind) folded before Flop
Seat 6: xcinaz (big blind) folded before Flop



PokerStars Hand #254507381896:  Hold'em No Limit ($0.50/$1.00 USD) - 2025/01/22 22:50:29 WET [2025/01/22 17:50:29 ET]
Table 'Ajax III' 6-max Seat #5 is the button
Seat 1: mr.Jckpot ($187.39 in chips) 
Seat 2: michasia ($108.11 in chips) 
Seat 3: Iospirate ($76.26 in chips) 
Seat 4: Trojanovich ($178.58 in chips) 
Seat 5: henri789 ($248.49 in chips) 
Seat 6: xcinaz ($106.71 in chips) 
xcinaz: posts small blind $0.50
mr.Jckpot: posts big blind $1
*** HOLE CARDS ***
michasia: folds 
Iospirate: folds 
Trojanovich: folds 
henri789: folds 
xcinaz: folds 
Uncalled bet ($0.50) returned to mr.Jckpot
mr.Jckpot collected $1 from pot
mr.Jckpot: doesn't show hand 
*** SUMMARY ***
Total pot $1 | Rake $0 
Seat 1: mr.Jckpot (big blind) collected ($1)
Seat 2: michasia folded before Flop (didn't bet)
Seat 3: Iospirate folded before Flop (didn't bet)
Seat 4: Trojanovich folded before Flop (didn't bet)
Seat 5: henri789 (button) folded before Flop (didn't bet)
Seat 6: xcinaz (small blind) folded before Flop



PokerStars Hand #254507385827:  Hold'em No Limit ($0.50/$1.00 USD) - 2025/01/22 22:50:43 WET [2025/01/22 17:50:43 ET]
Table 'Ajax III' 6-max Seat #6 is the button
Seat 1: mr.Jckpot ($187.89 in chips) 
Seat 2: michasia ($108.11 in chips) 
Seat 3: Iospirate ($76.26 in chips) 
Seat 4: Trojanovich ($178.58 in chips) 
Seat 5: henri789 ($248.49 in chips) 
Seat 6: xcinaz ($106.21 in chips) 
mr.Jckpot: posts small blind $0.50
michasia: posts big blind $1
*** HOLE CARDS ***
Iospirate: folds 
Trojanovich: folds 
henri789: folds 
xcinaz: folds 
mr.Jckpot: folds 
Uncalled bet ($0.50) returned to michasia
michasia collected $1 from pot
michasia: doesn't show hand 
*** SUMMARY ***
Total pot $1 | Rake $0 
Seat 1: mr.Jckpot (small blind) folded before Flop
Seat 2: michasia (big blind) collected ($1)
Seat 3: Iospirate folded before Flop (didn't bet)
Seat 4: Trojanovich folded before Flop (didn't bet)
Seat 5: henri789 folded before Flop (didn't bet)
Seat 6: xcinaz (button) folded before Flop (didn't bet)



PokerStars Hand #254507390817:  Hold'em No Limit ($0.50/$1.00 USD) - 2025/01/22 22:51:02 WET [2025/01/22 17:51:02 ET]
Table 'Ajax III' 6-max Seat #1 is the button
Seat 1: mr.Jckpot ($187.39 in chips) 
Seat 2: michasia ($108.61 in chips) 
Seat 3: Iospirate ($76.26 in chips) 
Seat 4: Trojanovich ($178.58 in chips) 
Seat 5: henri789 ($248.49 in chips) 
Seat 6: xcinaz ($106.21 in chips) 
michasia: posts small blind $0.50
Iospirate: posts big blind $1
*** HOLE CARDS ***
Trojanovich: folds 
henri789: folds 
xcinaz: folds 
mr.Jckpot: folds 
michasia: raises $2 to $3
Iospirate: raises $5 to $8
michasia: folds 
Uncalled bet ($5) returned to Iospirate
Iospirate collected $6 from pot
Iospirate: doesn't show hand 
*** SUMMARY ***
Total pot $6 | Rake $0 
Seat 1: mr.Jckpot (button) folded before Flop (didn't bet)
Seat 2: michasia (small blind) folded before Flop
Seat 3: Iospirate (big blind) collected ($6)
Seat 4: Trojanovich folded before Flop (didn't bet)
Seat 5: henri789 folded before Flop (didn't bet)
Seat 6: xcinaz folded before Flop (didn't bet)



PokerStars Hand #254507396859:  Hold'em No Limit ($0.50/$1.00 USD) - 2025/01/22 22:51:25 WET [2025/01/22 17:51:25 ET]
Table 'Ajax III' 6-max Seat #2 is the button
Seat 1: mr.Jckpot ($187.39 in chips) 
Seat 2: michasia ($105.61 in chips) 
Seat 3: Iospirate ($79.26 in chips) 
Seat 4: Trojanovich ($178.58 in chips) 
Seat 5: henri789 ($248.49 in chips) 
Seat 6: xcinaz ($106.21 in chips) 
Iospirate: posts small blind $0.50
Trojanovich: posts big blind $1
*** HOLE CARDS ***
henri789: folds 
xcinaz: folds 
mr.Jckpot: folds 
michasia: folds 
Iospirate: folds 
Uncalled bet ($0.50) returned to Trojanovich
Trojanovich collected $1 from pot
Trojanovich: doesn't show hand 
*** SUMMARY ***
Total pot $1 | Rake $0 
Seat 1: mr.Jckpot folded before Flop (didn't bet)
Seat 2: michasia (button) folded before Flop (didn't bet)
Seat 3: Iospirate (small blind) folded before Flop
Seat 4: Trojanovich (big blind) collected ($1)
Seat 5: henri789 folded before Flop (didn't bet)
Seat 6: xcinaz folded before Flop (didn't bet)



PokerStars Hand #254507401960:  Hold'em No Limit ($0.50/$1.00 USD) - 2025/01/22 22:51:44 WET [2025/01/22 17:51:44 ET]
Table 'Ajax III' 6-max Seat #3 is the button
Seat 1: mr.Jckpot ($187.39 in chips) 
Seat 2: michasia ($105.61 in chips) 
Seat 3: Iospirate ($78.76 in chips) 
Seat 4: Trojanovich ($179.08 in chips) 
Seat 5: henri789 ($248.49 in chips) 
Seat 6: xcinaz ($106.21 in chips) 
Trojanovich: posts small blind $0.50
henri789: posts big blind $1
*** HOLE CARDS ***
xcinaz: folds 
mr.Jckpot: raises $1.50 to $2.50
michasia: folds 
Iospirate: calls $2.50
Trojanovich: folds 
henri789: folds 
*** FLOP *** [7h 4h 7s]
mr.Jckpot: checks 
Iospirate: checks 
*** TURN *** [7h 4h 7s] [Ah]
mr.Jckpot: checks 
Iospirate: bets $2
mr.Jckpot: folds 
Uncalled bet ($2) returned to Iospirate
Iospirate collected $6.18 from pot
Iospirate: doesn't show hand 
*** SUMMARY ***
Total pot $6.50 | Rake $0.32 
Board [7h 4h 7s Ah]
Seat 1: mr.Jckpot folded on the Turn
Seat 2: michasia folded before Flop (didn't bet)
Seat 3: Iospirate (button) collected ($6.18)
Seat 4: Trojanovich (small blind) folded before Flop
Seat 5: henri789 (big blind) folded before Flop
Seat 6: xcinaz folded before Flop (didn't bet)



PokerStars Hand #254507413574:  Hold'em No Limit ($0.50/$1.00 USD) - 2025/01/22 22:52:28 WET [2025/01/22 17:52:28 ET]
Table 'Ajax III' 6-max Seat #4 is the button
Seat 1: mr.Jckpot ($184.89 in chips) 
Seat 2: michasia ($105.61 in chips) 
Seat 3: Iospirate ($82.44 in chips) 
Seat 4: Trojanovich ($178.58 in chips) 
Seat 5: henri789 ($247.49 in chips) 
Seat 6: xcinaz ($106.21 in chips) 
henri789: posts small blind $0.50
xcinaz: posts big blind $1
*** HOLE CARDS ***
mr.Jckpot: folds 
michasia: folds 
Iospirate: folds 
Trojanovich: folds 
henri789: folds 
Uncalled bet ($0.50) returned to xcinaz
xcinaz collected $1 from pot
xcinaz: doesn't show hand 
*** SUMMARY ***
Total pot $1 | Rake $0 
Seat 1: mr.Jckpot folded before Flop (didn't bet)
Seat 2: michasia folded before Flop (didn't bet)
Seat 3: Iospirate folded before Flop (didn't bet)
Seat 4: Trojanovich (button) folded before Flop (didn't bet)
Seat 5: henri789 (small blind) folded before Flop
Seat 6: xcinaz (big blind) collected ($1)



PokerStars Hand #254507416897:  Hold'em No Limit ($0.50/$1.00 USD) - 2025/01/22 22:52:41 WET [2025/01/22 17:52:41 ET]
Table 'Ajax III' 6-max Seat #5 is the button
Seat 1: mr.Jckpot ($184.89 in chips) 
Seat 2: michasia ($105.61 in chips) 
Seat 3: Iospirate ($82.44 in chips) 
Seat 4: Trojanovich ($178.58 in chips) 
Seat 5: henri789 ($246.99 in chips) 
Seat 6: xcinaz ($106.71 in chips) 
xcinaz: posts small blind $0.50
mr.Jckpot: posts big blind $1
*** HOLE CARDS ***
michasia: folds 
Iospirate: folds 
Trojanovich: folds 
henri789: raises $1.20 to $2.20
xcinaz: folds 
mr.Jckpot: folds 
Uncalled bet ($1.20) returned to henri789
henri789 collected $2.50 from pot
henri789: doesn't show hand 
*** SUMMARY ***
Total pot $2.50 | Rake $0 
Seat 1: mr.Jckpot (big blind) folded before Flop
Seat 2: michasia folded before Flop (didn't bet)
Seat 3: Iospirate folded before Flop (didn't bet)
Seat 4: Trojanovich folded before Flop (didn't bet)
Seat 5: henri789 (button) collected ($2.50)
Seat 6: xcinaz (small blind) folded before Flop



PokerStars Hand #254507421023:  Hold'em No Limit ($0.50/$1.00 USD) - 2025/01/22 22:52:57 WET [2025/01/22 17:52:57 ET]
Table 'Ajax III' 6-max Seat #6 is the button
Seat 1: mr.Jckpot ($183.89 in chips) 
Seat 2: michasia ($105.61 in chips) 
Seat 3: Iospirate ($82.44 in chips) 
Seat 4: Trojanovich ($178.58 in chips) 
Seat 5: henri789 ($248.49 in chips) 
Seat 6: xcinaz ($106.21 in chips) 
mr.Jckpot: posts small blind $0.50
michasia: posts big blind $1
*** HOLE CARDS ***
Iospirate: folds 
Trojanovich: folds 
henri789: folds 
xcinaz: raises $1.50 to $2.50
mr.Jckpot: folds 
michasia: folds 
Uncalled bet ($1.50) returned to xcinaz
xcinaz collected $2.50 from pot
xcinaz: doesn't show hand 
*** SUMMARY ***
Total pot $2.50 | Rake $0 
Seat 1: mr.Jckpot (small blind) folded before Flop
Seat 2: michasia (big blind) folded before Flop
Seat 3: Iospirate folded before Flop (didn't bet)
Seat 4: Trojanovich folded before Flop (didn't bet)
Seat 5: henri789 folded before Flop (didn't bet)
Seat 6: xcinaz (button) collected ($2.50)



PokerStars Hand #254507425319:  Hold'em No Limit ($0.50/$1.00 USD) - 2025/01/22 22:53:13 WET [2025/01/22 17:53:13 ET]
Table 'Ajax III' 6-max Seat #1 is the button
Seat 1: mr.Jckpot ($183.39 in chips) 
Seat 2: michasia ($104.61 in chips) 
Seat 3: Iospirate ($82.44 in chips) 
Seat 4: Trojanovich ($178.58 in chips) 
Seat 5: henri789 ($248.49 in chips) 
Seat 6: xcinaz ($107.71 in chips) 
michasia: posts small blind $0.50
Iospirate: posts big blind $1
*** HOLE CARDS ***
Trojanovich: raises $1.50 to $2.50
henri789: folds 
xcinaz: folds 
mr.Jckpot: folds 
michasia: folds 
Iospirate: folds 
Uncalled bet ($1.50) returned to Trojanovich
Trojanovich collected $2.50 from pot
Trojanovich: doesn't show hand 
*** SUMMARY ***
Total pot $2.50 | Rake $0 
Seat 1: mr.Jckpot (button) folded before Flop (didn't bet)
Seat 2: michasia (small blind) folded before Flop
Seat 3: Iospirate (big blind) folded before Flop
Seat 4: Trojanovich collected ($2.50)
Seat 5: henri789 folded before Flop (didn't bet)
Seat 6: xcinaz folded before Flop (didn't bet)



PokerStars Hand #254507428570:  Hold'em No Limit ($0.50/$1.00 USD) - 2025/01/22 22:53:26 WET [2025/01/22 17:53:26 ET]
Table 'Ajax III' 6-max Seat #2 is the button
Seat 1: mr.Jckpot ($183.39 in chips) 
Seat 2: michasia ($104.11 in chips) 
Seat 3: Iospirate ($81.44 in chips) 
Seat 4: Trojanovich ($180.08 in chips) 
Seat 5: henri789 ($248.49 in chips) 
Seat 6: xcinaz ($107.71 in chips) 
Iospirate: posts small blind $0.50
Trojanovich: posts big blind $1
*** HOLE CARDS ***
henri789: folds 
xcinaz: folds 
mr.Jckpot: folds 
michasia: raises $1.80 to $2.80
Iospirate: folds 
Trojanovich: folds 
Uncalled bet ($1.80) returned to michasia
michasia collected $2.50 from pot
michasia: doesn't show hand 
*** SUMMARY ***
Total pot $2.50 | Rake $0 
Seat 1: mr.Jckpot folded before Flop (didn't bet)
Seat 2: michasia (button) collected ($2.50)
Seat 3: Iospirate (small blind) folded before Flop
Seat 4: Trojanovich (big blind) folded before Flop
Seat 5: henri789 folded before Flop (didn't bet)
Seat 6: xcinaz folded before Flop (didn't bet)



PokerStars Hand #254507433758:  Hold'em No Limit ($0.50/$1.00 USD) - 2025/01/22 22:53:46 WET [2025/01/22 17:53:46 ET]
Table 'Ajax III' 6-max Seat #3 is the button
Seat 1: mr.Jckpot ($183.39 in chips) 
Seat 2: michasia ($105.61 in chips) 
Seat 3: Iospirate ($80.94 in chips) 
Seat 4: Trojanovich ($179.08 in chips) 
Seat 5: henri789 ($248.49 in chips) 
Seat 6: xcinaz ($107.71 in chips) 
Trojanovich: posts small blind $0.50
henri789: posts big blind $1
*** HOLE CARDS ***
xcinaz: folds 
mr.Jckpot: folds 
michasia: raises $1.80 to $2.80
Iospirate: calls $2.80
Trojanovich: folds 
henri789: folds 
*** FLOP *** [4s 2h 2s]
michasia: checks 
Iospirate: checks 
*** TURN *** [4s 2h 2s] [3d]
michasia: checks 
Iospirate: checks 
*** RIVER *** [4s 2h 2s 3d] [5c]
michasia: checks 
Iospirate: checks 
*** SHOW DOWN ***
michasia: shows [Jd Kd] (a pair of Deuces)
Iospirate: shows [7s 7h] (two pair, Sevens and Deuces)
Iospirate collected $6.74 from pot
*** SUMMARY ***
Total pot $7.10 | Rake $0.36 
Board [4s 2h 2s 3d 5c]
Seat 1: mr.Jckpot folded before Flop (didn't bet)
Seat 2: michasia showed [Jd Kd] and lost with a pair of Deuces
Seat 3: Iospirate (button) showed [7s 7h] and won ($6.74) with two pair, Sevens and Deuces
Seat 4: Trojanovich (small blind) folded before Flop
Seat 5: henri789 (big blind) folded before Flop
Seat 6: xcinaz folded before Flop (didn't bet)



PokerStars Hand #254507445764:  Hold'em No Limit ($0.50/$1.00 USD) - 2025/01/22 22:54:32 WET [2025/01/22 17:54:32 ET]
Table 'Ajax III' 6-max Seat #4 is the button
Seat 1: mr.Jckpot ($183.39 in chips) 
Seat 2: michasia ($102.81 in chips) 
Seat 3: Iospirate ($84.88 in chips) 
Seat 4: Trojanovich ($178.58 in chips) 
Seat 5: henri789 ($247.49 in chips) 
Seat 6: xcinaz ($107.71 in chips) 
henri789: posts small blind $0.50
xcinaz: posts big blind $1
*** HOLE CARDS ***
mr.Jckpot: folds 
michasia: folds 
Iospirate: folds 
Trojanovich: folds 
henri789: raises $2 to $3
xcinaz: folds 
Uncalled bet ($2) returned to henri789
henri789 collected $2 from pot
henri789: doesn't show hand 
*** SUMMARY ***
Total pot $2 | Rake $0 
Seat 1: mr.Jckpot folded before Flop (didn't bet)
Seat 2: michasia folded before Flop (didn't bet)
Seat 3: Iospirate folded before Flop (didn't bet)
Seat 4: Trojanovich (button) folded before Flop (didn't bet)
Seat 5: henri789 (small blind) collected ($2)
Seat 6: xcinaz (big blind) folded before Flop



PokerStars Hand #254507450811:  Hold'em No Limit ($0.50/$1.00 USD) - 2025/01/22 22:54:51 WET [2025/01/22 17:54:51 ET]
Table 'Ajax III' 6-max Seat #5 is the button
Seat 1: mr.Jckpot ($183.39 in chips) 
Seat 2: michasia ($102.81 in chips) 
Seat 3: Iospirate ($84.88 in chips) 
Seat 4: Trojanovich ($178.58 in chips) 
Seat 5: henri789 ($248.49 in chips) 
Seat 6: xcinaz ($106.71 in chips) 
xcinaz: posts small blind $0.50
mr.Jckpot: posts big blind $1
*** HOLE CARDS ***
michasia: folds 
Iospirate: folds 
Trojanovich: folds 
henri789: folds 
xcinaz: raises $2 to $3
mr.Jckpot: folds 
Uncalled bet ($2) returned to xcinaz
xcinaz collected $2 from pot
xcinaz: doesn't show hand 
*** SUMMARY ***
Total pot $2 | Rake $0 
Seat 1: mr.Jckpot (big blind) folded before Flop
Seat 2: michasia folded before Flop (didn't bet)
Seat 3: Iospirate folded before Flop (didn't bet)
Seat 4: Trojanovich folded before Flop (didn't bet)
Seat 5: henri789 (button) folded before Flop (didn't bet)
Seat 6: xcinaz (small blind) collected ($2)



PokerStars Hand #254507454771:  Hold'em No Limit ($0.50/$1.00 USD) - 2025/01/22 22:55:06 WET [2025/01/22 17:55:06 ET]
Table 'Ajax III' 6-max Seat #6 is the button
Seat 1: mr.Jckpot ($182.39 in chips) 
Seat 2: michasia ($102.81 in chips) 
Seat 3: Iospirate ($84.88 in chips) 
Seat 4: Trojanovich ($178.58 in chips) 
Seat 5: henri789 ($248.49 in chips) 
Seat 6: xcinaz ($107.71 in chips) 
mr.Jckpot: posts small blind $0.50
michasia: posts big blind $1
*** HOLE CARDS ***
Iospirate: folds 
Trojanovich: folds 
henri789: folds 
xcinaz: raises $1.50 to $2.50
mr.Jckpot: folds 
michasia: raises $9.50 to $12
xcinaz: folds 
Uncalled bet ($9.50) returned to michasia
michasia collected $5.50 from pot
michasia: doesn't show hand 
*** SUMMARY ***
Total pot $5.50 | Rake $0 
Seat 1: mr.Jckpot (small blind) folded before Flop
Seat 2: michasia (big blind) collected ($5.50)
Seat 3: Iospirate folded before Flop (didn't bet)
Seat 4: Trojanovich folded before Flop (didn't bet)
Seat 5: henri789 folded before Flop (didn't bet)
Seat 6: xcinaz (button) folded before Flop



PokerStars Hand #254507461657:  Hold'em No Limit ($0.50/$1.00 USD) - 2025/01/22 22:55:39 WET [2025/01/22 17:55:39 ET]
Table 'Ajax III' 6-max Seat #1 is the button
Seat 1: mr.Jckpot ($181.89 in chips) 
Seat 2: michasia ($105.81 in chips) 
Seat 3: Iospirate ($84.88 in chips) 
Seat 4: Trojanovich ($178.58 in chips) 
Seat 5: henri789 ($248.49 in chips) 
Seat 6: xcinaz ($105.21 in chips) 
michasia: posts small blind $0.50
Iospirate: posts big blind $1
*** HOLE CARDS ***
Trojanovich: folds 
henri789: raises $1.20 to $2.20
xcinaz: folds 
mr.Jckpot: folds 
michasia: folds 
Iospirate: folds 
Uncalled bet ($1.20) returned to henri789
henri789 collected $2.50 from pot
henri789: doesn't show hand 
*** SUMMARY ***
Total pot $2.50 | Rake $0 
Seat 1: mr.Jckpot (button) folded before Flop (didn't bet)
Seat 2: michasia (small blind) folded before Flop
Seat 3: Iospirate (big blind) folded before Flop
Seat 4: Trojanovich folded before Flop (didn't bet)
Seat 5: henri789 collected ($2.50)
Seat 6: xcinaz folded before Flop (didn't bet)



PokerStars Hand #254507465895:  Hold'em No Limit ($0.50/$1.00 USD) - 2025/01/22 22:56:01 WET [2025/01/22 17:56:01 ET]
Table 'Ajax III' 6-max Seat #2 is the button
Seat 1: mr.Jckpot ($181.89 in chips) 
Seat 2: michasia ($105.31 in chips) 
Seat 3: Iospirate ($83.88 in chips) 
Seat 4: Trojanovich ($178.58 in chips) 
Seat 5: henri789 ($249.99 in chips) 
Seat 6: xcinaz ($105.21 in chips) 
Iospirate: posts small blind $0.50
Trojanovich: posts big blind $1
*** HOLE CARDS ***
henri789: folds 
xcinaz: folds 
mr.Jckpot: folds 
michasia: raises $1.80 to $2.80
Iospirate: calls $2.30
Trojanovich: folds 
*** FLOP *** [8h 8d Qd]
Iospirate: checks 
michasia: checks 
*** TURN *** [8h 8d Qd] [Qc]
Iospirate: bets $5
michasia: folds 
Uncalled bet ($5) returned to Iospirate
Iospirate collected $6.27 from pot
Iospirate: doesn't show hand 
*** SUMMARY ***
Total pot $6.60 | Rake $0.33 
Board [8h 8d Qd Qc]
Seat 1: mr.Jckpot folded before Flop (didn't bet)
Seat 2: michasia (button) folded on the Turn
Seat 3: Iospirate (small blind) collected ($6.27)
Seat 4: Trojanovich (big blind) folded before Flop
Seat 5: henri789 folded before Flop (didn't bet)
Seat 6: xcinaz folded before Flop (didn't bet)



PokerStars Hand #254507473527:  Hold'em No Limit ($0.50/$1.00 USD) - 2025/01/22 22:56:39 WET [2025/01/22 17:56:39 ET]
Table 'Ajax III' 6-max Seat #3 is the button
Seat 1: mr.Jckpot ($181.89 in chips) 
Seat 2: michasia ($102.51 in chips) 
Seat 3: Iospirate ($87.35 in chips) 
Seat 4: Trojanovich ($177.58 in chips) 
Seat 5: henri789 ($249.99 in chips) 
Seat 6: xcinaz ($105.21 in chips) 
Trojanovich: posts small blind $0.50
henri789: posts big blind $1
*** HOLE CARDS ***
xcinaz: folds 
mr.Jckpot: folds 
michasia: folds 
Iospirate: folds 
Trojanovich: folds 
Uncalled bet ($0.50) returned to henri789
henri789 collected $1 from pot
henri789: doesn't show hand 
*** SUMMARY ***
Total pot $1 | Rake $0 
Seat 1: mr.Jckpot folded before Flop (didn't bet)
Seat 2: michasia folded before Flop (didn't bet)
Seat 3: Iospirate (button) folded before Flop (didn't bet)
Seat 4: Trojanovich (small blind) folded before Flop
Seat 5: henri789 (big blind) collected ($1)
Seat 6: xcinaz folded before Flop (didn't bet)



PokerStars Hand #254507477236:  Hold'em No Limit ($0.50/$1.00 USD) - 2025/01/22 22:56:57 WET [2025/01/22 17:56:57 ET]
Table 'Ajax III' 6-max Seat #4 is the button
Seat 1: mr.Jckpot ($181.89 in chips) 
Seat 2: michasia ($102.51 in chips) 
Seat 3: Iospirate ($87.35 in chips) 
Seat 4: Trojanovich ($177.08 in chips) 
Seat 5: henri789 ($250.49 in chips) 
Seat 6: xcinaz ($105.21 in chips) 
henri789: posts small blind $0.50
xcinaz: posts big blind $1
*** HOLE CARDS ***
mr.Jckpot: folds 
michasia: raises $1.60 to $2.60
Iospirate: calls $2.60
Trojanovich: folds 
henri789: folds 
xcinaz: folds 
*** FLOP *** [4c 5c Qs]
michasia: checks 
Iospirate: checks 
*** TURN *** [4c 5c Qs] [7d]
michasia: checks 
Iospirate: bets $2
michasia: folds 
Uncalled bet ($2) returned to Iospirate
Iospirate collected $6.36 from pot
Iospirate: doesn't show hand 
*** SUMMARY ***
Total pot $6.70 | Rake $0.34 
Board [4c 5c Qs 7d]
Seat 1: mr.Jckpot folded before Flop (didn't bet)
Seat 2: michasia folded on the Turn
Seat 3: Iospirate collected ($6.36)
Seat 4: Trojanovich (button) folded before Flop (didn't bet)
Seat 5: henri789 (small blind) folded before Flop
Seat 6: xcinaz (big blind) folded before Flop



PokerStars Hand #254507486494:  Hold'em No Limit ($0.50/$1.00 USD) - 2025/01/22 22:57:43 WET [2025/01/22 17:57:43 ET]
Table 'Ajax III' 6-max Seat #5 is the button
Seat 2: michasia ($100 in chips) is sitting out
Seat 1: mr.Jckpot ($181.89 in chips) 
Seat 3: Iospirate ($91.11 in chips) 
Seat 4: Trojanovich ($177.08 in chips) 
Seat 5: henri789 ($249.99 in chips) 
Seat 6: xcinaz ($104.21 in chips) 
xcinaz: posts small blind $0.50
mr.Jckpot: posts big blind $1
*** HOLE CARDS ***
Iospirate: folds 
Trojanovich: folds 
henri789: folds 
xcinaz: raises $2 to $3
mr.Jckpot: calls $2
*** FLOP *** [5d Kc 5s]
xcinaz: bets $1.88
mr.Jckpot: calls $1.88
*** TURN *** [5d Kc 5s] [5h]
xcinaz: checks 
mr.Jckpot: checks 
*** RIVER *** [5d Kc 5s 5h] [4d]
xcinaz: checks 
mr.Jckpot: bets $6.12
xcinaz: folds 
Uncalled bet ($6.12) returned to mr.Jckpot
mr.Jckpot collected $9.27 from pot
mr.Jckpot: doesn't show hand 
*** SUMMARY ***
Total pot $9.76 | Rake $0.49 
Board [5d Kc 5s 5h 4d]
Seat 2: michasia
Seat 1: mr.Jckpot (big blind) collected ($9.27)
Seat 3: Iospirate folded before Flop (didn't bet)
Seat 4: Trojanovich folded before Flop (didn't bet)
Seat 5: henri789 (button) folded before Flop (didn't bet)
Seat 6: xcinaz (small blind) folded on the River



PokerStars Hand #254507499591:  Hold'em No Limit ($0.50/$1.00 USD) - 2025/01/22 22:58:49 WET [2025/01/22 17:58:49 ET]
Table 'Ajax III' 6-max Seat #6 is the button
Seat 2: michasia ($100 in chips) is sitting out
Seat 1: mr.Jckpot ($186.28 in chips) 
Seat 3: Iospirate ($91.11 in chips) 
Seat 4: Trojanovich ($177.08 in chips) 
Seat 5: henri789 ($249.99 in chips) 
Seat 6: xcinaz ($100 in chips) 
mr.Jckpot: posts small blind $0.50
Iospirate: posts big blind $1
*** HOLE CARDS ***
Trojanovich: folds 
henri789: raises $1.20 to $2.20
xcinaz: folds 
mr.Jckpot: raises $9.80 to $12
Iospirate: folds 
henri789: raises $20.50 to $32.50
mr.Jckpot: calls $20.50
*** FLOP *** [7h 4h 3d]
mr.Jckpot: checks 
henri789: bets $25.50
mr.Jckpot: calls $25.50
*** TURN *** [7h 4h 3d] [Jh]
mr.Jckpot: checks 
henri789: bets $37
mr.Jckpot: folds 
Uncalled bet ($37) returned to henri789
henri789 collected $114.50 from pot
henri789: doesn't show hand 
*** SUMMARY ***
Total pot $117 | Rake $2.50 
Board [7h 4h 3d Jh]
Seat 2: michasia
Seat 1: mr.Jckpot (small blind) folded on the Turn
Seat 3: Iospirate (big blind) folded before Flop
Seat 4: Trojanovich folded before Flop (didn't bet)
Seat 5: henri789 collected ($114.50)
Seat 6: xcinaz (button) folded before Flop (didn't bet)



PokerStars Hand #254507527454:  Hold'em No Limit ($0.50/$1.00 USD) - 2025/01/22 23:01:04 WET [2025/01/22 18:01:04 ET]
Table 'Ajax III' 6-max Seat #1 is the button
Seat 2: michasia ($100 in chips) is sitting out
Seat 1: mr.Jckpot ($128.28 in chips) 
Seat 3: Iospirate ($90.11 in chips) 
Seat 4: Trojanovich ($177.08 in chips) 
Seat 5: henri789 ($306.49 in chips) 
Seat 6: xcinaz ($100 in chips) 
Iospirate: posts small blind $0.50
Trojanovich: posts big blind $1
*** HOLE CARDS ***
henri789: folds 
henri789 leaves the table
xcinaz: folds 
mr.Jckpot: folds 
Iospirate: calls $0.50
Trojanovich: checks 
*** FLOP *** [7s Ac 4s]
Iospirate: checks 
Trojanovich: checks 
*** TURN *** [7s Ac 4s] [Qh]
Iospirate: checks 
mr.Jckpot leaves the table
Trojanovich: checks 
*** RIVER *** [7s Ac 4s Qh] [4h]
Iospirate: bets $3
Trojanovich: folds 
Uncalled bet ($3) returned to Iospirate
Iospirate collected $1.90 from pot
Iospirate: doesn't show hand 
*** SUMMARY ***
Total pot $2 | Rake $0.10 
Board [7s Ac 4s Qh 4h]
Seat 2: michasia
Seat 1: mr.Jckpot (button) folded before Flop (didn't bet)
Seat 3: Iospirate (small blind) collected ($1.90)
Seat 4: Trojanovich (big blind) folded on the River
Seat 5: henri789 folded before Flop (didn't bet)
Seat 6: xcinaz folded before Flop (didn't bet)



PokerStars Hand #254507538177:  Hold'em No Limit ($0.50/$1.00 USD) - 2025/01/22 23:01:49 WET [2025/01/22 18:01:49 ET]
Table 'Ajax III' 6-max Seat #3 is the button
Seat 2: michasia ($100 in chips) is sitting out
Seat 3: Iospirate ($91.01 in chips) 
Seat 4: Trojanovich ($176.08 in chips) 
Seat 6: xcinaz ($100 in chips) 
Trojanovich: posts small blind $0.50
xcinaz: posts big blind $1
michasia: sits out 
*** HOLE CARDS ***
Iospirate: calls $1
Trojanovich: folds 
xcinaz: checks 
*** FLOP *** [2s 6s 8d]
xcinaz: checks 
Iospirate: checks 
*** TURN *** [2s 6s 8d] [3h]
xcinaz: bets $1
Iospirate: calls $1
*** RIVER *** [2s 6s 8d 3h] [Ad]
xcinaz: checks 
Iospirate: bets $3
xcinaz: folds 
Uncalled bet ($3) returned to Iospirate
Iospirate collected $4.28 from pot
Iospirate: doesn't show hand 
*** SUMMARY ***
Total pot $4.50 | Rake $0.22 
Board [2s 6s 8d 3h Ad]
Seat 2: michasia
Seat 3: Iospirate (button) collected ($4.28)
Seat 4: Trojanovich (small blind) folded before Flop
Seat 6: xcinaz (big blind) folded on the River



PokerStars Hand #254507548666:  Hold'em No Limit ($0.50/$1.00 USD) - 2025/01/22 23:02:32 WET [2025/01/22 18:02:32 ET]
Table 'Ajax III' 6-max Seat #4 is the button
Seat 2: michasia ($100 in chips) 
Seat 3: Iospirate ($93.29 in chips) 
Seat 4: Trojanovich ($175.58 in chips) 
Seat 6: xcinaz ($100 in chips) 
xcinaz: posts small blind $0.50
michasia: posts big blind $1
*** HOLE CARDS ***
Iospirate: calls $1
Trojanovich: raises $2.50 to $3.50
xcinaz: folds 
michasia: folds 
Iospirate: calls $2.50
*** FLOP *** [7d As Ah]
Iospirate: checks 
Trojanovich: bets $2.02
Iospirate: calls $2.02
*** TURN *** [7d As Ah] [8d]
Iospirate: checks 
Trojanovich: bets $11.90
Iospirate: folds 
Uncalled bet ($11.90) returned to Trojanovich
Trojanovich collected $11.91 from pot
Trojanovich: doesn't show hand 
*** SUMMARY ***
Total pot $12.54 | Rake $0.63 
Board [7d As Ah 8d]
Seat 2: michasia (big blind) folded before Flop
Seat 3: Iospirate folded on the Turn
Seat 4: Trojanovich (button) collected ($11.91)
Seat 6: xcinaz (small blind) folded before Flop



PokerStars Hand #254507563950:  Hold'em No Limit ($0.50/$1.00 USD) - 2025/01/22 23:03:32 WET [2025/01/22 18:03:32 ET]
Table 'Ajax III' 6-max Seat #6 is the button
Seat 2: michasia ($100 in chips) 
Seat 3: Iospirate ($87.77 in chips) 
Seat 4: Trojanovich ($181.97 in chips) 
Seat 6: xcinaz ($100 in chips) 
michasia: posts small blind $0.50
Iospirate: posts big blind $1
*** HOLE CARDS ***
Trojanovich: folds 
xcinaz: folds 
michasia: folds 
Uncalled bet ($0.50) returned to Iospirate
Iospirate collected $1 from pot
Iospirate: doesn't show hand 
*** SUMMARY ***
Total pot $1 | Rake $0 
Seat 2: michasia (small blind) folded before Flop
Seat 3: Iospirate (big blind) collected ($1)
Seat 4: Trojanovich folded before Flop (didn't bet)
Seat 6: xcinaz (button) folded before Flop (didn't bet)



PokerStars Hand #254507567815:  Hold'em No Limit ($0.50/$1.00 USD) - 2025/01/22 23:03:48 WET [2025/01/22 18:03:48 ET]
Table 'Ajax III' 6-max Seat #2 is the button
Seat 2: michasia ($100 in chips) 
Seat 3: Iospirate ($88.27 in chips) 
Seat 4: Trojanovich ($181.97 in chips) 
Seat 6: xcinaz ($100 in chips) 
Iospirate: posts small blind $0.50
Trojanovich: posts big blind $1
*** HOLE CARDS ***
xcinaz: folds 
michasia: folds 
Iospirate: folds 
Uncalled bet ($0.50) returned to Trojanovich
Trojanovich collected $1 from pot
Trojanovich: doesn't show hand 
*** SUMMARY ***
Total pot $1 | Rake $0 
Seat 2: michasia (button) folded before Flop (didn't bet)
Seat 3: Iospirate (small blind) folded before Flop
Seat 4: Trojanovich (big blind) collected ($1)
Seat 6: xcinaz folded before Flop (didn't bet)



PokerStars Hand #254507572723:  Hold'em No Limit ($0.50/$1.00 USD) - 2025/01/22 23:04:07 WET [2025/01/22 18:04:07 ET]
Table 'Ajax III' 6-max Seat #3 is the button
Seat 2: michasia ($100 in chips) 
Seat 3: Iospirate ($87.77 in chips) 
Seat 4: Trojanovich ($182.47 in chips) 
Seat 6: xcinaz ($100 in chips) 
Trojanovich: posts small blind $0.50
xcinaz: posts big blind $1
*** HOLE CARDS ***
michasia: folds 
Iospirate: folds 
Trojanovich: folds 
Uncalled bet ($0.50) returned to xcinaz
xcinaz collected $1 from pot
xcinaz: doesn't show hand 
*** SUMMARY ***
Total pot $1 | Rake $0 
Seat 2: michasia folded before Flop (didn't bet)
Seat 3: Iospirate (button) folded before Flop (didn't bet)
Seat 4: Trojanovich (small blind) folded before Flop
Seat 6: xcinaz (big blind) collected ($1)



PokerStars Hand #254507574859:  Hold'em No Limit ($0.50/$1.00 USD) - 2025/01/22 23:04:15 WET [2025/01/22 18:04:15 ET]
Table 'Ajax III' 6-max Seat #4 is the button
Seat 2: michasia ($100 in chips) 
Seat 3: Iospirate ($87.77 in chips) 
Seat 4: Trojanovich ($181.97 in chips) 
Seat 6: xcinaz ($100.50 in chips) 
xcinaz: posts small blind $0.50
michasia: posts big blind $1
*** HOLE CARDS ***
Iospirate: folds 
Trojanovich: folds 
xcinaz: folds 
Uncalled bet ($0.50) returned to michasia
michasia collected $1 from pot
michasia: doesn't show hand 
*** SUMMARY ***
Total pot $1 | Rake $0 
Seat 2: michasia (big blind) collected ($1)
Seat 3: Iospirate folded before Flop (didn't bet)
Seat 4: Trojanovich (button) folded before Flop (didn't bet)
Seat 6: xcinaz (small blind) folded before Flop



PokerStars Hand #254507578067:  Hold'em No Limit ($0.50/$1.00 USD) - 2025/01/22 23:04:28 WET [2025/01/22 18:04:28 ET]
Table 'Ajax III' 6-max Seat #6 is the button
Seat 2: michasia ($100.50 in chips) 
Seat 3: Iospirate ($87.77 in chips) 
Seat 4: Trojanovich ($181.97 in chips) 
Seat 6: xcinaz ($100 in chips) 
michasia: posts small blind $0.50
Iospirate: posts big blind $1
*** HOLE CARDS ***
Trojanovich: folds 
xcinaz: raises $1.50 to $2.50
michasia: folds 
Iospirate: folds 
Uncalled bet ($1.50) returned to xcinaz
xcinaz collected $2.50 from pot
xcinaz: doesn't show hand 
*** SUMMARY ***
Total pot $2.50 | Rake $0 
Seat 2: michasia (small blind) folded before Flop
Seat 3: Iospirate (big blind) folded before Flop
Seat 4: Trojanovich folded before Flop (didn't bet)
Seat 6: xcinaz (button) collected ($2.50)



PokerStars Hand #254507580049:  Hold'em No Limit ($0.50/$1.00 USD) - 2025/01/22 23:04:36 WET [2025/01/22 18:04:36 ET]
Table 'Ajax III' 6-max Seat #2 is the button
Seat 2: michasia ($100 in chips) 
Seat 3: Iospirate ($86.77 in chips) 
Seat 4: Trojanovich ($181.97 in chips) 
Seat 6: xcinaz ($101.50 in chips) 
Iospirate: posts small blind $0.50
Trojanovich: posts big blind $1
*** HOLE CARDS ***
xcinaz: folds 
michasia: folds 
Iospirate: raises $1 to $2
Trojanovich: calls $1
*** FLOP *** [9h 3s 4s]
Iospirate: checks 
Trojanovich: checks 
*** TURN *** [9h 3s 4s] [Kc]
1druizc1 joins the table at seat #5 
Iospirate: bets $3
Espada Fish joins the table at seat #1 
Trojanovich: folds 
Uncalled bet ($3) returned to Iospirate
Iospirate collected $3.80 from pot
Iospirate: doesn't show hand 
*** SUMMARY ***
Total pot $4 | Rake $0.20 
Board [9h 3s 4s Kc]
Seat 2: michasia (button) folded before Flop (didn't bet)
Seat 3: Iospirate (small blind) collected ($3.80)
Seat 4: Trojanovich (big blind) folded on the Turn
Seat 6: xcinaz folded before Flop (didn't bet)



PokerStars Hand #254507589015:  Hold'em No Limit ($0.50/$1.00 USD) - 2025/01/22 23:05:11 WET [2025/01/22 18:05:11 ET]
Table 'Ajax III' 6-max Seat #3 is the button
Seat 1: Espada Fish ($100 in chips) is sitting out
Seat 2: michasia ($100 in chips) 
Seat 3: Iospirate ($88.57 in chips) 
Seat 4: Trojanovich ($179.97 in chips) 
Seat 5: 1druizc1 ($100 in chips) 
Seat 6: xcinaz ($101.50 in chips) 
Trojanovich: posts small blind $0.50
1druizc1: posts big blind $1
Espada Fish: sits out 
*** HOLE CARDS ***
xcinaz: folds 
michasia: raises $1.80 to $2.80
Iospirate: folds 
Trojanovich: folds 
1druizc1: folds 
Uncalled bet ($1.80) returned to michasia
michasia collected $2.50 from pot
michasia: doesn't show hand 
*** SUMMARY ***
Total pot $2.50 | Rake $0 
Seat 1: Espada Fish
Seat 2: michasia collected ($2.50)
Seat 3: Iospirate (button) folded before Flop (didn't bet)
Seat 4: Trojanovich (small blind) folded before Flop
Seat 5: 1druizc1 (big blind) folded before Flop
Seat 6: xcinaz folded before Flop (didn't bet)



PokerStars Hand #254507592521:  Hold'em No Limit ($0.50/$1.00 USD) - 2025/01/22 23:05:25 WET [2025/01/22 18:05:25 ET]
Table 'Ajax III' 6-max Seat #4 is the button
Seat 1: Espada Fish ($100 in chips) is sitting out
Seat 2: michasia ($101.50 in chips) 
Seat 3: Iospirate ($88.57 in chips) 
Seat 4: Trojanovich ($179.47 in chips) 
Seat 5: 1druizc1 ($99 in chips) 
Seat 6: xcinaz ($101.50 in chips) 
1druizc1: posts small blind $0.50
xcinaz: posts big blind $1
Espada Fish: sits out 
*** HOLE CARDS ***
michasia: folds 
Iospirate: calls $1
Trojanovich: folds 
1druizc1: folds 
xcinaz: checks 
*** FLOP *** [Ad 4d As]
xcinaz: checks 
Iospirate: checks 
*** TURN *** [Ad 4d As] [Js]
xcinaz: bets $1
Iospirate: folds 
Uncalled bet ($1) returned to xcinaz
xcinaz collected $2.38 from pot
xcinaz: doesn't show hand 
*** SUMMARY ***
Total pot $2.50 | Rake $0.12 
Board [Ad 4d As Js]
Seat 1: Espada Fish
Seat 2: michasia folded before Flop (didn't bet)
Seat 3: Iospirate folded on the Turn
Seat 4: Trojanovich (button) folded before Flop (didn't bet)
Seat 5: 1druizc1 (small blind) folded before Flop
Seat 6: xcinaz (big blind) collected ($2.38)



PokerStars Hand #254507600291:  Hold'em No Limit ($0.50/$1.00 USD) - 2025/01/22 23:05:55 WET [2025/01/22 18:05:55 ET]
Table 'Ajax III' 6-max Seat #5 is the button
Seat 1: Espada Fish ($100 in chips) 
Seat 2: michasia ($101.50 in chips) 
Seat 3: Iospirate ($87.57 in chips) 
Seat 4: Trojanovich ($179.47 in chips) 
Seat 5: 1druizc1 ($100 in chips) 
Seat 6: xcinaz ($102.88 in chips) 
xcinaz: posts small blind $0.50
Espada Fish: posts big blind $1
*** HOLE CARDS ***
michasia: folds 
Iospirate: folds 
Trojanovich: folds 
1druizc1: raises $2 to $3
xcinaz: folds 
Espada Fish: folds 
Uncalled bet ($2) returned to 1druizc1
1druizc1 collected $2.50 from pot
1druizc1: doesn't show hand 
*** SUMMARY ***
Total pot $2.50 | Rake $0 
Seat 1: Espada Fish (big blind) folded before Flop
Seat 2: michasia folded before Flop (didn't bet)
Seat 3: Iospirate folded before Flop (didn't bet)
Seat 4: Trojanovich folded before Flop (didn't bet)
Seat 5: 1druizc1 (button) collected ($2.50)
Seat 6: xcinaz (small blind) folded before Flop



PokerStars Hand #254507603700:  Hold'em No Limit ($0.50/$1.00 USD) - 2025/01/22 23:06:08 WET [2025/01/22 18:06:08 ET]
Table 'Ajax III' 6-max Seat #6 is the button
Seat 1: Espada Fish ($100 in chips) 
Seat 2: michasia ($101.50 in chips) 
Seat 3: Iospirate ($87.57 in chips) 
Seat 4: Trojanovich ($179.47 in chips) 
Seat 5: 1druizc1 ($101.50 in chips) 
Seat 6: xcinaz ($102.38 in chips) 
Espada Fish: posts small blind $0.50
michasia: posts big blind $1
*** HOLE CARDS ***
Iospirate: folds 
Trojanovich: raises $1.50 to $2.50
1druizc1: folds 
xcinaz: folds 
Espada Fish: folds 
michasia: folds 
Uncalled bet ($1.50) returned to Trojanovich
Trojanovich collected $2.50 from pot
Trojanovich: doesn't show hand 
*** SUMMARY ***
Total pot $2.50 | Rake $0 
Seat 1: Espada Fish (small blind) folded before Flop
Seat 2: michasia (big blind) folded before Flop
Seat 3: Iospirate folded before Flop (didn't bet)
Seat 4: Trojanovich collected ($2.50)
Seat 5: 1druizc1 folded before Flop (didn't bet)
Seat 6: xcinaz (button) folded before Flop (didn't bet)



PokerStars Hand #254507607156:  Hold'em No Limit ($0.50/$1.00 USD) - 2025/01/22 23:06:22 WET [2025/01/22 18:06:22 ET]
Table 'Ajax III' 6-max Seat #1 is the button
Seat 1: Espada Fish ($100 in chips) 
Seat 2: michasia ($100.50 in chips) 
Seat 3: Iospirate ($87.57 in chips) 
Seat 4: Trojanovich ($180.97 in chips) 
Seat 5: 1druizc1 ($101.50 in chips) 
Seat 6: xcinaz ($102.38 in chips) 
michasia: posts small blind $0.50
Iospirate: posts big blind $1
*** HOLE CARDS ***
Trojanovich: folds 
1druizc1: raises $1.30 to $2.30
xcinaz: folds 
Espada Fish: folds 
michasia: folds 
Iospirate: folds 
Uncalled bet ($1.30) returned to 1druizc1
1druizc1 collected $2.50 from pot
1druizc1: doesn't show hand 
*** SUMMARY ***
Total pot $2.50 | Rake $0 
Seat 1: Espada Fish (button) folded before Flop (didn't bet)
Seat 2: michasia (small blind) folded before Flop
Seat 3: Iospirate (big blind) folded before Flop
Seat 4: Trojanovich folded before Flop (didn't bet)
Seat 5: 1druizc1 collected ($2.50)
Seat 6: xcinaz folded before Flop (didn't bet)



PokerStars Hand #254507610652:  Hold'em No Limit ($0.50/$1.00 USD) - 2025/01/22 23:06:36 WET [2025/01/22 18:06:36 ET]
Table 'Ajax III' 6-max Seat #2 is the button
Seat 1: Espada Fish ($100 in chips) 
Seat 2: michasia ($100 in chips) 
Seat 3: Iospirate ($86.57 in chips) 
Seat 4: Trojanovich ($180.97 in chips) 
Seat 5: 1druizc1 ($103 in chips) 
Seat 6: xcinaz ($102.38 in chips) 
Iospirate: posts small blind $0.50
Trojanovich: posts big blind $1
*** HOLE CARDS ***
1druizc1: folds 
xcinaz: folds 
Espada Fish: folds 
michasia: raises $1.80 to $2.80
Iospirate: calls $2.30
Trojanovich: folds 
*** FLOP *** [9s Tc 4d]
Iospirate: checks 
michasia: bets $2.07
Iospirate: raises $2.07 to $4.14
michasia: calls $2.07
*** TURN *** [9s Tc 4d] [Ac]
Iospirate: checks 
michasia: bets $9.43
Iospirate: raises $33 to $42.43
michasia: folds 
Uncalled bet ($33) returned to Iospirate
Iospirate collected $32.05 from pot
Iospirate: doesn't show hand 
*** SUMMARY ***
Total pot $33.74 | Rake $1.69 
Board [9s Tc 4d Ac]
Seat 1: Espada Fish folded before Flop (didn't bet)
Seat 2: michasia (button) folded on the Turn
Seat 3: Iospirate (small blind) collected ($32.05)
Seat 4: Trojanovich (big blind) folded before Flop
Seat 5: 1druizc1 folded before Flop (didn't bet)
Seat 6: xcinaz folded before Flop (didn't bet)



PokerStars Hand #254507621811:  Hold'em No Limit ($0.50/$1.00 USD) - 2025/01/22 23:07:19 WET [2025/01/22 18:07:19 ET]
Table 'Ajax III' 6-max Seat #3 is the button
Seat 1: Espada Fish ($100 in chips) 
Seat 2: michasia ($100 in chips) 
Seat 3: Iospirate ($102.25 in chips) 
Seat 4: Trojanovich ($179.97 in chips) 
Seat 5: 1druizc1 ($103 in chips) 
Seat 6: xcinaz ($102.38 in chips) 
Trojanovich: posts small blind $0.50
1druizc1: posts big blind $1
*** HOLE CARDS ***
xcinaz: folds 
Espada Fish: folds 
michasia: folds 
Iospirate: folds 
Trojanovich: raises $2 to $3
1druizc1: folds 
Uncalled bet ($2) returned to Trojanovich
Trojanovich collected $2 from pot
Trojanovich: doesn't show hand 
*** SUMMARY ***
Total pot $2 | Rake $0 
Seat 1: Espada Fish folded before Flop (didn't bet)
Seat 2: michasia folded before Flop (didn't bet)
Seat 3: Iospirate (button) folded before Flop (didn't bet)
Seat 4: Trojanovich (small blind) collected ($2)
Seat 5: 1druizc1 (big blind) folded before Flop
Seat 6: xcinaz folded before Flop (didn't bet)



PokerStars Hand #254507626517:  Hold'em No Limit ($0.50/$1.00 USD) - 2025/01/22 23:07:38 WET [2025/01/22 18:07:38 ET]
Table 'Ajax III' 6-max Seat #4 is the button
Seat 1: Espada Fish ($100 in chips) 
Seat 2: michasia ($100 in chips) 
Seat 3: Iospirate ($102.25 in chips) 
Seat 4: Trojanovich ($180.97 in chips) 
Seat 5: 1druizc1 ($102 in chips) 
Seat 6: xcinaz ($102.38 in chips) 
1druizc1: posts small blind $0.50
xcinaz: posts big blind $1
*** HOLE CARDS ***
Espada Fish: folds 
michasia: raises $1.60 to $2.60
Iospirate: folds 
Trojanovich: folds 
1druizc1: folds 
xcinaz: folds 
Uncalled bet ($1.60) returned to michasia
michasia collected $2.50 from pot
michasia: doesn't show hand 
*** SUMMARY ***
Total pot $2.50 | Rake $0 
Seat 1: Espada Fish folded before Flop (didn't bet)
Seat 2: michasia collected ($2.50)
Seat 3: Iospirate folded before Flop (didn't bet)
Seat 4: Trojanovich (button) folded before Flop (didn't bet)
Seat 5: 1druizc1 (small blind) folded before Flop
Seat 6: xcinaz (big blind) folded before Flop



PokerStars Hand #254507630075:  Hold'em No Limit ($0.50/$1.00 USD) - 2025/01/22 23:07:52 WET [2025/01/22 18:07:52 ET]
Table 'Ajax III' 6-max Seat #5 is the button
Seat 1: Espada Fish ($100 in chips) 
Seat 2: michasia ($101.50 in chips) 
Seat 3: Iospirate ($102.25 in chips) 
Seat 4: Trojanovich ($180.97 in chips) 
Seat 5: 1druizc1 ($101.50 in chips) 
Seat 6: xcinaz ($101.38 in chips) 
xcinaz: posts small blind $0.50
Espada Fish: posts big blind $1
*** HOLE CARDS ***
michasia: folds 
Iospirate: calls $1
Trojanovich: raises $3 to $4
1druizc1: folds 
xcinaz: folds 
Espada Fish: folds 
Iospirate: calls $3
*** FLOP *** [9d Ts Kc]
Iospirate: checks 
Trojanovich: bets $2.98
Iospirate: folds 
Uncalled bet ($2.98) returned to Trojanovich
Trojanovich collected $9.02 from pot
Trojanovich: doesn't show hand 
*** SUMMARY ***
Total pot $9.50 | Rake $0.48 
Board [9d Ts Kc]
Seat 1: Espada Fish (big blind) folded before Flop
Seat 2: michasia folded before Flop (didn't bet)
Seat 3: Iospirate folded on the Flop
Seat 4: Trojanovich collected ($9.02)
Seat 5: 1druizc1 (button) folded before Flop (didn't bet)
Seat 6: xcinaz (small blind) folded before Flop



PokerStars Hand #254507636414:  Hold'em No Limit ($0.50/$1.00 USD) - 2025/01/22 23:08:16 WET [2025/01/22 18:08:16 ET]
Table 'Ajax III' 6-max Seat #6 is the button
Seat 1: Espada Fish ($100 in chips) 
Seat 2: michasia ($101.50 in chips) 
Seat 3: Iospirate ($98.25 in chips) 
Seat 4: Trojanovich ($185.99 in chips) 
Seat 5: 1druizc1 ($101.50 in chips) 
Seat 6: xcinaz ($100.88 in chips) 
Espada Fish: posts small blind $0.50
michasia: posts big blind $1
*** HOLE CARDS ***
Iospirate: folds 
Trojanovich: folds 
1druizc1: folds 
xcinaz: raises $1.50 to $2.50
Espada Fish: folds 
michasia: folds 
Uncalled bet ($1.50) returned to xcinaz
xcinaz collected $2.50 from pot
xcinaz: doesn't show hand 
*** SUMMARY ***
Total pot $2.50 | Rake $0 
Seat 1: Espada Fish (small blind) folded before Flop
Seat 2: michasia (big blind) folded before Flop
Seat 3: Iospirate folded before Flop (didn't bet)
Seat 4: Trojanovich folded before Flop (didn't bet)
Seat 5: 1druizc1 folded before Flop (didn't bet)
Seat 6: xcinaz (button) collected ($2.50)



PokerStars Hand #254507640699:  Hold'em No Limit ($0.50/$1.00 USD) - 2025/01/22 23:08:33 WET [2025/01/22 18:08:33 ET]
Table 'Ajax III' 6-max Seat #1 is the button
Seat 1: Espada Fish ($100 in chips) 
Seat 2: michasia ($100.50 in chips) 
Seat 3: Iospirate ($98.25 in chips) 
Seat 4: Trojanovich ($185.99 in chips) 
Seat 5: 1druizc1 ($101.50 in chips) 
Seat 6: xcinaz ($102.38 in chips) 
michasia: posts small blind $0.50
Iospirate: posts big blind $1
*** HOLE CARDS ***
Trojanovich: raises $1.50 to $2.50
1druizc1: folds 
xcinaz: folds 
Espada Fish: folds 
michasia: folds 
Iospirate: calls $1.50
*** FLOP *** [Qc 6c Td]
Iospirate: checks 
Trojanovich: bets $1.72
Iospirate: calls $1.72
*** TURN *** [Qc 6c Td] [9c]
Iospirate: bets $3
Trojanovich: calls $3
*** RIVER *** [Qc 6c Td 9c] [8h]
Iospirate: bets $14.19
Trojanovich: raises $164.58 to $178.77 and is all-in
Iospirate: calls $76.84 and is all-in
Uncalled bet ($87.74) returned to Trojanovich
*** SHOW DOWN ***
Trojanovich: shows [Kh Jc] (a straight, Nine to King)
Iospirate: shows [3c 5c] (a flush, Queen high)
Iospirate collected $194.50 from pot
*** SUMMARY ***
Total pot $197 | Rake $2.50 
Board [Qc 6c Td 9c 8h]
Seat 1: Espada Fish (button) folded before Flop (didn't bet)
Seat 2: michasia (small blind) folded before Flop
Seat 3: Iospirate (big blind) showed [3c 5c] and won ($194.50) with a flush, Queen high
Seat 4: Trojanovich showed [Kh Jc] and lost with a straight, Nine to King
Seat 5: 1druizc1 folded before Flop (didn't bet)
Seat 6: xcinaz folded before Flop (didn't bet)



PokerStars Hand #254507662930:  Hold'em No Limit ($0.50/$1.00 USD) - 2025/01/22 23:10:00 WET [2025/01/22 18:10:00 ET]
Table 'Ajax III' 6-max Seat #2 is the button
Seat 1: Espada Fish ($100 in chips) 
Seat 2: michasia ($100 in chips) 
Seat 3: Iospirate ($194.50 in chips) 
Seat 4: Trojanovich ($100 in chips) 
Seat 5: 1druizc1 ($101.50 in chips) 
Seat 6: xcinaz ($102.38 in chips) 
Iospirate: posts small blind $0.50
Trojanovich: posts big blind $1
*** HOLE CARDS ***
1druizc1: folds 
xcinaz: folds 
Espada Fish: raises $1.20 to $2.20
michasia: folds 
Iospirate: folds 
Trojanovich: raises $8.80 to $11
Espada Fish: folds 
Uncalled bet ($8.80) returned to Trojanovich
Trojanovich collected $4.90 from pot
Trojanovich: doesn't show hand 
*** SUMMARY ***
Total pot $4.90 | Rake $0 
Seat 1: Espada Fish folded before Flop
Seat 2: michasia (button) folded before Flop (didn't bet)
Seat 3: Iospirate (small blind) folded before Flop
Seat 4: Trojanovich (big blind) collected ($4.90)
Seat 5: 1druizc1 folded before Flop (didn't bet)
Seat 6: xcinaz folded before Flop (didn't bet)



PokerStars Hand #254507671902:  Hold'em No Limit ($0.50/$1.00 USD) - 2025/01/22 23:10:36 WET [2025/01/22 18:10:36 ET]
Table 'Ajax III' 6-max Seat #3 is the button
Seat 1: Espada Fish ($100 in chips) 
Seat 2: michasia ($100 in chips) 
Seat 3: Iospirate ($194 in chips) 
Seat 4: Trojanovich ($102.70 in chips) 
Seat 5: 1druizc1 ($101.50 in chips) 
Seat 6: xcinaz ($102.38 in chips) 
Trojanovich: posts small blind $0.50
1druizc1: posts big blind $1
*** HOLE CARDS ***
xcinaz: folds 
Espada Fish: folds 
michasia: folds 
Iospirate: folds 
Trojanovich: raises $2 to $3
1druizc1: folds 
Uncalled bet ($2) returned to Trojanovich
Trojanovich collected $2 from pot
Trojanovich: doesn't show hand 
*** SUMMARY ***
Total pot $2 | Rake $0 
Seat 1: Espada Fish folded before Flop (didn't bet)
Seat 2: michasia folded before Flop (didn't bet)
Seat 3: Iospirate (button) folded before Flop (didn't bet)
Seat 4: Trojanovich (small blind) collected ($2)
Seat 5: 1druizc1 (big blind) folded before Flop
Seat 6: xcinaz folded before Flop (didn't bet)



PokerStars Hand #254507676749:  Hold'em No Limit ($0.50/$1.00 USD) - 2025/01/22 23:10:55 WET [2025/01/22 18:10:55 ET]
Table 'Ajax III' 6-max Seat #4 is the button
Seat 1: Espada Fish ($100 in chips) 
Seat 2: michasia ($100 in chips) 
Seat 3: Iospirate ($194 in chips) 
Seat 4: Trojanovich ($103.70 in chips) 
Seat 5: 1druizc1 ($100.50 in chips) 
Seat 6: xcinaz ($102.38 in chips) 
1druizc1: posts small blind $0.50
xcinaz: posts big blind $1
*** HOLE CARDS ***
Espada Fish: raises $1.20 to $2.20
michasia: folds 
Iospirate: folds 
Trojanovich: raises $4.80 to $7
1druizc1: folds 
xcinaz: folds 
Espada Fish: raises $13 to $20
Trojanovich: calls $13
*** FLOP *** [7s 7d 4s]
Espada Fish: bets $11
Trojanovich: calls $11
*** TURN *** [7s 7d 4s] [9d]
Espada Fish: checks 
Trojanovich: bets $20.13
Espada Fish: folds 
Uncalled bet ($20.13) returned to Trojanovich
Trojanovich collected $61 from pot
Trojanovich: doesn't show hand 
*** SUMMARY ***
Total pot $63.50 | Rake $2.50 
Board [7s 7d 4s 9d]
Seat 1: Espada Fish folded on the Turn
Seat 2: michasia folded before Flop (didn't bet)
Seat 3: Iospirate folded before Flop (didn't bet)
Seat 4: Trojanovich (button) collected ($61)
Seat 5: 1druizc1 (small blind) folded before Flop
Seat 6: xcinaz (big blind) folded before Flop



PokerStars Hand #254507703686:  Hold'em No Limit ($0.50/$1.00 USD) - 2025/01/22 23:12:41 WET [2025/01/22 18:12:41 ET]
Table 'Ajax III' 6-max Seat #5 is the button
Seat 1: Espada Fish ($100 in chips) is sitting out
Seat 2: michasia ($100 in chips) 
Seat 3: Iospirate ($194 in chips) 
Seat 4: Trojanovich ($133.70 in chips) 
Seat 5: 1druizc1 ($100 in chips) 
Seat 6: xcinaz ($101.38 in chips) 
xcinaz: posts small blind $0.50
Espada Fish: is sitting out 
michasia: posts big blind $1
*** HOLE CARDS ***
Iospirate: folds 
Trojanovich: folds 
1druizc1: folds 
xcinaz: folds 
Uncalled bet ($0.50) returned to michasia
michasia collected $1 from pot
michasia: doesn't show hand 
*** SUMMARY ***
Total pot $1 | Rake $0 
Seat 1: Espada Fish
Seat 2: michasia (big blind) collected ($1)
Seat 3: Iospirate folded before Flop (didn't bet)
Seat 4: Trojanovich folded before Flop (didn't bet)
Seat 5: 1druizc1 (button) folded before Flop (didn't bet)
Seat 6: xcinaz (small blind) folded before Flop



PokerStars Hand #254507706671:  Hold'em No Limit ($0.50/$1.00 USD) - 2025/01/22 23:12:53 WET [2025/01/22 18:12:53 ET]
Table 'Ajax III' 6-max Seat #6 is the button
Seat 1: Espada Fish ($100 in chips) is sitting out
Seat 2: michasia ($100.50 in chips) 
Seat 3: Iospirate ($194 in chips) 
Seat 4: Trojanovich ($133.70 in chips) 
Seat 5: 1druizc1 ($100 in chips) 
Seat 6: xcinaz ($100.88 in chips) 
michasia: posts small blind $0.50
Iospirate: posts big blind $1
*** HOLE CARDS ***
Trojanovich: raises $1.50 to $2.50
Espada Fish leaves the table
1druizc1: folds 
xcinaz: raises $5.50 to $8
michasia: folds 
Iospirate: calls $7
Trojanovich: calls $5.50
*** FLOP *** [2s Kh Qd]
Iospirate: checks 
Trojanovich: checks 
xcinaz: bets $5.82
Iospirate: folds 
Trojanovich: folds 
Uncalled bet ($5.82) returned to xcinaz
xcinaz collected $23.28 from pot
xcinaz: doesn't show hand 
*** SUMMARY ***
Total pot $24.50 | Rake $1.22 
Board [2s Kh Qd]
Seat 1: Espada Fish
Seat 2: michasia (small blind) folded before Flop
Seat 3: Iospirate (big blind) folded on the Flop
Seat 4: Trojanovich folded on the Flop
Seat 5: 1druizc1 folded before Flop (didn't bet)
Seat 6: xcinaz (button) collected ($23.28)



PokerStars Hand #254507913013:  Hold'em No Limit ($0.50/$1.00 USD) - 2025/01/22 23:26:46 WET [2025/01/22 18:26:46 ET]
Table 'Ajax III' 6-max Seat #6 is the button
Seat 2: michasia ($172.98 in chips) 
Seat 3: Iospirate ($178.50 in chips) 
Seat 4: Sheva9191 ($122.15 in chips) 
Seat 5: Dante21b ($99.50 in chips) 
Seat 6: xcinaz ($105.79 in chips) 
michasia: posts small blind $0.50
Iospirate: posts big blind $1
*** HOLE CARDS ***
Sheva9191: raises $1.25 to $2.25
Dante21b: folds 
xcinaz: folds 
michasia: folds 
Iospirate: folds 
Uncalled bet ($1.25) returned to Sheva9191
Sheva9191 collected $2.50 from pot
Sheva9191: doesn't show hand 
*** SUMMARY ***
Total pot $2.50 | Rake $0 
Seat 2: michasia (small blind) folded before Flop
Seat 3: Iospirate (big blind) folded before Flop
Seat 4: Sheva9191 collected ($2.50)
Seat 5: Dante21b folded before Flop (didn't bet)
Seat 6: xcinaz (button) folded before Flop (didn't bet)



PokerStars Hand #254507920006:  Hold'em No Limit ($0.50/$1.00 USD) - 2025/01/22 23:27:13 WET [2025/01/22 18:27:13 ET]
Table 'Ajax III' 6-max Seat #2 is the button
Seat 2: michasia ($172.48 in chips) 
Seat 3: Iospirate ($177.50 in chips) 
Seat 4: Sheva9191 ($123.65 in chips) 
Seat 5: Dante21b ($99.50 in chips) 
Seat 6: xcinaz ($105.79 in chips) 
Iospirate: posts small blind $0.50
Sheva9191: posts big blind $1
*** HOLE CARDS ***
Dante21b: folds 
xcinaz: folds 
michasia: raises $1.80 to $2.80
Iospirate: folds 
Sheva9191: calls $1.80
*** FLOP *** [2s Ts 5d]
Sheva9191: checks 
michasia: checks 
*** TURN *** [2s Ts 5d] [Kc]
Sheva9191: checks 
michasia: checks 
*** RIVER *** [2s Ts 5d Kc] [Ah]
Sheva9191: bets $2.90
michasia: folds 
Uncalled bet ($2.90) returned to Sheva9191
Sheva9191 collected $5.80 from pot
Sheva9191: doesn't show hand 
*** SUMMARY ***
Total pot $6.10 | Rake $0.30 
Board [2s Ts 5d Kc Ah]
Seat 2: michasia (button) folded on the River
Seat 3: Iospirate (small blind) folded before Flop
Seat 4: Sheva9191 (big blind) collected ($5.80)
Seat 5: Dante21b folded before Flop (didn't bet)
Seat 6: xcinaz folded before Flop (didn't bet)



PokerStars Hand #254508007150:  Hold'em No Limit ($0.50/$1.00 USD) - 2025/01/22 23:33:06 WET [2025/01/22 18:33:06 ET]
Table 'Ajax III' 6-max Seat #5 is the button
Seat 6: xcinaz ($103.79 in chips) is sitting out
Seat 1: Cositorto ($100 in chips) 
Seat 2: michasia ($168.18 in chips) 
Seat 3: Iospirate ($183.86 in chips) 
Seat 4: Sheva9191 ($123.15 in chips) 
Seat 5: Dante21b ($103.39 in chips) 
Cositorto: posts small blind $0.50
michasia: posts big blind $1
*** HOLE CARDS ***
Iospirate: folds 
Sheva9191: folds 
Dante21b: raises $1.50 to $2.50
Cositorto: folds 
michasia: raises $9.50 to $12
Dante21b: folds 
Uncalled bet ($9.50) returned to michasia
michasia collected $5.50 from pot
michasia: doesn't show hand 
*** SUMMARY ***
Total pot $5.50 | Rake $0 
Seat 6: xcinaz
Seat 1: Cositorto (small blind) folded before Flop
Seat 2: michasia (big blind) collected ($5.50)
Seat 3: Iospirate folded before Flop (didn't bet)
Seat 4: Sheva9191 folded before Flop (didn't bet)
Seat 5: Dante21b (button) folded before Flop



PokerStars Hand #254508011815:  Hold'em No Limit ($0.50/$1.00 USD) - 2025/01/22 23:33:25 WET [2025/01/22 18:33:25 ET]
Table 'Ajax III' 6-max Seat #1 is the button
Seat 6: xcinaz ($103.79 in chips) is sitting out
Seat 1: Cositorto ($100 in chips) 
Seat 2: michasia ($171.18 in chips) 
Seat 3: Iospirate ($183.86 in chips) 
Seat 4: Sheva9191 ($123.15 in chips) 
Seat 5: Dante21b ($100.89 in chips) 
michasia: posts small blind $0.50
Iospirate: posts big blind $1
*** HOLE CARDS ***
Sheva9191: raises $1 to $2
Dante21b: folds 
Cositorto: raises $4 to $6
michasia: folds 
Iospirate: folds 
Sheva9191: calls $4
*** FLOP *** [2h 8d Ad]
Sheva9191: checks 
Cositorto: bets $2.50
Sheva9191: folds 
Uncalled bet ($2.50) returned to Cositorto
Cositorto collected $12.82 from pot
Cositorto: doesn't show hand 
*** SUMMARY ***
Total pot $13.50 | Rake $0.68 
Board [2h 8d Ad]
Seat 6: xcinaz
Seat 1: Cositorto (button) collected ($12.82)
Seat 2: michasia (small blind) folded before Flop
Seat 3: Iospirate (big blind) folded before Flop
Seat 4: Sheva9191 folded on the Flop
Seat 5: Dante21b folded before Flop (didn't bet)



PokerStars Hand #254508021711:  Hold'em No Limit ($0.50/$1.00 USD) - 2025/01/22 23:34:06 WET [2025/01/22 18:34:06 ET]
Table 'Ajax III' 6-max Seat #2 is the button
Seat 6: xcinaz ($103.79 in chips) is sitting out
Seat 1: Cositorto ($106.82 in chips) 
Seat 2: michasia ($170.68 in chips) 
Seat 3: Iospirate ($182.86 in chips) 
Seat 4: Sheva9191 ($117.15 in chips) 
Seat 5: Dante21b ($100.89 in chips) 
Iospirate: posts small blind $0.50
Sheva9191: posts big blind $1
*** HOLE CARDS ***
Dante21b: raises $1.50 to $2.50
Cositorto: folds 
michasia: folds 
Iospirate: folds 
Sheva9191: calls $1.50
*** FLOP *** [8d 5h 2h]
Sheva9191: checks 
Dante21b: bets $5.22
Sheva9191: calls $5.22
*** TURN *** [8d 5h 2h] [Td]
Sheva9191: checks 
Dante21b: bets $22.71
Sheva9191: folds 
Uncalled bet ($22.71) returned to Dante21b
Dante21b collected $15.14 from pot
Dante21b: doesn't show hand 
*** SUMMARY ***
Total pot $15.94 | Rake $0.80 
Board [8d 5h 2h Td]
Seat 6: xcinaz
Seat 1: Cositorto folded before Flop (didn't bet)
Seat 2: michasia (button) folded before Flop (didn't bet)
Seat 3: Iospirate (small blind) folded before Flop
Seat 4: Sheva9191 (big blind) folded on the Turn
Seat 5: Dante21b collected ($15.14)



PokerStars Hand #254508031842:  Hold'em No Limit ($0.50/$1.00 USD) - 2025/01/22 23:34:47 WET [2025/01/22 18:34:47 ET]
Table 'Ajax III' 6-max Seat #3 is the button
Seat 6: xcinaz ($103.79 in chips) is sitting out
Seat 1: Cositorto ($106.82 in chips) 
Seat 2: michasia ($170.68 in chips) 
Seat 3: Iospirate ($182.36 in chips) 
Seat 4: Sheva9191 ($109.43 in chips) 
Seat 5: Dante21b ($108.31 in chips) 
Sheva9191: posts small blind $0.50
Dante21b: posts big blind $1
*** HOLE CARDS ***
Cositorto: folds 
michasia: folds 
Iospirate: folds 
Sheva9191: calls $0.50
Dante21b: checks 
*** FLOP *** [Kc 4c Ks]
Sheva9191: checks 
Dante21b: checks 
*** TURN *** [Kc 4c Ks] [Jc]
Sheva9191: bets $2.90
Dante21b: folds 
Uncalled bet ($2.90) returned to Sheva9191
Sheva9191 collected $1.90 from pot
Sheva9191: doesn't show hand 
*** SUMMARY ***
Total pot $2 | Rake $0.10 
Board [Kc 4c Ks Jc]
Seat 6: xcinaz
Seat 1: Cositorto folded before Flop (didn't bet)
Seat 2: michasia folded before Flop (didn't bet)
Seat 3: Iospirate (button) folded before Flop (didn't bet)
Seat 4: Sheva9191 (small blind) collected ($1.90)
Seat 5: Dante21b (big blind) folded on the Turn



PokerStars Hand #254508041279:  Hold'em No Limit ($0.50/$1.00 USD) - 2025/01/22 23:35:26 WET [2025/01/22 18:35:26 ET]
Table 'Ajax III' 6-max Seat #4 is the button
Seat 1: Cositorto ($106.82 in chips) 
Seat 2: michasia ($170.68 in chips) 
Seat 3: Iospirate ($182.36 in chips) 
Seat 4: Sheva9191 ($110.33 in chips) 
Seat 5: Dante21b ($107.31 in chips) 
Seat 6: xcinaz ($103.79 in chips) 
Dante21b: posts small blind $0.50
xcinaz: posts big blind $1
*** HOLE CARDS ***
Cositorto: folds 
michasia: raises $1.60 to $2.60
Iospirate: folds 
Sheva9191: calls $2.60
Dante21b: folds 
xcinaz: folds 
*** FLOP *** [Tc 4c 3h]
michasia: checks 
Sheva9191: bets $3.18
michasia: folds 
Uncalled bet ($3.18) returned to Sheva9191
Sheva9191 collected $6.36 from pot
Sheva9191: doesn't show hand 
*** SUMMARY ***
Total pot $6.70 | Rake $0.34 
Board [Tc 4c 3h]
Seat 1: Cositorto folded before Flop (didn't bet)
Seat 2: michasia folded on the Flop
Seat 3: Iospirate folded before Flop (didn't bet)
Seat 4: Sheva9191 (button) collected ($6.36)
Seat 5: Dante21b (small blind) folded before Flop
Seat 6: xcinaz (big blind) folded before Flop



PokerStars Hand #254508047615:  Hold'em No Limit ($0.50/$1.00 USD) - 2025/01/22 23:35:52 WET [2025/01/22 18:35:52 ET]
Table 'Ajax III' 6-max Seat #5 is the button
Seat 1: Cositorto ($106.82 in chips) 
Seat 2: michasia ($168.08 in chips) 
Seat 3: Iospirate ($182.36 in chips) 
Seat 4: Sheva9191 ($114.09 in chips) 
Seat 5: Dante21b ($106.81 in chips) 
Seat 6: xcinaz ($102.79 in chips) 
xcinaz: posts small blind $0.50
Cositorto: posts big blind $1
*** HOLE CARDS ***
michasia: folds 
Iospirate: folds 
Sheva9191: raises $1.50 to $2.50
Dante21b: folds 
xcinaz: folds 
Cositorto: folds 
Uncalled bet ($1.50) returned to Sheva9191
Sheva9191 collected $2.50 from pot
Sheva9191: doesn't show hand 
*** SUMMARY ***
Total pot $2.50 | Rake $0 
Seat 1: Cositorto (big blind) folded before Flop
Seat 2: michasia folded before Flop (didn't bet)
Seat 3: Iospirate folded before Flop (didn't bet)
Seat 4: Sheva9191 collected ($2.50)
Seat 5: Dante21b (button) folded before Flop (didn't bet)
Seat 6: xcinaz (small blind) folded before Flop



PokerStars Hand #254508054688:  Hold'em No Limit ($0.50/$1.00 USD) - 2025/01/22 23:36:21 WET [2025/01/22 18:36:21 ET]
Table 'Ajax III' 6-max Seat #6 is the button
Seat 1: Cositorto ($105.82 in chips) 
Seat 2: michasia ($168.08 in chips) 
Seat 3: Iospirate ($182.36 in chips) 
Seat 4: Sheva9191 ($115.59 in chips) 
Seat 5: Dante21b ($106.81 in chips) 
Seat 6: xcinaz ($102.29 in chips) 
Cositorto: posts small blind $0.50
michasia: posts big blind $1
*** HOLE CARDS ***
Iospirate: calls $1
Sheva9191: folds 
Dante21b: folds 
xcinaz: folds 
Cositorto: folds 
michasia: checks 
*** FLOP *** [Qc 5h Ts]
michasia: checks 
Iospirate: checks 
*** TURN *** [Qc 5h Ts] [2d]
michasia: checks 
Iospirate: checks 
*** RIVER *** [Qc 5h Ts 2d] [3d]
michasia: checks 
Iospirate: checks 
*** SHOW DOWN ***
michasia: shows [2h 9d] (a pair of Deuces)
Iospirate: mucks hand 
michasia collected $2.38 from pot
*** SUMMARY ***
Total pot $2.50 | Rake $0.12 
Board [Qc 5h Ts 2d 3d]
Seat 1: Cositorto (small blind) folded before Flop
Seat 2: michasia (big blind) showed [2h 9d] and won ($2.38) with a pair of Deuces
Seat 3: Iospirate mucked
Seat 4: Sheva9191 folded before Flop (didn't bet)
Seat 5: Dante21b folded before Flop (didn't bet)
Seat 6: xcinaz (button) folded before Flop (didn't bet)



PokerStars Hand #254508063578:  Hold'em No Limit ($0.50/$1.00 USD) - 2025/01/22 23:36:58 WET [2025/01/22 18:36:58 ET]
Table 'Ajax III' 6-max Seat #1 is the button
Seat 1: Cositorto ($105.32 in chips) 
Seat 2: michasia ($169.46 in chips) 
Seat 3: Iospirate ($181.36 in chips) 
Seat 4: Sheva9191 ($115.59 in chips) 
Seat 5: Dante21b ($106.81 in chips) 
Seat 6: xcinaz ($102.29 in chips) 
michasia: posts small blind $0.50
Iospirate: posts big blind $1
*** HOLE CARDS ***
Sheva9191: raises $1.50 to $2.50
Dante21b: folds 
xcinaz: folds 
Cositorto: raises $5 to $7.50
michasia: folds 
Iospirate: folds 
Sheva9191: raises $9 to $16.50
Cositorto: folds 
Uncalled bet ($9) returned to Sheva9191
Sheva9191 collected $16.50 from pot
Sheva9191: doesn't show hand 
*** SUMMARY ***
Total pot $16.50 | Rake $0 
Seat 1: Cositorto (button) folded before Flop
Seat 2: michasia (small blind) folded before Flop
Seat 3: Iospirate (big blind) folded before Flop
Seat 4: Sheva9191 collected ($16.50)
Seat 5: Dante21b folded before Flop (didn't bet)
Seat 6: xcinaz folded before Flop (didn't bet)



PokerStars Hand #254508071164:  Hold'em No Limit ($0.50/$1.00 USD) - 2025/01/22 23:37:30 WET [2025/01/22 18:37:30 ET]
Table 'Ajax III' 6-max Seat #2 is the button
Seat 1: Cositorto ($100 in chips) 
Seat 2: michasia ($168.96 in chips) 
Seat 3: Iospirate ($180.36 in chips) 
Seat 4: Sheva9191 ($124.59 in chips) 
Seat 5: Dante21b ($106.81 in chips) 
Seat 6: xcinaz ($102.29 in chips) 
Iospirate: posts small blind $0.50
Sheva9191: posts big blind $1
*** HOLE CARDS ***
Dante21b: folds 
xcinaz: folds 
Cositorto: folds 
michasia: raises $1.80 to $2.80
Iospirate: folds 
Sheva9191: folds 
Uncalled bet ($1.80) returned to michasia
michasia collected $2.50 from pot
michasia: doesn't show hand 
*** SUMMARY ***
Total pot $2.50 | Rake $0 
Seat 1: Cositorto folded before Flop (didn't bet)
Seat 2: michasia (button) collected ($2.50)
Seat 3: Iospirate (small blind) folded before Flop
Seat 4: Sheva9191 (big blind) folded before Flop
Seat 5: Dante21b folded before Flop (didn't bet)
Seat 6: xcinaz folded before Flop (didn't bet)



PokerStars Hand #254508074316:  Hold'em No Limit ($0.50/$1.00 USD) - 2025/01/22 23:37:43 WET [2025/01/22 18:37:43 ET]
Table 'Ajax III' 6-max Seat #3 is the button
Seat 1: Cositorto ($100 in chips) 
Seat 2: michasia ($170.46 in chips) 
Seat 3: Iospirate ($179.86 in chips) 
Seat 4: Sheva9191 ($123.59 in chips) 
Seat 5: Dante21b ($106.81 in chips) 
Seat 6: xcinaz ($102.29 in chips) 
Sheva9191: posts small blind $0.50
Dante21b: posts big blind $1
*** HOLE CARDS ***
xcinaz: folds 
Cositorto: folds 
michasia: folds 
Iospirate: folds 
Sheva9191: raises $1.25 to $2.25
Dante21b: raises $5.75 to $8
Sheva9191: calls $5.75
*** FLOP *** [3s Td Ks]
Sheva9191: checks 
Dante21b: checks 
*** TURN *** [3s Td Ks] [Js]
Sheva9191: bets $8.60
Dante21b: raises $44.40 to $53
Sheva9191: folds 
Uncalled bet ($44.40) returned to Dante21b
Dante21b collected $31.54 from pot
Dante21b: doesn't show hand 
*** SUMMARY ***
Total pot $33.20 | Rake $1.66 
Board [3s Td Ks Js]
Seat 1: Cositorto folded before Flop (didn't bet)
Seat 2: michasia folded before Flop (didn't bet)
Seat 3: Iospirate (button) folded before Flop (didn't bet)
Seat 4: Sheva9191 (small blind) folded on the Turn
Seat 5: Dante21b (big blind) collected ($31.54)
Seat 6: xcinaz folded before Flop (didn't bet)



PokerStars Hand #254508098769:  Hold'em No Limit ($0.50/$1.00 USD) - 2025/01/22 23:39:25 WET [2025/01/22 18:39:25 ET]
Table 'Ajax III' 6-max Seat #4 is the button
Seat 1: Cositorto ($100 in chips) 
Seat 2: michasia ($170.46 in chips) 
Seat 3: Iospirate ($179.86 in chips) 
Seat 4: Sheva9191 ($106.99 in chips) 
Seat 5: Dante21b ($121.75 in chips) 
Seat 6: xcinaz ($102.29 in chips) 
Dante21b: posts small blind $0.50
xcinaz: posts big blind $1
*** HOLE CARDS ***
Cositorto: raises $1 to $2
michasia: folds 
Iospirate: folds 
Sheva9191: folds 
Dante21b: raises $6 to $8
xcinaz: folds 
Cositorto: calls $6
*** FLOP *** [As 2h Qh]
Dante21b: bets $5.33
Cositorto: calls $5.33
*** TURN *** [As 2h Qh] [Kd]
Dante21b: bets $14
Cositorto: calls $14
*** RIVER *** [As 2h Qh Kd] [2d]
Dante21b has timed out
Dante21b: checks 
Cositorto: checks 
*** SHOW DOWN ***
Dante21b: shows [Th Td] (two pair, Tens and Deuces)
Cositorto: shows [Ac Tc] (two pair, Aces and Deuces)
Cositorto collected $53.16 from pot
*** SUMMARY ***
Total pot $55.66 | Rake $2.50 
Board [As 2h Qh Kd 2d]
Seat 1: Cositorto showed [Ac Tc] and won ($53.16) with two pair, Aces and Deuces
Seat 2: michasia folded before Flop (didn't bet)
Seat 3: Iospirate folded before Flop (didn't bet)
Seat 4: Sheva9191 (button) folded before Flop (didn't bet)
Seat 5: Dante21b (small blind) showed [Th Td] and lost with two pair, Tens and Deuces
Seat 6: xcinaz (big blind) folded before Flop



PokerStars Hand #254508127106:  Hold'em No Limit ($0.50/$1.00 USD) - 2025/01/22 23:41:26 WET [2025/01/22 18:41:26 ET]
Table 'Ajax III' 6-max Seat #5 is the button
Seat 1: Cositorto ($125.83 in chips) 
Seat 2: michasia ($170.46 in chips) 
Seat 3: Iospirate ($179.86 in chips) 
Seat 4: Sheva9191 ($106.99 in chips) 
Seat 5: Dante21b ($100 in chips) 
Seat 6: xcinaz ($101.29 in chips) 
xcinaz: posts small blind $0.50
Cositorto: posts big blind $1
*** HOLE CARDS ***
michasia: folds 
Iospirate: folds 
Sheva9191: calls $1
Dante21b: raises $4 to $5
xcinaz: folds 
Cositorto: calls $4
Sheva9191: folds 
*** FLOP *** [2h 5h 8c]
Cositorto: checks 
Dante21b: bets $3.60
Cositorto: folds 
Uncalled bet ($3.60) returned to Dante21b
Dante21b collected $10.92 from pot
Dante21b: doesn't show hand 
*** SUMMARY ***
Total pot $11.50 | Rake $0.58 
Board [2h 5h 8c]
Seat 1: Cositorto (big blind) folded on the Flop
Seat 2: michasia folded before Flop (didn't bet)
Seat 3: Iospirate folded before Flop (didn't bet)
Seat 4: Sheva9191 folded before Flop
Seat 5: Dante21b (button) collected ($10.92)
Seat 6: xcinaz (small blind) folded before Flop



PokerStars Hand #254508138811:  Hold'em No Limit ($0.50/$1.00 USD) - 2025/01/22 23:42:16 WET [2025/01/22 18:42:16 ET]
Table 'Ajax III' 6-max Seat #6 is the button
Seat 1: Cositorto ($120.83 in chips) 
Seat 2: michasia ($170.46 in chips) 
Seat 3: Iospirate ($179.86 in chips) 
Seat 4: Sheva9191 ($105.99 in chips) 
Seat 5: Dante21b ($105.92 in chips) 
Seat 6: xcinaz ($100.79 in chips) 
Cositorto: posts small blind $0.50
michasia: posts big blind $1
*** HOLE CARDS ***
Iospirate: calls $1
Sheva9191: calls $1
Dante21b: folds 
xcinaz: folds 
Cositorto: calls $0.50
michasia: checks 
*** FLOP *** [2d Ts 9h]
Cositorto: checks 
michasia: checks 
Iospirate: checks 
Sheva9191: bets $3.80
Cositorto: calls $3.80
michasia: folds 
Iospirate: folds 
*** TURN *** [2d Ts 9h] [3s]
Cositorto: checks 
Sheva9191: bets $6.51
Cositorto: calls $6.51
*** RIVER *** [2d Ts 9h 3s] [Qc]
Cositorto: checks 
Sheva9191: checks 
*** SHOW DOWN ***
Cositorto: shows [Th 4h] (a pair of Tens)
Sheva9191: mucks hand 
Cositorto collected $23.39 from pot
*** SUMMARY ***
Total pot $24.62 | Rake $1.23 
Board [2d Ts 9h 3s Qc]
Seat 1: Cositorto (small blind) showed [Th 4h] and won ($23.39) with a pair of Tens
Seat 2: michasia (big blind) folded on the Flop
Seat 3: Iospirate folded on the Flop
Seat 4: Sheva9191 mucked
Seat 5: Dante21b folded before Flop (didn't bet)
Seat 6: xcinaz (button) folded before Flop (didn't bet)



PokerStars Hand #254508156448:  Hold'em No Limit ($0.50/$1.00 USD) - 2025/01/22 23:43:32 WET [2025/01/22 18:43:32 ET]
Table 'Ajax III' 6-max Seat #1 is the button
Seat 1: Cositorto ($132.91 in chips) 
Seat 2: michasia ($169.46 in chips) 
Seat 3: Iospirate ($178.86 in chips) 
Seat 4: Sheva9191 ($94.68 in chips) 
Seat 5: Dante21b ($105.92 in chips) 
Seat 6: xcinaz ($100.79 in chips) 
michasia: posts small blind $0.50
Iospirate: posts big blind $1
*** HOLE CARDS ***
Sheva9191: folds 
Dante21b: raises $1.50 to $2.50
xcinaz: folds 
Cositorto: folds 
michasia: raises $9.50 to $12
Iospirate: folds 
Dante21b: folds 
Uncalled bet ($9.50) returned to michasia
michasia collected $6 from pot
michasia: doesn't show hand 
*** SUMMARY ***
Total pot $6 | Rake $0 
Seat 1: Cositorto (button) folded before Flop (didn't bet)
Seat 2: michasia (small blind) collected ($6)
Seat 3: Iospirate (big blind) folded before Flop
Seat 4: Sheva9191 folded before Flop (didn't bet)
Seat 5: Dante21b folded before Flop
Seat 6: xcinaz folded before Flop (didn't bet)



PokerStars Hand #254508165087:  Hold'em No Limit ($0.50/$1.00 USD) - 2025/01/22 23:44:09 WET [2025/01/22 18:44:09 ET]
Table 'Ajax III' 6-max Seat #2 is the button
Seat 1: Cositorto ($132.91 in chips) 
Seat 2: michasia ($172.96 in chips) 
Seat 3: Iospirate ($177.86 in chips) 
Seat 4: Sheva9191 ($94.68 in chips) 
Seat 5: Dante21b ($103.42 in chips) 
Seat 6: xcinaz ($100.79 in chips) 
Iospirate: posts small blind $0.50
Sheva9191: posts big blind $1
*** HOLE CARDS ***
Dante21b: folds 
xcinaz: folds 
Cositorto: folds 
michasia: raises $1.80 to $2.80
Iospirate: folds 
Sheva9191: folds 
Uncalled bet ($1.80) returned to michasia
michasia collected $2.50 from pot
michasia: doesn't show hand 
*** SUMMARY ***
Total pot $2.50 | Rake $0 
Seat 1: Cositorto folded before Flop (didn't bet)
Seat 2: michasia (button) collected ($2.50)
Seat 3: Iospirate (small blind) folded before Flop
Seat 4: Sheva9191 (big blind) folded before Flop
Seat 5: Dante21b folded before Flop (didn't bet)
Seat 6: xcinaz folded before Flop (didn't bet)



PokerStars Hand #254508173652:  Hold'em No Limit ($0.50/$1.00 USD) - 2025/01/22 23:44:46 WET [2025/01/22 18:44:46 ET]
Table 'Ajax III' 6-max Seat #3 is the button
Seat 1: Cositorto ($132.91 in chips) 
Seat 2: michasia ($174.46 in chips) 
Seat 3: Iospirate ($177.36 in chips) 
Seat 4: Sheva9191 ($93.68 in chips) 
Seat 5: Dante21b ($103.42 in chips) 
Seat 6: xcinaz ($100.79 in chips) 
Sheva9191: posts small blind $0.50
Dante21b: posts big blind $1
*** HOLE CARDS ***
xcinaz: folds 
Cositorto: raises $1 to $2
michasia: folds 
Iospirate: folds 
Sheva9191: folds 
Dante21b: folds 
Uncalled bet ($1) returned to Cositorto
Cositorto collected $2.50 from pot
Cositorto: doesn't show hand 
*** SUMMARY ***
Total pot $2.50 | Rake $0 
Seat 1: Cositorto collected ($2.50)
Seat 2: michasia folded before Flop (didn't bet)
Seat 3: Iospirate (button) folded before Flop (didn't bet)
Seat 4: Sheva9191 (small blind) folded before Flop
Seat 5: Dante21b (big blind) folded before Flop
Seat 6: xcinaz folded before Flop (didn't bet)



PokerStars Hand #254508178755:  Hold'em No Limit ($0.50/$1.00 USD) - 2025/01/22 23:45:08 WET [2025/01/22 18:45:08 ET]
Table 'Ajax III' 6-max Seat #4 is the button
Seat 1: Cositorto ($134.41 in chips) 
Seat 2: michasia ($174.46 in chips) 
Seat 3: Iospirate ($177.36 in chips) 
Seat 4: Sheva9191 ($93.18 in chips) 
Seat 5: Dante21b ($102.42 in chips) 
Seat 6: xcinaz ($100.79 in chips) 
Dante21b: posts small blind $0.50
xcinaz: posts big blind $1
*** HOLE CARDS ***
Cositorto: folds 
michasia: folds 
Iospirate: folds 
Sheva9191: folds 
Dante21b: folds 
Uncalled bet ($0.50) returned to xcinaz
xcinaz collected $1 from pot
xcinaz: doesn't show hand 
*** SUMMARY ***
Total pot $1 | Rake $0 
Seat 1: Cositorto folded before Flop (didn't bet)
Seat 2: michasia folded before Flop (didn't bet)
Seat 3: Iospirate folded before Flop (didn't bet)
Seat 4: Sheva9191 (button) folded before Flop (didn't bet)
Seat 5: Dante21b (small blind) folded before Flop
Seat 6: xcinaz (big blind) collected ($1)



PokerStars Hand #254508181456:  Hold'em No Limit ($0.50/$1.00 USD) - 2025/01/22 23:45:20 WET [2025/01/22 18:45:20 ET]
Table 'Ajax III' 6-max Seat #5 is the button
Seat 1: Cositorto ($134.41 in chips) 
Seat 2: michasia ($174.46 in chips) 
Seat 3: Iospirate ($177.36 in chips) 
Seat 4: Sheva9191 ($93.18 in chips) 
Seat 5: Dante21b ($101.92 in chips) 
Seat 6: xcinaz ($101.29 in chips) 
xcinaz: posts small blind $0.50
Cositorto: posts big blind $1
*** HOLE CARDS ***
michasia: folds 
Iospirate: folds 
Sheva9191: folds 
Dante21b: folds 
xcinaz: raises $2 to $3
Cositorto: folds 
Uncalled bet ($2) returned to xcinaz
xcinaz collected $2 from pot
xcinaz: doesn't show hand 
*** SUMMARY ***
Total pot $2 | Rake $0 
Seat 1: Cositorto (big blind) folded before Flop
Seat 2: michasia folded before Flop (didn't bet)
Seat 3: Iospirate folded before Flop (didn't bet)
Seat 4: Sheva9191 folded before Flop (didn't bet)
Seat 5: Dante21b (button) folded before Flop (didn't bet)
Seat 6: xcinaz (small blind) collected ($2)



PokerStars Hand #254508184805:  Hold'em No Limit ($0.50/$1.00 USD) - 2025/01/22 23:45:34 WET [2025/01/22 18:45:34 ET]
Table 'Ajax III' 6-max Seat #6 is the button
Seat 1: Cositorto ($133.41 in chips) 
Seat 2: michasia ($174.46 in chips) 
Seat 3: Iospirate ($177.36 in chips) 
Seat 4: Sheva9191 ($93.18 in chips) 
Seat 5: Dante21b ($101.92 in chips) 
Seat 6: xcinaz ($102.29 in chips) 
Cositorto: posts small blind $0.50
michasia: posts big blind $1
*** HOLE CARDS ***
Iospirate: folds 
Sheva9191: folds 
Dante21b: raises $1.50 to $2.50
xcinaz: folds 
Cositorto: folds 
michasia: folds 
Uncalled bet ($1.50) returned to Dante21b
Dante21b collected $2.50 from pot
Dante21b: doesn't show hand 
*** SUMMARY ***
Total pot $2.50 | Rake $0 
Seat 1: Cositorto (small blind) folded before Flop
Seat 2: michasia (big blind) folded before Flop
Seat 3: Iospirate folded before Flop (didn't bet)
Seat 4: Sheva9191 folded before Flop (didn't bet)
Seat 5: Dante21b collected ($2.50)
Seat 6: xcinaz (button) folded before Flop (didn't bet)



PokerStars Hand #254508188211:  Hold'em No Limit ($0.50/$1.00 USD) - 2025/01/22 23:45:48 WET [2025/01/22 18:45:48 ET]
Table 'Ajax III' 6-max Seat #1 is the button
Seat 1: Cositorto ($132.91 in chips) 
Seat 2: michasia ($173.46 in chips) 
Seat 3: Iospirate ($177.36 in chips) 
Seat 4: Sheva9191 ($93.18 in chips) 
Seat 5: Dante21b ($103.42 in chips) 
Seat 6: xcinaz ($102.29 in chips) 
michasia: posts small blind $0.50
Iospirate: posts big blind $1
*** HOLE CARDS ***
Sheva9191: folds 
Dante21b: folds 
xcinaz: raises $1.20 to $2.20
Cositorto: folds 
michasia: folds 
Iospirate: folds 
Uncalled bet ($1.20) returned to xcinaz
xcinaz collected $2.50 from pot
xcinaz: doesn't show hand 
*** SUMMARY ***
Total pot $2.50 | Rake $0 
Seat 1: Cositorto (button) folded before Flop (didn't bet)
Seat 2: michasia (small blind) folded before Flop
Seat 3: Iospirate (big blind) folded before Flop
Seat 4: Sheva9191 folded before Flop (didn't bet)
Seat 5: Dante21b folded before Flop (didn't bet)
Seat 6: xcinaz collected ($2.50)



PokerStars Hand #254508193365:  Hold'em No Limit ($0.50/$1.00 USD) - 2025/01/22 23:46:11 WET [2025/01/22 18:46:11 ET]
Table 'Ajax III' 6-max Seat #2 is the button
Seat 1: Cositorto ($132.91 in chips) 
Seat 2: michasia ($172.96 in chips) 
Seat 3: Iospirate ($176.36 in chips) 
Seat 4: Sheva9191 ($93.18 in chips) 
Seat 5: Dante21b ($103.42 in chips) 
Seat 6: xcinaz ($103.79 in chips) 
Iospirate: posts small blind $0.50
Sheva9191: posts big blind $1
*** HOLE CARDS ***
Dante21b: folds 
xcinaz: folds 
Cositorto: folds 
michasia: folds 
Iospirate has timed out
Iospirate: folds 
Uncalled bet ($0.50) returned to Sheva9191
Sheva9191 collected $1 from pot
Sheva9191: doesn't show hand 
*** SUMMARY ***
Total pot $1 | Rake $0 
Seat 1: Cositorto folded before Flop (didn't bet)
Seat 2: michasia (button) folded before Flop (didn't bet)
Seat 3: Iospirate (small blind) folded before Flop
Seat 4: Sheva9191 (big blind) collected ($1)
Seat 5: Dante21b folded before Flop (didn't bet)
Seat 6: xcinaz folded before Flop (didn't bet)



PokerStars Hand #254508206096:  Hold'em No Limit ($0.50/$1.00 USD) - 2025/01/22 23:47:06 WET [2025/01/22 18:47:06 ET]
Table 'Ajax III' 6-max Seat #4 is the button
Seat 3: Iospirate ($175.86 in chips) is sitting out
Seat 1: Cositorto ($132.91 in chips) 
Seat 2: michasia ($172.96 in chips) 
Seat 4: Sheva9191 ($100 in chips) 
Seat 5: Dante21b ($103.42 in chips) 
Seat 6: xcinaz ($103.79 in chips) 
Dante21b: posts small blind $0.50
xcinaz: posts big blind $1
*** HOLE CARDS ***
Cositorto: folds 
michasia: folds 
Sheva9191: raises $2 to $3
Dante21b: folds 
xcinaz: calls $2
*** FLOP *** [9s 3h 4h]
xcinaz: checks 
Sheva9191: bets $3.09
xcinaz: folds 
Uncalled bet ($3.09) returned to Sheva9191
Sheva9191 collected $6.18 from pot
Sheva9191: doesn't show hand 
*** SUMMARY ***
Total pot $6.50 | Rake $0.32 
Board [9s 3h 4h]
Seat 3: Iospirate
Seat 1: Cositorto folded before Flop (didn't bet)
Seat 2: michasia folded before Flop (didn't bet)
Seat 4: Sheva9191 (button) collected ($6.18)
Seat 5: Dante21b (small blind) folded before Flop
Seat 6: xcinaz (big blind) folded on the Flop



PokerStars Hand #254508211909:  Hold'em No Limit ($0.50/$1.00 USD) - 2025/01/22 23:47:31 WET [2025/01/22 18:47:31 ET]
Table 'Ajax III' 6-max Seat #5 is the button
Seat 3: Iospirate ($175.86 in chips) is sitting out
Seat 1: Cositorto ($132.91 in chips) 
Seat 2: michasia ($172.96 in chips) 
Seat 4: Sheva9191 ($103.18 in chips) 
Seat 5: Dante21b ($102.92 in chips) 
Seat 6: xcinaz ($100.79 in chips) 
xcinaz: posts small blind $0.50
Cositorto: posts big blind $1
*** HOLE CARDS ***
michasia: folds 
Sheva9191: folds 
Dante21b: raises $1.50 to $2.50
xcinaz: raises $9 to $11.50
Cositorto: raises $92 to $103.50
Dante21b: folds 
xcinaz: folds 
Uncalled bet ($92) returned to Cositorto
Cositorto collected $25.50 from pot
Cositorto: doesn't show hand 
*** SUMMARY ***
Total pot $25.50 | Rake $0 
Seat 3: Iospirate
Seat 1: Cositorto (big blind) collected ($25.50)
Seat 2: michasia folded before Flop (didn't bet)
Seat 4: Sheva9191 folded before Flop (didn't bet)
Seat 5: Dante21b (button) folded before Flop
Seat 6: xcinaz (small blind) folded before Flop



PokerStars Hand #254508223948:  Hold'em No Limit ($0.50/$1.00 USD) - 2025/01/22 23:48:24 WET [2025/01/22 18:48:24 ET]
Table 'Ajax III' 6-max Seat #6 is the button
Seat 1: Cositorto ($146.91 in chips) 
Seat 2: michasia ($172.96 in chips) 
Seat 3: Iospirate ($175.86 in chips) 
Seat 4: Sheva9191 ($103.18 in chips) 
Seat 5: Dante21b ($100.42 in chips) 
Seat 6: xcinaz ($100 in chips) 
Cositorto: posts small blind $0.50
michasia: posts big blind $1
*** HOLE CARDS ***
Iospirate: folds 
Sheva9191: raises $2 to $3
Dante21b: folds 
xcinaz: folds 
Cositorto: folds 
michasia: calls $2
*** FLOP *** [2c 4d 9c]
michasia: checks 
Sheva9191: bets $3.09
michasia: calls $3.09
*** TURN *** [2c 4d 9c] [2s]
michasia: checks 
Sheva9191: bets $10.03
michasia: calls $10.03
*** RIVER *** [2c 4d 9c 2s] [6s]
michasia: checks 
Sheva9191: bets $21.55
michasia: calls $21.55
*** SHOW DOWN ***
Sheva9191: shows [Qs As] (a pair of Deuces)
michasia: shows [8h 8c] (two pair, Eights and Deuces)
michasia collected $73.34 from pot
*** SUMMARY ***
Total pot $75.84 | Rake $2.50 
Board [2c 4d 9c 2s 6s]
Seat 1: Cositorto (small blind) folded before Flop
Seat 2: michasia (big blind) showed [8h 8c] and won ($73.34) with two pair, Eights and Deuces
Seat 3: Iospirate folded before Flop (didn't bet)
Seat 4: Sheva9191 showed [Qs As] and lost with a pair of Deuces
Seat 5: Dante21b folded before Flop (didn't bet)
Seat 6: xcinaz (button) folded before Flop (didn't bet)



PokerStars Hand #254508237599:  Hold'em No Limit ($0.50/$1.00 USD) - 2025/01/22 23:49:24 WET [2025/01/22 18:49:24 ET]
Table 'Ajax III' 6-max Seat #1 is the button
Seat 1: Cositorto ($146.41 in chips) 
Seat 2: michasia ($208.63 in chips) 
Seat 3: Iospirate ($175.86 in chips) 
Seat 4: Sheva9191 ($65.51 in chips) 
Seat 5: Dante21b ($100.42 in chips) 
Seat 6: xcinaz ($100 in chips) 
michasia: posts small blind $0.50
Iospirate: posts big blind $1
*** HOLE CARDS ***
Sheva9191: calls $1
Dante21b: raises $1.50 to $2.50
xcinaz: raises $5.50 to $8
Cositorto: folds 
michasia: folds 
Iospirate: folds 
Sheva9191: raises $11.50 to $19.50
Dante21b: folds 
xcinaz: calls $11.50
*** FLOP *** [7s Tc Js]
Sheva9191: checks 
xcinaz: bets $13.48
Sheva9191: raises $32.53 to $46.01 and is all-in
xcinaz: calls $32.53
*** TURN *** [7s Tc Js] [6d]
*** RIVER *** [7s Tc Js 6d] [Ks]
*** SHOW DOWN ***
Sheva9191: shows [Ad As] (a pair of Aces)
xcinaz: shows [Td Th] (three of a kind, Tens)
xcinaz collected $132.52 from pot
*** SUMMARY ***
Total pot $135.02 | Rake $2.50 
Board [7s Tc Js 6d Ks]
Seat 1: Cositorto (button) folded before Flop (didn't bet)
Seat 2: michasia (small blind) folded before Flop
Seat 3: Iospirate (big blind) folded before Flop
Seat 4: Sheva9191 showed [Ad As] and lost with a pair of Aces
Seat 5: Dante21b folded before Flop
Seat 6: xcinaz showed [Td Th] and won ($132.52) with three of a kind, Tens



PokerStars Hand #254508257610:  Hold'em No Limit ($0.50/$1.00 USD) - 2025/01/22 23:50:54 WET [2025/01/22 18:50:54 ET]
Table 'Ajax III' 6-max Seat #2 is the button
Seat 4: Sheva9191 ($0 in chips) is sitting out
Seat 1: Cositorto ($146.41 in chips) 
Seat 2: michasia ($208.13 in chips) 
Seat 3: Iospirate ($174.86 in chips) 
Seat 5: Dante21b ($97.92 in chips) 
Seat 6: xcinaz ($167.01 in chips) 
Iospirate: posts small blind $0.50
Dante21b: posts big blind $1
*** HOLE CARDS ***
xcinaz: folds 
Sheva9191 leaves the table
Cositorto: folds 
michasia: folds 
Iospirate: raises $1 to $2
sutata joins the table at seat #4 
Dante21b: folds 
Uncalled bet ($1) returned to Iospirate
Iospirate collected $2 from pot
Iospirate: doesn't show hand 
*** SUMMARY ***
Total pot $2 | Rake $0 
Seat 4: Sheva9191
Seat 1: Cositorto folded before Flop (didn't bet)
Seat 2: michasia (button) folded before Flop (didn't bet)
Seat 3: Iospirate (small blind) collected ($2)
Seat 5: Dante21b (big blind) folded before Flop
Seat 6: xcinaz folded before Flop (didn't bet)



PokerStars Hand #254508264182:  Hold'em No Limit ($0.50/$1.00 USD) - 2025/01/22 23:51:24 WET [2025/01/22 18:51:24 ET]
Table 'Ajax III' 6-max Seat #3 is the button
Seat 4: sutata ($100 in chips) is sitting out
Seat 1: Cositorto ($146.41 in chips) 
Seat 2: michasia ($208.13 in chips) 
Seat 3: Iospirate ($175.86 in chips) 
Seat 5: Dante21b ($96.92 in chips) 
Seat 6: xcinaz ($167.01 in chips) 
Dante21b: posts small blind $0.50
xcinaz: posts big blind $1
*** HOLE CARDS ***
Cositorto: folds 
michasia: folds 
Iospirate: folds 
Dante21b: raises $2 to $3
xcinaz: calls $2
*** FLOP *** [6d 5s Ah]
Dante21b: checks 
xcinaz: checks 
*** TURN *** [6d 5s Ah] [Kc]
Dante21b: checks 
xcinaz: checks 
*** RIVER *** [6d 5s Ah Kc] [5d]
Dante21b: bets $8.55
xcinaz: calls $8.55
*** SHOW DOWN ***
Dante21b: shows [5h 7h] (three of a kind, Fives)
xcinaz: mucks hand 
Dante21b collected $21.94 from pot
*** SUMMARY ***
Total pot $23.10 | Rake $1.16 
Board [6d 5s Ah Kc 5d]
Seat 4: sutata
Seat 1: Cositorto folded before Flop (didn't bet)
Seat 2: michasia folded before Flop (didn't bet)
Seat 3: Iospirate (button) folded before Flop (didn't bet)
Seat 5: Dante21b (small blind) showed [5h 7h] and won ($21.94) with three of a kind, Fives
Seat 6: xcinaz (big blind) mucked



PokerStars Hand #254508277117:  Hold'em No Limit ($0.50/$1.00 USD) - 2025/01/22 23:52:23 WET [2025/01/22 18:52:23 ET]
Table 'Ajax III' 6-max Seat #5 is the button
Seat 4: sutata ($100 in chips) is sitting out
Seat 1: Cositorto ($146.41 in chips) 
Seat 2: michasia ($208.13 in chips) 
Seat 3: Iospirate ($175.86 in chips) 
Seat 5: Dante21b ($107.31 in chips) 
Seat 6: xcinaz ($155.46 in chips) 
xcinaz: posts small blind $0.50
Cositorto: posts big blind $1
sutata: sits out 
*** HOLE CARDS ***
michasia: folds 
Iospirate: folds 
Dante21b: raises $1.25 to $2.25
xcinaz: folds 
Cositorto: calls $1.25
*** FLOP *** [9c Qh Ks]
Cositorto: checks 
Dante21b: bets $1.57
Cositorto: folds 
Uncalled bet ($1.57) returned to Dante21b
Dante21b collected $4.75 from pot
Dante21b: doesn't show hand 
*** SUMMARY ***
Total pot $5 | Rake $0.25 
Board [9c Qh Ks]
Seat 4: sutata
Seat 1: Cositorto (big blind) folded on the Flop
Seat 2: michasia folded before Flop (didn't bet)
Seat 3: Iospirate folded before Flop (didn't bet)
Seat 5: Dante21b (button) collected ($4.75)
Seat 6: xcinaz (small blind) folded before Flop



PokerStars Hand #254508285300:  Hold'em No Limit ($0.50/$1.00 USD) - 2025/01/22 23:53:00 WET [2025/01/22 18:53:00 ET]
Table 'Ajax III' 6-max Seat #6 is the button
Seat 4: sutata ($100 in chips) is sitting out
Seat 1: Cositorto ($144.16 in chips) 
Seat 2: michasia ($208.13 in chips) 
Seat 3: Iospirate ($175.86 in chips) 
Seat 5: Dante21b ($109.81 in chips) 
Seat 6: xcinaz ($154.96 in chips) 
Cositorto: posts small blind $0.50
michasia: posts big blind $1
sutata: sits out 
*** HOLE CARDS ***
Iospirate: folds 
Dante21b: folds 
xcinaz: folds 
Cositorto: folds 
Uncalled bet ($0.50) returned to michasia
michasia collected $1 from pot
michasia: doesn't show hand 
*** SUMMARY ***
Total pot $1 | Rake $0 
Seat 4: sutata
Seat 1: Cositorto (small blind) folded before Flop
Seat 2: michasia (big blind) collected ($1)
Seat 3: Iospirate folded before Flop (didn't bet)
Seat 5: Dante21b folded before Flop (didn't bet)
Seat 6: xcinaz (button) folded before Flop (didn't bet)



PokerStars Hand #254508288749:  Hold'em No Limit ($0.50/$1.00 USD) - 2025/01/22 23:53:16 WET [2025/01/22 18:53:16 ET]
Table 'Ajax III' 6-max Seat #1 is the button
Seat 4: sutata ($100 in chips) is sitting out
Seat 1: Cositorto ($143.66 in chips) 
Seat 2: michasia ($208.63 in chips) 
Seat 3: Iospirate ($175.86 in chips) 
Seat 5: Dante21b ($109.81 in chips) 
Seat 6: xcinaz ($154.96 in chips) 
michasia: posts small blind $0.50
Iospirate: posts big blind $1
sutata: sits out 
*** HOLE CARDS ***
Dante21b: folds 
xcinaz: folds 
Cositorto: folds 
michasia: folds 
Uncalled bet ($0.50) returned to Iospirate
Iospirate collected $1 from pot
Iospirate: doesn't show hand 
*** SUMMARY ***
Total pot $1 | Rake $0 
Seat 4: sutata
Seat 1: Cositorto (button) folded before Flop (didn't bet)
Seat 2: michasia (small blind) folded before Flop
Seat 3: Iospirate (big blind) collected ($1)
Seat 5: Dante21b folded before Flop (didn't bet)
Seat 6: xcinaz folded before Flop (didn't bet)



PokerStars Hand #254508291631:  Hold'em No Limit ($0.50/$1.00 USD) - 2025/01/22 23:53:29 WET [2025/01/22 18:53:29 ET]
Table 'Ajax III' 6-max Seat #2 is the button
Seat 1: Cositorto ($143.66 in chips) 
Seat 2: michasia ($208.13 in chips) 
Seat 3: Iospirate ($176.36 in chips) 
Seat 4: sutata ($100 in chips) 
Seat 5: Dante21b ($109.81 in chips) 
Seat 6: xcinaz ($154.96 in chips) 
Iospirate: posts small blind $0.50
sutata: posts big blind $1
*** HOLE CARDS ***
Dante21b: raises $1.50 to $2.50
xcinaz: folds 
Cositorto: folds 
michasia: folds 
Iospirate: folds 
sutata: folds 
Uncalled bet ($1.50) returned to Dante21b
Dante21b collected $2.50 from pot
Dante21b: doesn't show hand 
*** SUMMARY ***
Total pot $2.50 | Rake $0 
Seat 1: Cositorto folded before Flop (didn't bet)
Seat 2: michasia (button) folded before Flop (didn't bet)
Seat 3: Iospirate (small blind) folded before Flop
Seat 4: sutata (big blind) folded before Flop
Seat 5: Dante21b collected ($2.50)
Seat 6: xcinaz folded before Flop (didn't bet)



PokerStars Hand #254508295176:  Hold'em No Limit ($0.50/$1.00 USD) - 2025/01/22 23:53:45 WET [2025/01/22 18:53:45 ET]
Table 'Ajax III' 6-max Seat #3 is the button
Seat 1: Cositorto ($143.66 in chips) 
Seat 2: michasia ($208.13 in chips) 
Seat 3: Iospirate ($175.86 in chips) 
Seat 4: sutata ($100 in chips) 
Seat 5: Dante21b ($111.31 in chips) 
Seat 6: xcinaz ($154.96 in chips) 
sutata: posts small blind $0.50
Dante21b: posts big blind $1
*** HOLE CARDS ***
xcinaz: raises $1 to $2
Cositorto: folds 
michasia: folds 
Iospirate: folds 
sutata: folds 
Dante21b: folds 
Uncalled bet ($1) returned to xcinaz
xcinaz collected $2.50 from pot
xcinaz: doesn't show hand 
*** SUMMARY ***
Total pot $2.50 | Rake $0 
Seat 1: Cositorto folded before Flop (didn't bet)
Seat 2: michasia folded before Flop (didn't bet)
Seat 3: Iospirate (button) folded before Flop (didn't bet)
Seat 4: sutata (small blind) folded before Flop
Seat 5: Dante21b (big blind) folded before Flop
Seat 6: xcinaz collected ($2.50)



PokerStars Hand #254508298252:  Hold'em No Limit ($0.50/$1.00 USD) - 2025/01/22 23:53:59 WET [2025/01/22 18:53:59 ET]
Table 'Ajax III' 6-max Seat #4 is the button
Seat 1: Cositorto ($143.66 in chips) 
Seat 2: michasia ($208.13 in chips) 
Seat 3: Iospirate ($175.86 in chips) 
Seat 4: sutata ($100 in chips) 
Seat 5: Dante21b ($110.31 in chips) 
Seat 6: xcinaz ($156.46 in chips) 
Dante21b: posts small blind $0.50
xcinaz: posts big blind $1
*** HOLE CARDS ***
Cositorto: folds 
michasia: folds 
Iospirate: folds 
sutata: folds 
Dante21b: folds 
Uncalled bet ($0.50) returned to xcinaz
xcinaz collected $1 from pot
xcinaz: doesn't show hand 
*** SUMMARY ***
Total pot $1 | Rake $0 
Seat 1: Cositorto folded before Flop (didn't bet)
Seat 2: michasia folded before Flop (didn't bet)
Seat 3: Iospirate folded before Flop (didn't bet)
Seat 4: sutata (button) folded before Flop (didn't bet)
Seat 5: Dante21b (small blind) folded before Flop
Seat 6: xcinaz (big blind) collected ($1)



PokerStars Hand #254508300907:  Hold'em No Limit ($0.50/$1.00 USD) - 2025/01/22 23:54:11 WET [2025/01/22 18:54:11 ET]
Table 'Ajax III' 6-max Seat #5 is the button
Seat 1: Cositorto ($143.66 in chips) 
Seat 2: michasia ($208.13 in chips) 
Seat 3: Iospirate ($175.86 in chips) 
Seat 4: sutata ($100 in chips) 
Seat 5: Dante21b ($109.81 in chips) 
Seat 6: xcinaz ($156.96 in chips) 
xcinaz: posts small blind $0.50
Cositorto: posts big blind $1
*** HOLE CARDS ***
michasia: folds 
Iospirate: raises $1 to $2
sutata: folds 
Dante21b: folds 
xcinaz: folds 
Cositorto: raises $7 to $9
Iospirate: raises $7 to $16
Cositorto: calls $7
*** FLOP *** [9c 3h Jd]
Cositorto: checks 
Iospirate: bets $4
Cositorto: calls $4
*** TURN *** [9c 3h Jd] [6c]
Cositorto: checks 
Iospirate: bets $17
Cositorto: calls $17
*** RIVER *** [9c 3h Jd 6c] [Jh]
Cositorto: checks 
Iospirate: bets $106
Cositorto: folds 
Uncalled bet ($106) returned to Iospirate
Iospirate collected $72 from pot
Iospirate: doesn't show hand 
*** SUMMARY ***
Total pot $74.50 | Rake $2.50 
Board [9c 3h Jd 6c Jh]
Seat 1: Cositorto (big blind) folded on the River
Seat 2: michasia folded before Flop (didn't bet)
Seat 3: Iospirate collected ($72)
Seat 4: sutata folded before Flop (didn't bet)
Seat 5: Dante21b (button) folded before Flop (didn't bet)
Seat 6: xcinaz (small blind) folded before Flop



PokerStars Hand #254508322590:  Hold'em No Limit ($0.50/$1.00 USD) - 2025/01/22 23:56:02 WET [2025/01/22 18:56:02 ET]
Table 'Ajax III' 6-max Seat #6 is the button
Seat 1: Cositorto ($106.66 in chips) 
Seat 2: michasia ($208.13 in chips) 
Seat 3: Iospirate ($210.86 in chips) 
Seat 4: sutata ($100 in chips) 
Seat 5: Dante21b ($109.81 in chips) 
Seat 6: xcinaz ($156.46 in chips) 
Cositorto: posts small blind $0.50
michasia: posts big blind $1
*** HOLE CARDS ***
Iospirate: folds 
sutata: folds 
Iospirate leaves the table
Dante21b has timed out
Dante21b: folds 
xcinaz: folds 
Cositorto: folds 
Uncalled bet ($0.50) returned to michasia
michasia collected $1 from pot
michasia: doesn't show hand 
*** SUMMARY ***
Total pot $1 | Rake $0 
Seat 1: Cositorto (small blind) folded before Flop
Seat 2: michasia (big blind) collected ($1)
Seat 3: Iospirate folded before Flop (didn't bet)
Seat 4: sutata folded before Flop (didn't bet)
Seat 5: Dante21b folded before Flop (didn't bet)
Seat 6: xcinaz (button) folded before Flop (didn't bet)



PokerStars Hand #254508327976:  Hold'em No Limit ($0.50/$1.00 USD) - 2025/01/22 23:56:34 WET [2025/01/22 18:56:34 ET]
Table 'Ajax III' 6-max Seat #1 is the button
Seat 1: Cositorto ($106.16 in chips) 
Seat 2: michasia ($208.63 in chips) 
Seat 4: sutata ($100 in chips) 
Seat 5: Dante21b ($109.81 in chips) 
Seat 6: xcinaz ($156.46 in chips) 
michasia: posts small blind $0.50
sutata: posts big blind $1
*** HOLE CARDS ***
Dante21b: raises $1.50 to $2.50
xcinaz: folds 
Cositorto: folds 
michasia: folds 
sutata: calls $1.50
*** FLOP *** [As 7s Ks]
sutata: checks 
Dante21b: checks 
*** TURN *** [As 7s Ks] [4h]
sutata: checks 
Dante21b: bets $2.61
sutata: folds 
Uncalled bet ($2.61) returned to Dante21b
Dante21b collected $5.22 from pot
Dante21b: doesn't show hand 
*** SUMMARY ***
Total pot $5.50 | Rake $0.28 
Board [As 7s Ks 4h]
Seat 1: Cositorto (button) folded before Flop (didn't bet)
Seat 2: michasia (small blind) folded before Flop
Seat 4: sutata (big blind) folded on the Turn
Seat 5: Dante21b collected ($5.22)
Seat 6: xcinaz folded before Flop (didn't bet)



PokerStars Hand #254508337426:  Hold'em No Limit ($0.50/$1.00 USD) - 2025/01/22 23:57:30 WET [2025/01/22 18:57:30 ET]
Table 'Ajax III' 6-max Seat #2 is the button
Seat 1: Cositorto ($106.16 in chips) 
Seat 2: michasia ($208.13 in chips) 
Seat 4: sutata ($100 in chips) 
Seat 5: Dante21b ($112.53 in chips) 
Seat 6: xcinaz ($156.46 in chips) 
sutata: posts small blind $0.50
Dante21b: posts big blind $1
*** HOLE CARDS ***
xcinaz: folds 
Cositorto: raises $1 to $2
michasia: folds 
sutata: folds 
Dante21b: folds 
Uncalled bet ($1) returned to Cositorto
Dante21b leaves the table
Cositorto collected $2.50 from pot
Cositorto: doesn't show hand 
*** SUMMARY ***
Total pot $2.50 | Rake $0 
Seat 1: Cositorto collected ($2.50)
Seat 2: michasia (button) folded before Flop (didn't bet)
Seat 4: sutata (small blind) folded before Flop
Seat 5: Dante21b (big blind) folded before Flop
Seat 6: xcinaz folded before Flop (didn't bet)



PokerStars Hand #254508341740:  Hold'em No Limit ($0.50/$1.00 USD) - 2025/01/22 23:57:55 WET [2025/01/22 18:57:55 ET]
Table 'Ajax III' 6-max Seat #4 is the button
Seat 1: Cositorto ($107.66 in chips) 
Seat 2: michasia ($208.13 in chips) 
Seat 4: sutata ($100 in chips) 
Seat 6: xcinaz ($156.46 in chips) 
xcinaz: posts small blind $0.50
Cositorto: posts big blind $1
*** HOLE CARDS ***
michasia: folds 
michasia leaves the table
sutata: raises $2 to $3
xcinaz: folds 
Cositorto: folds 
Uncalled bet ($2) returned to sutata
sutata collected $2.50 from pot
sutata: doesn't show hand 
*** SUMMARY ***
Total pot $2.50 | Rake $0 
Seat 1: Cositorto (big blind) folded before Flop
Seat 2: michasia folded before Flop (didn't bet)
Seat 4: sutata (button) collected ($2.50)
Seat 6: xcinaz (small blind) folded before Flop



