PokerStars Hand #254281681901:  Hold'em No Limit ($0.50/$1.00 USD) - 2025/01/09 18:48:59 WET [2025/01/09 13:48:59 ET]
Table 'Dagmar II' 6-max Seat #6 is the button
Seat 1: ImaPeppaPig ($100 in chips) 
Seat 2: Burlica2013 ($100 in chips) 
Seat 3: Larrysan21 ($74.90 in chips) 
Seat 4: app1e_j@ck ($10 in chips) 
Seat 5: Gfoer ($100 in chips) 
Seat 6: MAO_DZEDYN_S ($100 in chips) 
ImaPeppaPig: posts small blind $0.50
Burlica2013: posts big blind $1
*** HOLE CARDS ***
Larrysan21: folds 
app1e_j@ck: folds 
Gfoer: folds 
MAO_DZEDYN_S: raises $1.50 to $2.50
ImaPeppaPig: folds 
Burlica2013: folds 
Uncalled bet ($1.50) returned to MAO_DZEDYN_S
MAO_DZEDYN_S collected $2.50 from pot
MAO_DZEDYN_S: doesn't show hand 
*** SUMMARY ***
Total pot $2.50 | Rake $0 
Seat 1: ImaPeppaPig (small blind) folded before Flop
Seat 2: Burlica2013 (big blind) folded before Flop
Seat 3: Larrysan21 folded before Flop (didn't bet)
Seat 4: app1e_j@ck folded before Flop (didn't bet)
Seat 5: Gfoer folded before Flop (didn't bet)
Seat 6: MAO_DZEDYN_S (button) collected ($2.50)



PokerStars Hand #254281692616:  Hold'em No Limit ($0.50/$1.00 USD) - 2025/01/09 18:49:34 WET [2025/01/09 13:49:34 ET]
Table 'Dagmar II' 6-max Seat #1 is the button
Seat 1: ImaPeppaPig ($100 in chips) 
Seat 2: Burlica2013 ($100 in chips) 
Seat 3: Larrysan21 ($74.90 in chips) 
Seat 4: app1e_j@ck ($10 in chips) 
Seat 5: Gfoer ($100 in chips) 
Seat 6: MAO_DZEDYN_S ($101.50 in chips) 
Burlica2013: posts small blind $0.50
Larrysan21: posts big blind $1
*** HOLE CARDS ***
app1e_j@ck: folds 
Gfoer: folds 
MAO_DZEDYN_S: folds 
ImaPeppaPig: raises $1 to $2
Burlica2013: folds 
Larrysan21: folds 
Uncalled bet ($1) returned to ImaPeppaPig
ImaPeppaPig collected $2.50 from pot
ImaPeppaPig: doesn't show hand 
*** SUMMARY ***
Total pot $2.50 | Rake $0 
Seat 1: ImaPeppaPig (button) collected ($2.50)
Seat 2: Burlica2013 (small blind) folded before Flop
Seat 3: Larrysan21 (big blind) folded before Flop
Seat 4: app1e_j@ck folded before Flop (didn't bet)
Seat 5: Gfoer folded before Flop (didn't bet)
Seat 6: MAO_DZEDYN_S folded before Flop (didn't bet)



PokerStars Hand #254281696862:  Hold'em No Limit ($0.50/$1.00 USD) - 2025/01/09 18:49:48 WET [2025/01/09 13:49:48 ET]
Table 'Dagmar II' 6-max Seat #2 is the button
Seat 1: ImaPeppaPig ($101.50 in chips) 
Seat 2: Burlica2013 ($100 in chips) 
Seat 3: Larrysan21 ($73.90 in chips) 
Seat 4: app1e_j@ck ($10 in chips) 
Seat 5: Gfoer ($100 in chips) 
Seat 6: MAO_DZEDYN_S ($101.50 in chips) 
Larrysan21: posts small blind $0.50
app1e_j@ck: posts big blind $1
*** HOLE CARDS ***
Gfoer: raises $1.20 to $2.20
MAO_DZEDYN_S: folds 
ImaPeppaPig: folds 
Burlica2013: folds 
Larrysan21: folds 
app1e_j@ck: folds 
Uncalled bet ($1.20) returned to Gfoer
Gfoer collected $2.50 from pot
Gfoer: doesn't show hand 
*** SUMMARY ***
Total pot $2.50 | Rake $0 
Seat 1: ImaPeppaPig folded before Flop (didn't bet)
Seat 2: Burlica2013 (button) folded before Flop (didn't bet)
Seat 3: Larrysan21 (small blind) folded before Flop
Seat 4: app1e_j@ck (big blind) folded before Flop
Seat 5: Gfoer collected ($2.50)
Seat 6: MAO_DZEDYN_S folded before Flop (didn't bet)



PokerStars Hand #254281705453:  Hold'em No Limit ($0.50/$1.00 USD) - 2025/01/09 18:50:16 WET [2025/01/09 13:50:16 ET]
Table 'Dagmar II' 6-max Seat #3 is the button
Seat 1: ImaPeppaPig ($101.50 in chips) 
Seat 2: Burlica2013 ($100 in chips) 
Seat 3: Larrysan21 ($73.40 in chips) 
Seat 4: app1e_j@ck ($100 in chips) 
Seat 5: Gfoer ($101.50 in chips) 
Seat 6: MAO_DZEDYN_S ($101.50 in chips) 
app1e_j@ck: posts small blind $0.50
Gfoer: posts big blind $1
*** HOLE CARDS ***
MAO_DZEDYN_S: folds 
ImaPeppaPig: folds 
Burlica2013: folds 
Larrysan21: raises $2 to $3
app1e_j@ck: raises $5 to $8
Gfoer: folds 
Larrysan21: calls $5
*** FLOP *** [8d Ad 4d]
app1e_j@ck: checks 
Larrysan21: checks 
*** TURN *** [8d Ad 4d] [9c]
app1e_j@ck: bets $12.11
Larrysan21: folds 
Uncalled bet ($12.11) returned to app1e_j@ck
app1e_j@ck collected $16.15 from pot
app1e_j@ck: doesn't show hand 
*** SUMMARY ***
Total pot $17 | Rake $0.85 
Board [8d Ad 4d 9c]
Seat 1: ImaPeppaPig folded before Flop (didn't bet)
Seat 2: Burlica2013 folded before Flop (didn't bet)
Seat 3: Larrysan21 (button) folded on the Turn
Seat 4: app1e_j@ck (small blind) collected ($16.15)
Seat 5: Gfoer (big blind) folded before Flop
Seat 6: MAO_DZEDYN_S folded before Flop (didn't bet)



PokerStars Hand #254281719853:  Hold'em No Limit ($0.50/$1.00 USD) - 2025/01/09 18:51:03 WET [2025/01/09 13:51:03 ET]
Table 'Dagmar II' 6-max Seat #4 is the button
Seat 1: ImaPeppaPig ($101.50 in chips) 
Seat 2: Burlica2013 ($100 in chips) 
Seat 3: Larrysan21 ($65.40 in chips) 
Seat 4: app1e_j@ck ($108.15 in chips) 
Seat 5: Gfoer ($100.50 in chips) 
Seat 6: MAO_DZEDYN_S ($101.50 in chips) 
Gfoer: posts small blind $0.50
MAO_DZEDYN_S: posts big blind $1
*** HOLE CARDS ***
ImaPeppaPig: raises $1 to $2
Burlica2013: folds 
Burlica2013 leaves the table
Larrysan21: folds 
app1e_j@ck: folds 
AlexPinsk1 joins the table at seat #2 
Gfoer: raises $10 to $12
MAO_DZEDYN_S: folds 
ImaPeppaPig: folds 
Uncalled bet ($10) returned to Gfoer
Gfoer collected $5 from pot
Gfoer: doesn't show hand 
*** SUMMARY ***
Total pot $5 | Rake $0 
Seat 1: ImaPeppaPig folded before Flop
Seat 2: Burlica2013 folded before Flop (didn't bet)
Seat 3: Larrysan21 folded before Flop (didn't bet)
Seat 4: app1e_j@ck (button) folded before Flop (didn't bet)
Seat 5: Gfoer (small blind) collected ($5)
Seat 6: MAO_DZEDYN_S (big blind) folded before Flop



PokerStars Hand #254281729998:  Hold'em No Limit ($0.50/$1.00 USD) - 2025/01/09 18:51:37 WET [2025/01/09 13:51:37 ET]
Table 'Dagmar II' 6-max Seat #5 is the button
Seat 2: AlexPinsk1 ($100 in chips) is sitting out
Seat 1: ImaPeppaPig ($100 in chips) 
Seat 3: Larrysan21 ($65.40 in chips) 
Seat 4: app1e_j@ck ($108.15 in chips) 
Seat 5: Gfoer ($103.50 in chips) 
Seat 6: MAO_DZEDYN_S ($100.50 in chips) 
MAO_DZEDYN_S: posts small blind $0.50
ImaPeppaPig: posts big blind $1
AlexPinsk1: sits out 
*** HOLE CARDS ***
Larrysan21: folds 
app1e_j@ck: folds 
Gfoer: raises $1 to $2
MAO_DZEDYN_S: raises $8.43 to $10.43
ImaPeppaPig: folds 
Gfoer: raises $10.57 to $21
MAO_DZEDYN_S: folds 
Uncalled bet ($10.57) returned to Gfoer
Gfoer collected $21.86 from pot
Gfoer: doesn't show hand 
*** SUMMARY ***
Total pot $21.86 | Rake $0 
Seat 2: AlexPinsk1
Seat 1: ImaPeppaPig (big blind) folded before Flop
Seat 3: Larrysan21 folded before Flop (didn't bet)
Seat 4: app1e_j@ck folded before Flop (didn't bet)
Seat 5: Gfoer (button) collected ($21.86)
Seat 6: MAO_DZEDYN_S (small blind) folded before Flop



PokerStars Hand #254281749168:  Hold'em No Limit ($0.50/$1.00 USD) - 2025/01/09 18:52:40 WET [2025/01/09 13:52:40 ET]
Table 'Dagmar II' 6-max Seat #6 is the button
Seat 1: ImaPeppaPig ($100 in chips) 
Seat 2: AlexPinsk1 ($100 in chips) 
Seat 3: Larrysan21 ($65.40 in chips) 
Seat 4: app1e_j@ck ($108.15 in chips) 
Seat 5: Gfoer ($114.93 in chips) 
Seat 6: MAO_DZEDYN_S ($100 in chips) 
ImaPeppaPig: posts small blind $0.50
AlexPinsk1: posts big blind $1
*** HOLE CARDS ***
Larrysan21: raises $2 to $3
app1e_j@ck: raises $6 to $9
Gfoer: folds 
MAO_DZEDYN_S: folds 
ImaPeppaPig: folds 
AlexPinsk1: folds 
Larrysan21: raises $13 to $22
app1e_j@ck: folds 
Uncalled bet ($13) returned to Larrysan21
Larrysan21 collected $19.50 from pot
*** SUMMARY ***
Total pot $19.50 | Rake $0 
Seat 1: ImaPeppaPig (small blind) folded before Flop
Seat 2: AlexPinsk1 (big blind) folded before Flop
Seat 3: Larrysan21 collected ($19.50)
Seat 4: app1e_j@ck folded before Flop
Seat 5: Gfoer folded before Flop (didn't bet)
Seat 6: MAO_DZEDYN_S (button) folded before Flop (didn't bet)



PokerStars Hand #254281765271:  Hold'em No Limit ($0.50/$1.00 USD) - 2025/01/09 18:53:32 WET [2025/01/09 13:53:32 ET]
Table 'Dagmar II' 6-max Seat #1 is the button
Seat 1: ImaPeppaPig ($100 in chips) 
Seat 2: AlexPinsk1 ($100 in chips) 
Seat 3: Larrysan21 ($75.90 in chips) 
Seat 4: app1e_j@ck ($99.15 in chips) 
Seat 5: Gfoer ($114.93 in chips) 
Seat 6: MAO_DZEDYN_S ($100 in chips) 
AlexPinsk1: posts small blind $0.50
Larrysan21: posts big blind $1
*** HOLE CARDS ***
app1e_j@ck: folds 
Gfoer: folds 
MAO_DZEDYN_S: folds 
ImaPeppaPig: raises $1.50 to $2.50
AlexPinsk1: folds 
Larrysan21: calls $1.50
*** FLOP *** [2c 7s 9d]
Larrysan21: checks 
ImaPeppaPig: checks 
*** TURN *** [2c 7s 9d] [Js]
Larrysan21: bets $5
ImaPeppaPig: folds 
Uncalled bet ($5) returned to Larrysan21
Larrysan21 collected $5.22 from pot
*** SUMMARY ***
Total pot $5.50 | Rake $0.28 
Board [2c 7s 9d Js]
Seat 1: ImaPeppaPig (button) folded on the Turn
Seat 2: AlexPinsk1 (small blind) folded before Flop
Seat 3: Larrysan21 (big blind) collected ($5.22)
Seat 4: app1e_j@ck folded before Flop (didn't bet)
Seat 5: Gfoer folded before Flop (didn't bet)
Seat 6: MAO_DZEDYN_S folded before Flop (didn't bet)



PokerStars Hand #254281774470:  Hold'em No Limit ($0.50/$1.00 USD) - 2025/01/09 18:54:03 WET [2025/01/09 13:54:03 ET]
Table 'Dagmar II' 6-max Seat #2 is the button
Seat 1: ImaPeppaPig ($100 in chips) 
Seat 2: AlexPinsk1 ($100 in chips) 
Seat 3: Larrysan21 ($78.62 in chips) 
Seat 4: app1e_j@ck ($99.15 in chips) 
Seat 5: Gfoer ($114.93 in chips) 
Seat 6: MAO_DZEDYN_S ($100 in chips) 
Larrysan21: posts small blind $0.50
app1e_j@ck: posts big blind $1
*** HOLE CARDS ***
Gfoer: raises $1.20 to $2.20
MAO_DZEDYN_S: folds 
ImaPeppaPig: folds 
AlexPinsk1: folds 
Larrysan21: raises $4.20 to $6.40
app1e_j@ck: folds 
Gfoer: folds 
Uncalled bet ($4.20) returned to Larrysan21
Larrysan21 collected $5.40 from pot
Gfoer leaves the table
*** SUMMARY ***
Total pot $5.40 | Rake $0 
Seat 1: ImaPeppaPig folded before Flop (didn't bet)
Seat 2: AlexPinsk1 (button) folded before Flop (didn't bet)
Seat 3: Larrysan21 (small blind) collected ($5.40)
Seat 4: app1e_j@ck (big blind) folded before Flop
Seat 5: Gfoer folded before Flop
Seat 6: MAO_DZEDYN_S folded before Flop (didn't bet)



PokerStars Hand #254281783299:  Hold'em No Limit ($0.50/$1.00 USD) - 2025/01/09 18:54:32 WET [2025/01/09 13:54:32 ET]
Table 'Dagmar II' 6-max Seat #3 is the button
Seat 1: ImaPeppaPig ($100 in chips) 
Seat 2: AlexPinsk1 ($100 in chips) 
Seat 3: Larrysan21 ($81.82 in chips) 
Seat 4: app1e_j@ck ($98.15 in chips) 
Seat 6: MAO_DZEDYN_S ($100 in chips) 
app1e_j@ck: posts small blind $0.50
MAO_DZEDYN_S: posts big blind $1
*** HOLE CARDS ***
ImaPeppaPig: folds 
AlexPinsk1: raises $1.50 to $2.50
Larrysan21: folds 
app1e_j@ck: folds 
BE4077 joins the table at seat #5 
BE4077 is disconnected 
MAO_DZEDYN_S: raises $9.68 to $12.18
AlexPinsk1: folds 
Uncalled bet ($9.68) returned to MAO_DZEDYN_S
MAO_DZEDYN_S collected $5.50 from pot
MAO_DZEDYN_S: doesn't show hand 
*** SUMMARY ***
Total pot $5.50 | Rake $0 
Seat 1: ImaPeppaPig folded before Flop (didn't bet)
Seat 2: AlexPinsk1 folded before Flop
Seat 3: Larrysan21 (button) folded before Flop (didn't bet)
Seat 4: app1e_j@ck (small blind) folded before Flop
Seat 6: MAO_DZEDYN_S (big blind) collected ($5.50)



PokerStars Hand #254281793586:  Hold'em No Limit ($0.50/$1.00 USD) - 2025/01/09 18:55:05 WET [2025/01/09 13:55:05 ET]
Table 'Dagmar II' 6-max Seat #4 is the button
Seat 5: BE4077 ($70.05 in chips) is sitting out
Seat 1: ImaPeppaPig ($100 in chips) 
Seat 2: AlexPinsk1 ($100 in chips) 
Seat 3: Larrysan21 ($81.82 in chips) 
Seat 4: app1e_j@ck ($97.65 in chips) 
Seat 6: MAO_DZEDYN_S ($103 in chips) 
MAO_DZEDYN_S: posts small blind $0.50
ImaPeppaPig: posts big blind $1
*** HOLE CARDS ***
AlexPinsk1: folds 
Larrysan21: folds 
app1e_j@ck: folds 
MAO_DZEDYN_S: folds 
Uncalled bet ($0.50) returned to ImaPeppaPig
ImaPeppaPig collected $1 from pot
ImaPeppaPig: doesn't show hand 
*** SUMMARY ***
Total pot $1 | Rake $0 
Seat 5: BE4077
Seat 1: ImaPeppaPig (big blind) collected ($1)
Seat 2: AlexPinsk1 folded before Flop (didn't bet)
Seat 3: Larrysan21 folded before Flop (didn't bet)
Seat 4: app1e_j@ck (button) folded before Flop (didn't bet)
Seat 6: MAO_DZEDYN_S (small blind) folded before Flop



PokerStars Hand #254281796207:  Hold'em No Limit ($0.50/$1.00 USD) - 2025/01/09 18:55:18 WET [2025/01/09 13:55:18 ET]
Table 'Dagmar II' 6-max Seat #6 is the button
Seat 1: ImaPeppaPig ($100.50 in chips) 
Seat 2: AlexPinsk1 ($100 in chips) 
Seat 3: Larrysan21 ($81.82 in chips) 
Seat 4: app1e_j@ck ($97.65 in chips) 
Seat 5: BE4077 ($70.05 in chips) 
Seat 6: MAO_DZEDYN_S ($102.50 in chips) 
ImaPeppaPig: posts small blind $0.50
AlexPinsk1: posts big blind $1
BE4077: posts big blind $1
*** HOLE CARDS ***
Larrysan21: folds 
app1e_j@ck: raises $3.50 to $4.50
BE4077: calls $3.50
MAO_DZEDYN_S: folds 
ImaPeppaPig: folds 
AlexPinsk1: folds 
*** FLOP *** [7d As 6d]
app1e_j@ck: bets $3.29
BE4077: calls $3.29
*** TURN *** [7d As 6d] [Kd]
app1e_j@ck: bets $12.67
BE4077: folds 
Uncalled bet ($12.67) returned to app1e_j@ck
app1e_j@ck collected $16.23 from pot
app1e_j@ck: doesn't show hand 
*** SUMMARY ***
Total pot $17.08 | Rake $0.85 
Board [7d As 6d Kd]
Seat 1: ImaPeppaPig (small blind) folded before Flop
Seat 2: AlexPinsk1 (big blind) folded before Flop
Seat 3: Larrysan21 folded before Flop (didn't bet)
Seat 4: app1e_j@ck collected ($16.23)
Seat 5: BE4077 folded on the Turn
Seat 6: MAO_DZEDYN_S (button) folded before Flop (didn't bet)



PokerStars Hand #254281803488:  Hold'em No Limit ($0.50/$1.00 USD) - 2025/01/09 18:55:53 WET [2025/01/09 13:55:53 ET]
Table 'Dagmar II' 6-max Seat #1 is the button
Seat 1: ImaPeppaPig ($100 in chips) 
Seat 2: AlexPinsk1 ($100 in chips) 
Seat 3: Larrysan21 ($81.82 in chips) 
Seat 4: app1e_j@ck ($106.09 in chips) 
Seat 5: BE4077 ($62.26 in chips) 
Seat 6: MAO_DZEDYN_S ($102.50 in chips) 
AlexPinsk1: posts small blind $0.50
Larrysan21: posts big blind $1
*** HOLE CARDS ***
app1e_j@ck: folds 
BE4077: calls $1
MAO_DZEDYN_S: folds 
ImaPeppaPig: folds 
AlexPinsk1: raises $3.50 to $4.50
Larrysan21: folds 
BE4077: calls $3.50
*** FLOP *** [5s Ac 4s]
AlexPinsk1: checks 
BE4077: bets $5.75
AlexPinsk1: folds 
Uncalled bet ($5.75) returned to BE4077
BE4077 collected $9.50 from pot
*** SUMMARY ***
Total pot $10 | Rake $0.50 
Board [5s Ac 4s]
Seat 1: ImaPeppaPig (button) folded before Flop (didn't bet)
Seat 2: AlexPinsk1 (small blind) folded on the Flop
Seat 3: Larrysan21 (big blind) folded before Flop
Seat 4: app1e_j@ck folded before Flop (didn't bet)
Seat 5: BE4077 collected ($9.50)
Seat 6: MAO_DZEDYN_S folded before Flop (didn't bet)



PokerStars Hand #254281814067:  Hold'em No Limit ($0.50/$1.00 USD) - 2025/01/09 18:56:43 WET [2025/01/09 13:56:43 ET]
Table 'Dagmar II' 6-max Seat #2 is the button
Seat 1: ImaPeppaPig ($100 in chips) 
Seat 2: AlexPinsk1 ($100 in chips) 
Seat 3: Larrysan21 ($80.82 in chips) 
Seat 4: app1e_j@ck ($106.09 in chips) 
Seat 5: BE4077 ($67.26 in chips) 
Seat 6: MAO_DZEDYN_S ($102.50 in chips) 
Larrysan21: posts small blind $0.50
app1e_j@ck: posts big blind $1
*** HOLE CARDS ***
BE4077: calls $1
MAO_DZEDYN_S: folds 
ImaPeppaPig: folds 
AlexPinsk1: folds 
Larrysan21: folds 
app1e_j@ck: checks 
*** FLOP *** [4s 7c Qs]
app1e_j@ck: checks 
BE4077: bets $1.19
app1e_j@ck: calls $1.19
*** TURN *** [4s 7c Qs] [7h]
app1e_j@ck: checks 
BE4077: bets $3.32
app1e_j@ck: calls $3.32
*** RIVER *** [4s 7c Qs 7h] [6c]
app1e_j@ck has timed out
app1e_j@ck: checks 
BE4077: checks 
*** SHOW DOWN ***
app1e_j@ck: shows [Ts 3s] (a pair of Sevens)
BE4077: shows [Qd 8d] (two pair, Queens and Sevens)
BE4077 collected $10.94 from pot
*** SUMMARY ***
Total pot $11.52 | Rake $0.58 
Board [4s 7c Qs 7h 6c]
Seat 1: ImaPeppaPig folded before Flop (didn't bet)
Seat 2: AlexPinsk1 (button) folded before Flop (didn't bet)
Seat 3: Larrysan21 (small blind) folded before Flop
Seat 4: app1e_j@ck (big blind) showed [Ts 3s] and lost with a pair of Sevens
Seat 5: BE4077 showed [Qd 8d] and won ($10.94) with two pair, Queens and Sevens
Seat 6: MAO_DZEDYN_S folded before Flop (didn't bet)



PokerStars Hand #254281835089:  Hold'em No Limit ($0.50/$1.00 USD) - 2025/01/09 18:58:21 WET [2025/01/09 13:58:21 ET]
Table 'Dagmar II' 6-max Seat #3 is the button
Seat 1: ImaPeppaPig ($100 in chips) 
Seat 2: AlexPinsk1 ($100 in chips) 
Seat 3: Larrysan21 ($80.32 in chips) 
Seat 4: app1e_j@ck ($100.58 in chips) 
Seat 5: BE4077 ($72.69 in chips) 
Seat 6: MAO_DZEDYN_S ($102.50 in chips) 
app1e_j@ck: posts small blind $0.50
BE4077: posts big blind $1
*** HOLE CARDS ***
MAO_DZEDYN_S: folds 
ImaPeppaPig: folds 
AlexPinsk1: folds 
Larrysan21: folds 
app1e_j@ck: raises $2 to $3
BE4077: calls $2
*** FLOP *** [9h 7s Jd]
app1e_j@ck: bets $5.38
BE4077: calls $5.38
*** TURN *** [9h 7s Jd] [9c]
app1e_j@ck: bets $7.50
BE4077: calls $7.50
*** RIVER *** [9h 7s Jd 9c] [Qs]
app1e_j@ck: bets $9.96
BE4077: raises $46.85 to $56.81 and is all-in
app1e_j@ck has timed out
app1e_j@ck: folds 
Uncalled bet ($46.85) returned to BE4077
BE4077 collected $49.18 from pot
*** SUMMARY ***
Total pot $51.68 | Rake $2.50 
Board [9h 7s Jd 9c Qs]
Seat 1: ImaPeppaPig folded before Flop (didn't bet)
Seat 2: AlexPinsk1 folded before Flop (didn't bet)
Seat 3: Larrysan21 (button) folded before Flop (didn't bet)
Seat 4: app1e_j@ck (small blind) folded on the River
Seat 5: BE4077 (big blind) collected ($49.18)
Seat 6: MAO_DZEDYN_S folded before Flop (didn't bet)



PokerStars Hand #254281849148:  Hold'em No Limit ($0.50/$1.00 USD) - 2025/01/09 18:59:27 WET [2025/01/09 13:59:27 ET]
Table 'Dagmar II' 6-max Seat #4 is the button
Seat 1: ImaPeppaPig ($100 in chips) 
Seat 2: AlexPinsk1 ($100 in chips) 
Seat 3: Larrysan21 ($80.32 in chips) 
Seat 4: app1e_j@ck ($74.74 in chips) 
Seat 5: BE4077 ($96.03 in chips) 
Seat 6: MAO_DZEDYN_S ($102.50 in chips) 
BE4077: posts small blind $0.50
MAO_DZEDYN_S: posts big blind $1
*** HOLE CARDS ***
ImaPeppaPig: folds 
AlexPinsk1: folds 
Larrysan21: folds 
app1e_j@ck: raises $1.50 to $2.50
BE4077: calls $2
MAO_DZEDYN_S: folds 
*** FLOP *** [9h Td Qh]
BE4077: checks 
app1e_j@ck: checks 
*** TURN *** [9h Td Qh] [6h]
BE4077: checks 
app1e_j@ck: checks 
*** RIVER *** [9h Td Qh 6h] [6d]
BE4077: checks 
app1e_j@ck: bets $3.80
BE4077: calls $3.80
*** SHOW DOWN ***
app1e_j@ck: shows [5s 7s] (a pair of Sixes)
BE4077: shows [Tc Jh] (two pair, Tens and Sixes)
BE4077 collected $12.92 from pot
*** SUMMARY ***
Total pot $13.60 | Rake $0.68 
Board [9h Td Qh 6h 6d]
Seat 1: ImaPeppaPig folded before Flop (didn't bet)
Seat 2: AlexPinsk1 folded before Flop (didn't bet)
Seat 3: Larrysan21 folded before Flop (didn't bet)
Seat 4: app1e_j@ck (button) showed [5s 7s] and lost with a pair of Sixes
Seat 5: BE4077 (small blind) showed [Tc Jh] and won ($12.92) with two pair, Tens and Sixes
Seat 6: MAO_DZEDYN_S (big blind) folded before Flop



PokerStars Hand #254281856898:  Hold'em No Limit ($0.50/$1.00 USD) - 2025/01/09 19:00:03 WET [2025/01/09 14:00:03 ET]
Table 'Dagmar II' 6-max Seat #5 is the button
Seat 1: ImaPeppaPig ($100 in chips) 
Seat 2: AlexPinsk1 ($100 in chips) 
Seat 3: Larrysan21 ($80.32 in chips) 
Seat 4: app1e_j@ck ($68.44 in chips) 
Seat 5: BE4077 ($102.65 in chips) 
Seat 6: MAO_DZEDYN_S ($101.50 in chips) 
MAO_DZEDYN_S: posts small blind $0.50
ImaPeppaPig: posts big blind $1
*** HOLE CARDS ***
AlexPinsk1: folds 
Larrysan21: folds 
app1e_j@ck: folds 
BE4077: calls $1
MAO_DZEDYN_S: folds 
ImaPeppaPig: checks 
*** FLOP *** [Td 9d 9h]
ImaPeppaPig: checks 
BE4077: checks 
*** TURN *** [Td 9d 9h] [2h]
ImaPeppaPig: checks 
BE4077: checks 
*** RIVER *** [Td 9d 9h 2h] [5d]
ImaPeppaPig: checks 
BE4077: checks 
*** SHOW DOWN ***
ImaPeppaPig: shows [Kd 4h] (a pair of Nines)
BE4077: shows [Ks 5s] (two pair, Nines and Fives)
BE4077 collected $2.38 from pot
*** SUMMARY ***
Total pot $2.50 | Rake $0.12 
Board [Td 9d 9h 2h 5d]
Seat 1: ImaPeppaPig (big blind) showed [Kd 4h] and lost with a pair of Nines
Seat 2: AlexPinsk1 folded before Flop (didn't bet)
Seat 3: Larrysan21 folded before Flop (didn't bet)
Seat 4: app1e_j@ck folded before Flop (didn't bet)
Seat 5: BE4077 (button) showed [Ks 5s] and won ($2.38) with two pair, Nines and Fives
Seat 6: MAO_DZEDYN_S (small blind) folded before Flop



PokerStars Hand #254281864206:  Hold'em No Limit ($0.50/$1.00 USD) - 2025/01/09 19:00:35 WET [2025/01/09 14:00:35 ET]
Table 'Dagmar II' 6-max Seat #6 is the button
Seat 1: ImaPeppaPig ($100 in chips) 
Seat 2: AlexPinsk1 ($100 in chips) 
Seat 3: Larrysan21 ($80.32 in chips) 
Seat 4: app1e_j@ck ($68.44 in chips) 
Seat 5: BE4077 ($104.03 in chips) 
Seat 6: MAO_DZEDYN_S ($101 in chips) 
ImaPeppaPig: posts small blind $0.50
AlexPinsk1: posts big blind $1
*** HOLE CARDS ***
Larrysan21: raises $3 to $4
app1e_j@ck: folds 
BE4077: folds 
MAO_DZEDYN_S: folds 
ImaPeppaPig: folds 
AlexPinsk1: calls $3
*** FLOP *** [2d 7s Ks]
AlexPinsk1: checks 
Larrysan21: bets $6.04
AlexPinsk1: folds 
Uncalled bet ($6.04) returned to Larrysan21
Larrysan21 collected $8.08 from pot
*** SUMMARY ***
Total pot $8.50 | Rake $0.42 
Board [2d 7s Ks]
Seat 1: ImaPeppaPig (small blind) folded before Flop
Seat 2: AlexPinsk1 (big blind) folded on the Flop
Seat 3: Larrysan21 collected ($8.08)
Seat 4: app1e_j@ck folded before Flop (didn't bet)
Seat 5: BE4077 folded before Flop (didn't bet)
Seat 6: MAO_DZEDYN_S (button) folded before Flop (didn't bet)



PokerStars Hand #254281872414:  Hold'em No Limit ($0.50/$1.00 USD) - 2025/01/09 19:01:09 WET [2025/01/09 14:01:09 ET]
Table 'Dagmar II' 6-max Seat #1 is the button
Seat 1: ImaPeppaPig ($100 in chips) 
Seat 2: AlexPinsk1 ($100 in chips) 
Seat 3: Larrysan21 ($84.40 in chips) 
Seat 4: app1e_j@ck ($68.44 in chips) 
Seat 5: BE4077 ($104.03 in chips) 
Seat 6: MAO_DZEDYN_S ($101 in chips) 
AlexPinsk1: posts small blind $0.50
Larrysan21: posts big blind $1
*** HOLE CARDS ***
app1e_j@ck: folds 
BE4077: calls $1
MAO_DZEDYN_S: folds 
ImaPeppaPig: raises $3 to $4
AlexPinsk1: folds 
Larrysan21: calls $3
BE4077: folds 
*** FLOP *** [Ah 9c 6c]
Larrysan21: checks 
ImaPeppaPig: bets $2.80
Larrysan21: raises $9.20 to $12
ImaPeppaPig: folds 
Uncalled bet ($9.20) returned to Larrysan21
Larrysan21 collected $14.34 from pot
*** SUMMARY ***
Total pot $15.10 | Rake $0.76 
Board [Ah 9c 6c]
Seat 1: ImaPeppaPig (button) folded on the Flop
Seat 2: AlexPinsk1 (small blind) folded before Flop
Seat 3: Larrysan21 (big blind) collected ($14.34)
Seat 4: app1e_j@ck folded before Flop (didn't bet)
Seat 5: BE4077 folded before Flop
Seat 6: MAO_DZEDYN_S folded before Flop (didn't bet)



PokerStars Hand #254281881527:  Hold'em No Limit ($0.50/$1.00 USD) - 2025/01/09 19:01:44 WET [2025/01/09 14:01:44 ET]
Table 'Dagmar II' 6-max Seat #2 is the button
Seat 1: ImaPeppaPig ($100 in chips) 
Seat 2: AlexPinsk1 ($100 in chips) 
Seat 3: Larrysan21 ($91.94 in chips) 
Seat 4: app1e_j@ck ($68.44 in chips) 
Seat 5: BE4077 ($103.03 in chips) 
Seat 6: MAO_DZEDYN_S ($101 in chips) 
Larrysan21: posts small blind $0.50
app1e_j@ck: posts big blind $1
*** HOLE CARDS ***
BE4077: calls $1
MAO_DZEDYN_S: folds 
ImaPeppaPig: folds 
AlexPinsk1: folds 
Larrysan21: folds 
app1e_j@ck: raises $4.50 to $5.50
BE4077: calls $4.50
*** FLOP *** [2s 4s 3h]
app1e_j@ck: checks 
BE4077: checks 
*** TURN *** [2s 4s 3h] [2c]
app1e_j@ck has timed out
app1e_j@ck: checks 
BE4077: checks 
*** RIVER *** [2s 4s 3h 2c] [8d]
app1e_j@ck: checks 
BE4077: checks 
*** SHOW DOWN ***
app1e_j@ck: shows [Qd Ac] (a pair of Deuces)
BE4077: mucks hand 
app1e_j@ck collected $10.92 from pot
*** SUMMARY ***
Total pot $11.50 | Rake $0.58 
Board [2s 4s 3h 2c 8d]
Seat 1: ImaPeppaPig folded before Flop (didn't bet)
Seat 2: AlexPinsk1 (button) folded before Flop (didn't bet)
Seat 3: Larrysan21 (small blind) folded before Flop
Seat 4: app1e_j@ck (big blind) showed [Qd Ac] and won ($10.92) with a pair of Deuces
Seat 5: BE4077 mucked
Seat 6: MAO_DZEDYN_S folded before Flop (didn't bet)



PokerStars Hand #254281898922:  Hold'em No Limit ($0.50/$1.00 USD) - 2025/01/09 19:02:41 WET [2025/01/09 14:02:41 ET]
Table 'Dagmar II' 6-max Seat #3 is the button
Seat 1: ImaPeppaPig ($100 in chips) 
Seat 2: AlexPinsk1 ($100 in chips) 
Seat 3: Larrysan21 ($91.44 in chips) 
Seat 4: app1e_j@ck ($73.86 in chips) 
Seat 5: BE4077 ($97.53 in chips) 
Seat 6: MAO_DZEDYN_S ($101 in chips) 
app1e_j@ck: posts small blind $0.50
BE4077: posts big blind $1
*** HOLE CARDS ***
MAO_DZEDYN_S: raises $1.25 to $2.25
ImaPeppaPig: folds 
AlexPinsk1: folds 
Larrysan21: folds 
app1e_j@ck: folds 
BE4077: calls $1.25
*** FLOP *** [Qc Ts 8c]
BE4077: checks 
MAO_DZEDYN_S: checks 
*** TURN *** [Qc Ts 8c] [Ks]
BE4077: checks 
MAO_DZEDYN_S: checks 
*** RIVER *** [Qc Ts 8c Ks] [7h]
BE4077: checks 
MAO_DZEDYN_S: checks 
*** SHOW DOWN ***
BE4077: shows [Ah Qh] (a pair of Queens)
MAO_DZEDYN_S: mucks hand 
BE4077 collected $4.75 from pot
*** SUMMARY ***
Total pot $5 | Rake $0.25 
Board [Qc Ts 8c Ks 7h]
Seat 1: ImaPeppaPig folded before Flop (didn't bet)
Seat 2: AlexPinsk1 folded before Flop (didn't bet)
Seat 3: Larrysan21 (button) folded before Flop (didn't bet)
Seat 4: app1e_j@ck (small blind) folded before Flop
Seat 5: BE4077 (big blind) showed [Ah Qh] and won ($4.75) with a pair of Queens
Seat 6: MAO_DZEDYN_S mucked



PokerStars Hand #254281910269:  Hold'em No Limit ($0.50/$1.00 USD) - 2025/01/09 19:03:19 WET [2025/01/09 14:03:19 ET]
Table 'Dagmar II' 6-max Seat #4 is the button
Seat 1: ImaPeppaPig ($100 in chips) 
Seat 2: AlexPinsk1 ($100 in chips) 
Seat 3: Larrysan21 ($91.44 in chips) 
Seat 4: app1e_j@ck ($73.36 in chips) 
Seat 5: BE4077 ($100.03 in chips) 
Seat 6: MAO_DZEDYN_S ($100 in chips) 
BE4077: posts small blind $0.50
MAO_DZEDYN_S: posts big blind $1
*** HOLE CARDS ***
ImaPeppaPig: folds 
AlexPinsk1: folds 
Larrysan21: folds 
app1e_j@ck: folds 
BE4077: calls $0.50
MAO_DZEDYN_S: checks 
*** FLOP *** [2s As 4d]
BE4077: checks 
MAO_DZEDYN_S: bets $1
BE4077: folds 
Uncalled bet ($1) returned to MAO_DZEDYN_S
MAO_DZEDYN_S collected $1.90 from pot
MAO_DZEDYN_S: doesn't show hand 
*** SUMMARY ***
Total pot $2 | Rake $0.10 
Board [2s As 4d]
Seat 1: ImaPeppaPig folded before Flop (didn't bet)
Seat 2: AlexPinsk1 folded before Flop (didn't bet)
Seat 3: Larrysan21 folded before Flop (didn't bet)
Seat 4: app1e_j@ck (button) folded before Flop (didn't bet)
Seat 5: BE4077 (small blind) folded on the Flop
Seat 6: MAO_DZEDYN_S (big blind) collected ($1.90)



PokerStars Hand #254281917164:  Hold'em No Limit ($0.50/$1.00 USD) - 2025/01/09 19:03:42 WET [2025/01/09 14:03:42 ET]
Table 'Dagmar II' 6-max Seat #5 is the button
Seat 1: ImaPeppaPig ($100 in chips) 
Seat 2: AlexPinsk1 ($100 in chips) 
Seat 3: Larrysan21 ($91.44 in chips) 
Seat 4: app1e_j@ck ($73.36 in chips) 
Seat 5: BE4077 ($99.03 in chips) 
Seat 6: MAO_DZEDYN_S ($100.90 in chips) 
MAO_DZEDYN_S: posts small blind $0.50
ImaPeppaPig: posts big blind $1
*** HOLE CARDS ***
AlexPinsk1: folds 
Larrysan21: raises $3 to $4
app1e_j@ck: folds 
BE4077: folds 
MAO_DZEDYN_S: folds 
ImaPeppaPig: folds 
Uncalled bet ($3) returned to Larrysan21
Larrysan21 collected $2.50 from pot
*** SUMMARY ***
Total pot $2.50 | Rake $0 
Seat 1: ImaPeppaPig (big blind) folded before Flop
Seat 2: AlexPinsk1 folded before Flop (didn't bet)
Seat 3: Larrysan21 collected ($2.50)
Seat 4: app1e_j@ck folded before Flop (didn't bet)
Seat 5: BE4077 (button) folded before Flop (didn't bet)
Seat 6: MAO_DZEDYN_S (small blind) folded before Flop



PokerStars Hand #254281922710:  Hold'em No Limit ($0.50/$1.00 USD) - 2025/01/09 19:04:01 WET [2025/01/09 14:04:01 ET]
Table 'Dagmar II' 6-max Seat #6 is the button
Seat 1: ImaPeppaPig ($100 in chips) 
Seat 2: AlexPinsk1 ($100 in chips) 
Seat 3: Larrysan21 ($92.94 in chips) 
Seat 4: app1e_j@ck ($73.36 in chips) 
Seat 5: BE4077 ($99.03 in chips) 
Seat 6: MAO_DZEDYN_S ($100.40 in chips) 
ImaPeppaPig: posts small blind $0.50
AlexPinsk1: posts big blind $1
*** HOLE CARDS ***
Larrysan21: raises $2 to $3
app1e_j@ck: raises $6 to $9
BE4077: folds 
MAO_DZEDYN_S: folds 
ImaPeppaPig: folds 
AlexPinsk1: folds 
Larrysan21: calls $6
*** FLOP *** [Qs 4d Qh]
Larrysan21: checks 
app1e_j@ck: bets $6.11
Larrysan21: folds 
Uncalled bet ($6.11) returned to app1e_j@ck
app1e_j@ck collected $18.52 from pot
app1e_j@ck: doesn't show hand 
*** SUMMARY ***
Total pot $19.50 | Rake $0.98 
Board [Qs 4d Qh]
Seat 1: ImaPeppaPig (small blind) folded before Flop
Seat 2: AlexPinsk1 (big blind) folded before Flop
Seat 3: Larrysan21 folded on the Flop
Seat 4: app1e_j@ck collected ($18.52)
Seat 5: BE4077 folded before Flop (didn't bet)
Seat 6: MAO_DZEDYN_S (button) folded before Flop (didn't bet)



PokerStars Hand #254281933795:  Hold'em No Limit ($0.50/$1.00 USD) - 2025/01/09 19:04:37 WET [2025/01/09 14:04:37 ET]
Table 'Dagmar II' 6-max Seat #1 is the button
Seat 1: ImaPeppaPig ($100 in chips) 
Seat 2: AlexPinsk1 ($100 in chips) 
Seat 3: Larrysan21 ($83.94 in chips) 
Seat 4: app1e_j@ck ($82.88 in chips) 
Seat 5: BE4077 ($99.03 in chips) 
Seat 6: MAO_DZEDYN_S ($100.40 in chips) 
AlexPinsk1: posts small blind $0.50
Larrysan21: posts big blind $1
*** HOLE CARDS ***
app1e_j@ck: folds 
BE4077: calls $1
MAO_DZEDYN_S: raises $3.25 to $4.25
ImaPeppaPig: folds 
AlexPinsk1: folds 
Larrysan21: raises $6.25 to $10.50
BE4077: folds 
MAO_DZEDYN_S: raises $16.86 to $27.36
Larrysan21: calls $16.86
*** FLOP *** [8d 6d 6h]
Larrysan21: bets $56.58 and is all-in
MAO_DZEDYN_S: calls $56.58
*** TURN *** [8d 6d 6h] [Ad]
*** RIVER *** [8d 6d 6h Ad] [9c]
*** SHOW DOWN ***
Larrysan21: shows [4s 4h] (two pair, Sixes and Fours)
MAO_DZEDYN_S: shows [Ks Kd] (two pair, Kings and Sixes)
MAO_DZEDYN_S collected $166.88 from pot
*** SUMMARY ***
Total pot $169.38 | Rake $2.50 
Board [8d 6d 6h Ad 9c]
Seat 1: ImaPeppaPig (button) folded before Flop (didn't bet)
Seat 2: AlexPinsk1 (small blind) folded before Flop
Seat 3: Larrysan21 (big blind) showed [4s 4h] and lost with two pair, Sixes and Fours
Seat 4: app1e_j@ck folded before Flop (didn't bet)
Seat 5: BE4077 folded before Flop
Seat 6: MAO_DZEDYN_S showed [Ks Kd] and won ($166.88) with two pair, Kings and Sixes



PokerStars Hand #254281954761:  Hold'em No Limit ($0.50/$1.00 USD) - 2025/01/09 19:05:46 WET [2025/01/09 14:05:46 ET]
Table 'Dagmar II' 6-max Seat #2 is the button
Seat 3: Larrysan21 ($0 in chips) is sitting out
Seat 1: ImaPeppaPig ($100 in chips) 
Seat 2: AlexPinsk1 ($100 in chips) 
Seat 4: app1e_j@ck ($100 in chips) 
Seat 5: BE4077 ($98.03 in chips) 
Seat 6: MAO_DZEDYN_S ($183.34 in chips) 
app1e_j@ck: posts small blind $0.50
BE4077: posts big blind $1
*** HOLE CARDS ***
Larrysan21 is disconnected 
MAO_DZEDYN_S: raises $1.25 to $2.25
ImaPeppaPig: raises $4.75 to $7
AlexPinsk1: folds 
app1e_j@ck: folds 
BE4077: folds 
MAO_DZEDYN_S: folds 
Uncalled bet ($4.75) returned to ImaPeppaPig
ImaPeppaPig collected $6 from pot
ImaPeppaPig: doesn't show hand 
*** SUMMARY ***
Total pot $6 | Rake $0 
Seat 3: Larrysan21
Seat 1: ImaPeppaPig collected ($6)
Seat 2: AlexPinsk1 (button) folded before Flop (didn't bet)
Seat 4: app1e_j@ck (small blind) folded before Flop
Seat 5: BE4077 (big blind) folded before Flop
Seat 6: MAO_DZEDYN_S folded before Flop



PokerStars Hand #254281965349:  Hold'em No Limit ($0.50/$1.00 USD) - 2025/01/09 19:06:21 WET [2025/01/09 14:06:21 ET]
Table 'Dagmar II' 6-max Seat #4 is the button
Seat 3: Larrysan21 ($0 in chips) is sitting out
Seat 1: ImaPeppaPig ($103.75 in chips) 
Seat 2: AlexPinsk1 ($100 in chips) 
Seat 4: app1e_j@ck ($99.50 in chips) 
Seat 5: BE4077 ($97.03 in chips) 
Seat 6: MAO_DZEDYN_S ($181.09 in chips) 
BE4077: posts small blind $0.50
MAO_DZEDYN_S: posts big blind $1
*** HOLE CARDS ***
ImaPeppaPig: folds 
AlexPinsk1: folds 
app1e_j@ck: raises $1.50 to $2.50
BE4077: calls $2
MAO_DZEDYN_S: folds 
*** FLOP *** [5h Tc Ts]
BE4077: checks 
app1e_j@ck: bets $1.88
BE4077: folds 
Uncalled bet ($1.88) returned to app1e_j@ck
app1e_j@ck collected $5.70 from pot
app1e_j@ck: doesn't show hand 
*** SUMMARY ***
Total pot $6 | Rake $0.30 
Board [5h Tc Ts]
Seat 3: Larrysan21
Seat 1: ImaPeppaPig folded before Flop (didn't bet)
Seat 2: AlexPinsk1 folded before Flop (didn't bet)
Seat 4: app1e_j@ck (button) collected ($5.70)
Seat 5: BE4077 (small blind) folded on the Flop
Seat 6: MAO_DZEDYN_S (big blind) folded before Flop



PokerStars Hand #254281973570:  Hold'em No Limit ($0.50/$1.00 USD) - 2025/01/09 19:06:47 WET [2025/01/09 14:06:47 ET]
Table 'Dagmar II' 6-max Seat #5 is the button
Seat 3: Larrysan21 ($0 in chips) is sitting out
Seat 1: ImaPeppaPig ($103.75 in chips) 
Seat 2: AlexPinsk1 ($100 in chips) 
Seat 4: app1e_j@ck ($102.70 in chips) 
Seat 5: BE4077 ($94.53 in chips) 
Seat 6: MAO_DZEDYN_S ($180.09 in chips) 
MAO_DZEDYN_S: posts small blind $0.50
ImaPeppaPig: posts big blind $1
*** HOLE CARDS ***
AlexPinsk1: folds 
app1e_j@ck: folds 
BE4077: calls $1
MAO_DZEDYN_S: folds 
ImaPeppaPig: checks 
*** FLOP *** [7s Qh Ad]
ImaPeppaPig: checks 
BE4077: checks 
*** TURN *** [7s Qh Ad] [Jh]
ImaPeppaPig: bets $1.24
BE4077: folds 
Uncalled bet ($1.24) returned to ImaPeppaPig
ImaPeppaPig collected $2.38 from pot
ImaPeppaPig: doesn't show hand 
*** SUMMARY ***
Total pot $2.50 | Rake $0.12 
Board [7s Qh Ad Jh]
Seat 3: Larrysan21
Seat 1: ImaPeppaPig (big blind) collected ($2.38)
Seat 2: AlexPinsk1 folded before Flop (didn't bet)
Seat 4: app1e_j@ck folded before Flop (didn't bet)
Seat 5: BE4077 (button) folded on the Turn
Seat 6: MAO_DZEDYN_S (small blind) folded before Flop



PokerStars Hand #254281980389:  Hold'em No Limit ($0.50/$1.00 USD) - 2025/01/09 19:07:10 WET [2025/01/09 14:07:10 ET]
Table 'Dagmar II' 6-max Seat #6 is the button
Seat 3: Larrysan21 ($0 in chips) is sitting out
Seat 1: ImaPeppaPig ($105.13 in chips) 
Seat 2: AlexPinsk1 ($100 in chips) 
Seat 4: app1e_j@ck ($102.70 in chips) 
Seat 5: BE4077 ($93.53 in chips) 
Seat 6: MAO_DZEDYN_S ($179.59 in chips) 
ImaPeppaPig: posts small blind $0.50
AlexPinsk1: posts big blind $1
*** HOLE CARDS ***
app1e_j@ck: raises $1.50 to $2.50
BE4077: calls $2.50
MAO_DZEDYN_S: folds 
ImaPeppaPig: raises $11.50 to $14
AlexPinsk1: folds 
app1e_j@ck: folds 
BE4077: folds 
Uncalled bet ($11.50) returned to ImaPeppaPig
ImaPeppaPig collected $8.50 from pot
ImaPeppaPig: doesn't show hand 
*** SUMMARY ***
Total pot $8.50 | Rake $0 
Seat 3: Larrysan21
Seat 1: ImaPeppaPig (small blind) collected ($8.50)
Seat 2: AlexPinsk1 (big blind) folded before Flop
Seat 4: app1e_j@ck folded before Flop
Seat 5: BE4077 folded before Flop
Seat 6: MAO_DZEDYN_S (button) folded before Flop (didn't bet)



PokerStars Hand #254281993384:  Hold'em No Limit ($0.50/$1.00 USD) - 2025/01/09 19:07:52 WET [2025/01/09 14:07:52 ET]
Table 'Dagmar II' 6-max Seat #1 is the button
Seat 3: Larrysan21 ($0 in chips) is sitting out
Seat 1: ImaPeppaPig ($111.13 in chips) 
Seat 2: AlexPinsk1 ($100 in chips) 
Seat 4: app1e_j@ck ($100.20 in chips) 
Seat 5: BE4077 ($91.03 in chips) 
Seat 6: MAO_DZEDYN_S ($179.59 in chips) 
AlexPinsk1: posts small blind $0.50
app1e_j@ck: posts big blind $1
*** HOLE CARDS ***
BE4077: folds 
MAO_DZEDYN_S: folds 
ImaPeppaPig: folds 
AlexPinsk1: raises $2 to $3
app1e_j@ck: raises $6 to $9
AlexPinsk1: folds 
Uncalled bet ($6) returned to app1e_j@ck
app1e_j@ck collected $6 from pot
app1e_j@ck: doesn't show hand 
*** SUMMARY ***
Total pot $6 | Rake $0 
Seat 3: Larrysan21
Seat 1: ImaPeppaPig (button) folded before Flop (didn't bet)
Seat 2: AlexPinsk1 (small blind) folded before Flop
Seat 4: app1e_j@ck (big blind) collected ($6)
Seat 5: BE4077 folded before Flop (didn't bet)
Seat 6: MAO_DZEDYN_S folded before Flop (didn't bet)



PokerStars Hand #254282004215:  Hold'em No Limit ($0.50/$1.00 USD) - 2025/01/09 19:08:28 WET [2025/01/09 14:08:28 ET]
Table 'Dagmar II' 6-max Seat #2 is the button
Seat 3: Larrysan21 ($0 in chips) is sitting out
Seat 1: ImaPeppaPig ($111.13 in chips) 
Seat 2: AlexPinsk1 ($100 in chips) 
Seat 4: app1e_j@ck ($103.20 in chips) 
Seat 5: BE4077 ($91.03 in chips) 
Seat 6: MAO_DZEDYN_S ($179.59 in chips) 
app1e_j@ck: posts small blind $0.50
BE4077: posts big blind $1
*** HOLE CARDS ***
MAO_DZEDYN_S: raises $1.25 to $2.25
ImaPeppaPig: folds 
AlexPinsk1: folds 
app1e_j@ck: folds 
BE4077: folds 
Uncalled bet ($1.25) returned to MAO_DZEDYN_S
MAO_DZEDYN_S collected $2.50 from pot
MAO_DZEDYN_S: doesn't show hand 
*** SUMMARY ***
Total pot $2.50 | Rake $0 
Seat 3: Larrysan21
Seat 1: ImaPeppaPig folded before Flop (didn't bet)
Seat 2: AlexPinsk1 (button) folded before Flop (didn't bet)
Seat 4: app1e_j@ck (small blind) folded before Flop
Seat 5: BE4077 (big blind) folded before Flop
Seat 6: MAO_DZEDYN_S collected ($2.50)



PokerStars Hand #254282011184:  Hold'em No Limit ($0.50/$1.00 USD) - 2025/01/09 19:08:51 WET [2025/01/09 14:08:51 ET]
Table 'Dagmar II' 6-max Seat #4 is the button
Seat 3: Larrysan21 ($0 in chips) is sitting out
Seat 1: ImaPeppaPig ($111.13 in chips) 
Seat 2: AlexPinsk1 ($100 in chips) 
Seat 4: app1e_j@ck ($102.70 in chips) 
Seat 5: BE4077 ($90.03 in chips) 
Seat 6: MAO_DZEDYN_S ($181.09 in chips) 
BE4077: posts small blind $0.50
MAO_DZEDYN_S: posts big blind $1
*** HOLE CARDS ***
ImaPeppaPig: folds 
AlexPinsk1: folds 
app1e_j@ck: raises $1.50 to $2.50
BE4077: calls $2
MAO_DZEDYN_S: raises $11.18 to $13.68
app1e_j@ck: folds 
BE4077: folds 
Uncalled bet ($11.18) returned to MAO_DZEDYN_S
MAO_DZEDYN_S collected $7.50 from pot
MAO_DZEDYN_S: doesn't show hand 
*** SUMMARY ***
Total pot $7.50 | Rake $0 
Seat 3: Larrysan21
Seat 1: ImaPeppaPig folded before Flop (didn't bet)
Seat 2: AlexPinsk1 folded before Flop (didn't bet)
Seat 4: app1e_j@ck (button) folded before Flop
Seat 5: BE4077 (small blind) folded before Flop
Seat 6: MAO_DZEDYN_S (big blind) collected ($7.50)



PokerStars Hand #254282019004:  Hold'em No Limit ($0.50/$1.00 USD) - 2025/01/09 19:09:17 WET [2025/01/09 14:09:17 ET]
Table 'Dagmar II' 6-max Seat #5 is the button
Seat 3: Larrysan21 ($0 in chips) is sitting out
Seat 1: ImaPeppaPig ($111.13 in chips) 
Seat 2: AlexPinsk1 ($100 in chips) 
Seat 4: app1e_j@ck ($100.20 in chips) 
Seat 5: BE4077 ($87.53 in chips) 
Seat 6: MAO_DZEDYN_S ($186.09 in chips) 
MAO_DZEDYN_S: posts small blind $0.50
ImaPeppaPig: posts big blind $1
*** HOLE CARDS ***
AlexPinsk1: folds 
app1e_j@ck: raises $2 to $3
BE4077: calls $3
MAO_DZEDYN_S: folds 
ImaPeppaPig: calls $2
*** FLOP *** [3d 3c Jd]
ImaPeppaPig: checks 
app1e_j@ck: bets $2.98
BE4077: raises $2.98 to $5.96
ImaPeppaPig: folds 
app1e_j@ck: calls $2.98
*** TURN *** [3d 3c Jd] [9c]
app1e_j@ck: checks 
BE4077: bets $20.35
app1e_j@ck: calls $20.35
*** RIVER *** [3d 3c Jd 9c] [7c]
app1e_j@ck: checks 
BE4077: checks 
*** SHOW DOWN ***
app1e_j@ck: shows [Ah Ac] (two pair, Aces and Threes)
BE4077: mucks hand 
app1e_j@ck collected $59.62 from pot
*** SUMMARY ***
Total pot $62.12 | Rake $2.50 
Board [3d 3c Jd 9c 7c]
Seat 3: Larrysan21
Seat 1: ImaPeppaPig (big blind) folded on the Flop
Seat 2: AlexPinsk1 folded before Flop (didn't bet)
Seat 4: app1e_j@ck showed [Ah Ac] and won ($59.62) with two pair, Aces and Threes
Seat 5: BE4077 (button) mucked
Seat 6: MAO_DZEDYN_S (small blind) folded before Flop



PokerStars Hand #254282032598:  Hold'em No Limit ($0.50/$1.00 USD) - 2025/01/09 19:10:02 WET [2025/01/09 14:10:02 ET]
Table 'Dagmar II' 6-max Seat #6 is the button
Seat 3: Larrysan21 ($0 in chips) is sitting out
Seat 1: ImaPeppaPig ($108.13 in chips) 
Seat 2: AlexPinsk1 ($100 in chips) 
Seat 4: app1e_j@ck ($130.51 in chips) 
Seat 5: BE4077 ($58.22 in chips) 
Seat 6: MAO_DZEDYN_S ($185.59 in chips) 
ImaPeppaPig: posts small blind $0.50
AlexPinsk1: posts big blind $1
*** HOLE CARDS ***
app1e_j@ck: folds 
BE4077: calls $1
MAO_DZEDYN_S: folds 
ImaPeppaPig: folds 
AlexPinsk1: checks 
*** FLOP *** [8d 4d 5d]
AlexPinsk1: checks 
BE4077: checks 
*** TURN *** [8d 4d 5d] [Tc]
AlexPinsk1: checks 
BE4077: checks 
*** RIVER *** [8d 4d 5d Tc] [Kc]
AlexPinsk1: bets $3.50
BE4077: folds 
Uncalled bet ($3.50) returned to AlexPinsk1
AlexPinsk1 collected $2.38 from pot
AlexPinsk1: doesn't show hand 
*** SUMMARY ***
Total pot $2.50 | Rake $0.12 
Board [8d 4d 5d Tc Kc]
Seat 3: Larrysan21
Seat 1: ImaPeppaPig (small blind) folded before Flop
Seat 2: AlexPinsk1 (big blind) collected ($2.38)
Seat 4: app1e_j@ck folded before Flop (didn't bet)
Seat 5: BE4077 folded on the River
Seat 6: MAO_DZEDYN_S (button) folded before Flop (didn't bet)



PokerStars Hand #254282041457:  Hold'em No Limit ($0.50/$1.00 USD) - 2025/01/09 19:10:31 WET [2025/01/09 14:10:31 ET]
Table 'Dagmar II' 6-max Seat #1 is the button
Seat 3: Larrysan21 ($0 in chips) is sitting out
Seat 1: ImaPeppaPig ($107.63 in chips) 
Seat 2: AlexPinsk1 ($101.38 in chips) 
Seat 4: app1e_j@ck ($130.51 in chips) 
Seat 5: BE4077 ($57.22 in chips) 
Seat 6: MAO_DZEDYN_S ($185.59 in chips) 
AlexPinsk1: posts small blind $0.50
app1e_j@ck: posts big blind $1
*** HOLE CARDS ***
BE4077: calls $1
MAO_DZEDYN_S: folds 
ImaPeppaPig: folds 
AlexPinsk1: folds 
app1e_j@ck: checks 
*** FLOP *** [5d Kd 9h]
app1e_j@ck: checks 
BE4077: bets $1.19
app1e_j@ck: folds 
Uncalled bet ($1.19) returned to BE4077
BE4077 collected $2.38 from pot
*** SUMMARY ***
Total pot $2.50 | Rake $0.12 
Board [5d Kd 9h]
Seat 3: Larrysan21
Seat 1: ImaPeppaPig (button) folded before Flop (didn't bet)
Seat 2: AlexPinsk1 (small blind) folded before Flop
Seat 4: app1e_j@ck (big blind) folded on the Flop
Seat 5: BE4077 collected ($2.38)
Seat 6: MAO_DZEDYN_S folded before Flop (didn't bet)



PokerStars Hand #254282051750:  Hold'em No Limit ($0.50/$1.00 USD) - 2025/01/09 19:11:04 WET [2025/01/09 14:11:04 ET]
Table 'Dagmar II' 6-max Seat #2 is the button
Seat 3: Larrysan21 ($0 in chips) is sitting out
Seat 1: ImaPeppaPig ($107.63 in chips) 
Seat 2: AlexPinsk1 ($100.88 in chips) 
Seat 4: app1e_j@ck ($129.51 in chips) 
Seat 5: BE4077 ($58.60 in chips) 
Seat 6: MAO_DZEDYN_S ($185.59 in chips) 
app1e_j@ck: posts small blind $0.50
BE4077: posts big blind $1
*** HOLE CARDS ***
MAO_DZEDYN_S: folds 
ImaPeppaPig: folds 
AlexPinsk1: folds 
app1e_j@ck: folds 
Uncalled bet ($0.50) returned to BE4077
BE4077 collected $1 from pot
*** SUMMARY ***
Total pot $1 | Rake $0 
Seat 3: Larrysan21
Seat 1: ImaPeppaPig folded before Flop (didn't bet)
Seat 2: AlexPinsk1 (button) folded before Flop (didn't bet)
Seat 4: app1e_j@ck (small blind) folded before Flop
Seat 5: BE4077 (big blind) collected ($1)
Seat 6: MAO_DZEDYN_S folded before Flop (didn't bet)



PokerStars Hand #254282056298:  Hold'em No Limit ($0.50/$1.00 USD) - 2025/01/09 19:11:19 WET [2025/01/09 14:11:19 ET]
Table 'Dagmar II' 6-max Seat #4 is the button
Seat 3: Larrysan21 ($0 in chips) is sitting out
Seat 1: ImaPeppaPig ($107.63 in chips) 
Seat 2: AlexPinsk1 ($100.88 in chips) 
Seat 4: app1e_j@ck ($129.01 in chips) 
Seat 5: BE4077 ($59.10 in chips) 
Seat 6: MAO_DZEDYN_S ($185.59 in chips) 
BE4077: posts small blind $0.50
MAO_DZEDYN_S: posts big blind $1
*** HOLE CARDS ***
ImaPeppaPig: folds 
AlexPinsk1: folds 
Larrysan21 is disconnected 
app1e_j@ck: folds 
BE4077: folds 
Uncalled bet ($0.50) returned to MAO_DZEDYN_S
MAO_DZEDYN_S collected $1 from pot
MAO_DZEDYN_S: doesn't show hand 
*** SUMMARY ***
Total pot $1 | Rake $0 
Seat 3: Larrysan21
Seat 1: ImaPeppaPig folded before Flop (didn't bet)
Seat 2: AlexPinsk1 folded before Flop (didn't bet)
Seat 4: app1e_j@ck (button) folded before Flop (didn't bet)
Seat 5: BE4077 (small blind) folded before Flop
Seat 6: MAO_DZEDYN_S (big blind) collected ($1)



PokerStars Hand #254282060216:  Hold'em No Limit ($0.50/$1.00 USD) - 2025/01/09 19:11:32 WET [2025/01/09 14:11:32 ET]
Table 'Dagmar II' 6-max Seat #5 is the button
Seat 3: Larrysan21 ($0 in chips) is sitting out
Seat 1: ImaPeppaPig ($107.63 in chips) 
Seat 2: AlexPinsk1 ($100.88 in chips) 
Seat 4: app1e_j@ck ($129.01 in chips) 
Seat 5: BE4077 ($58.60 in chips) 
Seat 6: MAO_DZEDYN_S ($186.09 in chips) 
MAO_DZEDYN_S: posts small blind $0.50
ImaPeppaPig: posts big blind $1
*** HOLE CARDS ***
AlexPinsk1: folds 
app1e_j@ck: folds 
BE4077: calls $1
MAO_DZEDYN_S: folds 
ImaPeppaPig: checks 
*** FLOP *** [4h Qc Jh]
ImaPeppaPig: checks 
BE4077: bets $1.19
ImaPeppaPig: folds 
Uncalled bet ($1.19) returned to BE4077
BE4077 collected $2.38 from pot
*** SUMMARY ***
Total pot $2.50 | Rake $0.12 
Board [4h Qc Jh]
Seat 3: Larrysan21
Seat 1: ImaPeppaPig (big blind) folded on the Flop
Seat 2: AlexPinsk1 folded before Flop (didn't bet)
Seat 4: app1e_j@ck folded before Flop (didn't bet)
Seat 5: BE4077 (button) collected ($2.38)
Seat 6: MAO_DZEDYN_S (small blind) folded before Flop



PokerStars Hand #254282067013:  Hold'em No Limit ($0.50/$1.00 USD) - 2025/01/09 19:11:55 WET [2025/01/09 14:11:55 ET]
Table 'Dagmar II' 6-max Seat #6 is the button
Seat 3: Larrysan21 ($0 in chips) is sitting out
Seat 1: ImaPeppaPig ($106.63 in chips) 
Seat 2: AlexPinsk1 ($100.88 in chips) 
Seat 4: app1e_j@ck ($129.01 in chips) 
Seat 5: BE4077 ($59.98 in chips) 
Seat 6: MAO_DZEDYN_S ($185.59 in chips) 
ImaPeppaPig: posts small blind $0.50
AlexPinsk1: posts big blind $1
*** HOLE CARDS ***
app1e_j@ck: folds 
BE4077: folds 
MAO_DZEDYN_S: folds 
ImaPeppaPig: folds 
Uncalled bet ($0.50) returned to AlexPinsk1
AlexPinsk1 collected $1 from pot
AlexPinsk1: doesn't show hand 
*** SUMMARY ***
Total pot $1 | Rake $0 
Seat 3: Larrysan21
Seat 1: ImaPeppaPig (small blind) folded before Flop
Seat 2: AlexPinsk1 (big blind) collected ($1)
Seat 4: app1e_j@ck folded before Flop (didn't bet)
Seat 5: BE4077 folded before Flop (didn't bet)
Seat 6: MAO_DZEDYN_S (button) folded before Flop (didn't bet)



PokerStars Hand #254282071814:  Hold'em No Limit ($0.50/$1.00 USD) - 2025/01/09 19:12:10 WET [2025/01/09 14:12:10 ET]
Table 'Dagmar II' 6-max Seat #1 is the button
Seat 3: Larrysan21 ($0 in chips) is sitting out
Seat 1: ImaPeppaPig ($106.13 in chips) 
Seat 2: AlexPinsk1 ($101.38 in chips) 
Seat 4: app1e_j@ck ($129.01 in chips) 
Seat 5: BE4077 ($59.98 in chips) 
Seat 6: MAO_DZEDYN_S ($185.59 in chips) 
AlexPinsk1: posts small blind $0.50
app1e_j@ck: posts big blind $1
*** HOLE CARDS ***
BE4077: folds 
MAO_DZEDYN_S: folds 
ImaPeppaPig: folds 
AlexPinsk1: raises $2 to $3
app1e_j@ck: folds 
Uncalled bet ($2) returned to AlexPinsk1
AlexPinsk1 collected $2 from pot
Larrysan21 leaves the table
AlexPinsk1: doesn't show hand 
*** SUMMARY ***
Total pot $2 | Rake $0 
Seat 3: Larrysan21
Seat 1: ImaPeppaPig (button) folded before Flop (didn't bet)
Seat 2: AlexPinsk1 (small blind) collected ($2)
Seat 4: app1e_j@ck (big blind) folded before Flop
Seat 5: BE4077 folded before Flop (didn't bet)
Seat 6: MAO_DZEDYN_S folded before Flop (didn't bet)



PokerStars Hand #254282081921:  Hold'em No Limit ($0.50/$1.00 USD) - 2025/01/09 19:12:43 WET [2025/01/09 14:12:43 ET]
Table 'Dagmar II' 6-max Seat #2 is the button
Seat 1: ImaPeppaPig ($106.13 in chips) 
Seat 2: AlexPinsk1 ($102.38 in chips) 
Seat 4: app1e_j@ck ($128.01 in chips) 
Seat 5: BE4077 ($59.98 in chips) 
Seat 6: MAO_DZEDYN_S ($185.59 in chips) 
app1e_j@ck: posts small blind $0.50
BE4077: posts big blind $1
*** HOLE CARDS ***
sta$igk joins the table at seat #3 
MAO_DZEDYN_S: folds 
ImaPeppaPig: folds 
AlexPinsk1: folds 
app1e_j@ck: folds 
Uncalled bet ($0.50) returned to BE4077
BE4077 collected $1 from pot
*** SUMMARY ***
Total pot $1 | Rake $0 
Seat 1: ImaPeppaPig folded before Flop (didn't bet)
Seat 2: AlexPinsk1 (button) folded before Flop (didn't bet)
Seat 4: app1e_j@ck (small blind) folded before Flop
Seat 5: BE4077 (big blind) collected ($1)
Seat 6: MAO_DZEDYN_S folded before Flop (didn't bet)



PokerStars Hand #254282086053:  Hold'em No Limit ($0.50/$1.00 USD) - 2025/01/09 19:12:57 WET [2025/01/09 14:12:57 ET]
Table 'Dagmar II' 6-max Seat #4 is the button
Seat 3: sta$igk ($100 in chips) is sitting out
Seat 1: ImaPeppaPig ($106.13 in chips) 
Seat 2: AlexPinsk1 ($102.38 in chips) 
Seat 4: app1e_j@ck ($127.51 in chips) 
Seat 5: BE4077 ($60.48 in chips) 
Seat 6: MAO_DZEDYN_S ($185.59 in chips) 
BE4077: posts small blind $0.50
MAO_DZEDYN_S: posts big blind $1
sta$igk: sits out 
*** HOLE CARDS ***
ImaPeppaPig: folds 
AlexPinsk1: folds 
app1e_j@ck: folds 
BE4077: folds 
Uncalled bet ($0.50) returned to MAO_DZEDYN_S
MAO_DZEDYN_S collected $1 from pot
MAO_DZEDYN_S: doesn't show hand 
*** SUMMARY ***
Total pot $1 | Rake $0 
Seat 3: sta$igk
Seat 1: ImaPeppaPig folded before Flop (didn't bet)
Seat 2: AlexPinsk1 folded before Flop (didn't bet)
Seat 4: app1e_j@ck (button) folded before Flop (didn't bet)
Seat 5: BE4077 (small blind) folded before Flop
Seat 6: MAO_DZEDYN_S (big blind) collected ($1)



PokerStars Hand #254282088697:  Hold'em No Limit ($0.50/$1.00 USD) - 2025/01/09 19:13:06 WET [2025/01/09 14:13:06 ET]
Table 'Dagmar II' 6-max Seat #5 is the button
Seat 3: sta$igk ($100 in chips) is sitting out
Seat 1: ImaPeppaPig ($106.13 in chips) 
Seat 2: AlexPinsk1 ($102.38 in chips) 
Seat 4: app1e_j@ck ($127.51 in chips) 
Seat 5: BE4077 ($59.98 in chips) 
Seat 6: MAO_DZEDYN_S ($186.09 in chips) 
MAO_DZEDYN_S: posts small blind $0.50
ImaPeppaPig: posts big blind $1
sta$igk: sits out 
*** HOLE CARDS ***
AlexPinsk1: raises $1.50 to $2.50
app1e_j@ck: folds 
BE4077: calls $2.50
MAO_DZEDYN_S: folds 
ImaPeppaPig: folds 
*** FLOP *** [3d Jc Th]
AlexPinsk1: checks 
BE4077: checks 
*** TURN *** [3d Jc Th] [9s]
AlexPinsk1: checks 
BE4077: checks 
*** RIVER *** [3d Jc Th 9s] [8d]
AlexPinsk1: bets $3.09
BE4077: folds 
Uncalled bet ($3.09) returned to AlexPinsk1
AlexPinsk1 collected $6.18 from pot
AlexPinsk1: doesn't show hand 
*** SUMMARY ***
Total pot $6.50 | Rake $0.32 
Board [3d Jc Th 9s 8d]
Seat 3: sta$igk
Seat 1: ImaPeppaPig (big blind) folded before Flop
Seat 2: AlexPinsk1 collected ($6.18)
Seat 4: app1e_j@ck folded before Flop (didn't bet)
Seat 5: BE4077 (button) folded on the River
Seat 6: MAO_DZEDYN_S (small blind) folded before Flop



PokerStars Hand #254282099773:  Hold'em No Limit ($0.50/$1.00 USD) - 2025/01/09 19:13:42 WET [2025/01/09 14:13:42 ET]
Table 'Dagmar II' 6-max Seat #6 is the button
Seat 3: sta$igk ($100 in chips) is sitting out
Seat 1: ImaPeppaPig ($105.13 in chips) 
Seat 2: AlexPinsk1 ($106.06 in chips) 
Seat 4: app1e_j@ck ($127.51 in chips) 
Seat 5: BE4077 ($57.48 in chips) 
Seat 6: MAO_DZEDYN_S ($185.59 in chips) 
ImaPeppaPig: posts small blind $0.50
AlexPinsk1: posts big blind $1
sta$igk: sits out 
*** HOLE CARDS ***
app1e_j@ck: folds 
BE4077: calls $1
MAO_DZEDYN_S: folds 
ImaPeppaPig: folds 
AlexPinsk1: checks 
*** FLOP *** [4d Tc Ah]
AlexPinsk1: checks 
BE4077: bets $1
AlexPinsk1: folds 
Uncalled bet ($1) returned to BE4077
BE4077 collected $2.38 from pot
*** SUMMARY ***
Total pot $2.50 | Rake $0.12 
Board [4d Tc Ah]
Seat 3: sta$igk
Seat 1: ImaPeppaPig (small blind) folded before Flop
Seat 2: AlexPinsk1 (big blind) folded on the Flop
Seat 4: app1e_j@ck folded before Flop (didn't bet)
Seat 5: BE4077 collected ($2.38)
Seat 6: MAO_DZEDYN_S (button) folded before Flop (didn't bet)



PokerStars Hand #254282107499:  Hold'em No Limit ($0.50/$1.00 USD) - 2025/01/09 19:14:07 WET [2025/01/09 14:14:07 ET]
Table 'Dagmar II' 6-max Seat #1 is the button
Seat 1: ImaPeppaPig ($104.63 in chips) 
Seat 2: AlexPinsk1 ($105.06 in chips) 
Seat 3: sta$igk ($100 in chips) 
Seat 4: app1e_j@ck ($127.51 in chips) 
Seat 5: BE4077 ($58.86 in chips) 
Seat 6: MAO_DZEDYN_S ($185.59 in chips) 
AlexPinsk1: posts small blind $0.50
sta$igk: posts big blind $1
*** HOLE CARDS ***
app1e_j@ck: raises $1.50 to $2.50
BE4077: calls $2.50
MAO_DZEDYN_S: folds 
ImaPeppaPig: folds 
AlexPinsk1: calls $2
sta$igk: folds 
*** FLOP *** [9c 3d 8c]
AlexPinsk1: checks 
app1e_j@ck: checks 
BE4077: checks 
*** TURN *** [9c 3d 8c] [8d]
AlexPinsk1: bets $3
app1e_j@ck: folds 
BE4077: folds 
Uncalled bet ($3) returned to AlexPinsk1
AlexPinsk1 collected $8.08 from pot
AlexPinsk1: doesn't show hand 
*** SUMMARY ***
Total pot $8.50 | Rake $0.42 
Board [9c 3d 8c 8d]
Seat 1: ImaPeppaPig (button) folded before Flop (didn't bet)
Seat 2: AlexPinsk1 (small blind) collected ($8.08)
Seat 3: sta$igk (big blind) folded before Flop
Seat 4: app1e_j@ck folded on the Turn
Seat 5: BE4077 folded on the Turn
Seat 6: MAO_DZEDYN_S folded before Flop (didn't bet)



PokerStars Hand #254282116262:  Hold'em No Limit ($0.50/$1.00 USD) - 2025/01/09 19:14:36 WET [2025/01/09 14:14:36 ET]
Table 'Dagmar II' 6-max Seat #2 is the button
Seat 1: ImaPeppaPig ($104.63 in chips) 
Seat 2: AlexPinsk1 ($110.64 in chips) 
Seat 3: sta$igk ($100 in chips) 
Seat 4: app1e_j@ck ($125.01 in chips) 
Seat 5: BE4077 ($56.36 in chips) 
Seat 6: MAO_DZEDYN_S ($185.59 in chips) 
sta$igk: posts small blind $0.50
app1e_j@ck: posts big blind $1
*** HOLE CARDS ***
BE4077: calls $1
MAO_DZEDYN_S: folds 
ImaPeppaPig: folds 
AlexPinsk1: folds 
sta$igk: folds 
app1e_j@ck: checks 
*** FLOP *** [5s Ah 6d]
app1e_j@ck: checks 
BE4077: checks 
*** TURN *** [5s Ah 6d] [8s]
app1e_j@ck: checks 
BE4077: bets $1.19
app1e_j@ck: calls $1.19
*** RIVER *** [5s Ah 6d 8s] [2h]
app1e_j@ck: checks 
BE4077: checks 
*** SHOW DOWN ***
app1e_j@ck: shows [6h Kh] (a pair of Sixes)
BE4077: mucks hand 
app1e_j@ck collected $4.64 from pot
*** SUMMARY ***
Total pot $4.88 | Rake $0.24 
Board [5s Ah 6d 8s 2h]
Seat 1: ImaPeppaPig folded before Flop (didn't bet)
Seat 2: AlexPinsk1 (button) folded before Flop (didn't bet)
Seat 3: sta$igk (small blind) folded before Flop
Seat 4: app1e_j@ck (big blind) showed [6h Kh] and won ($4.64) with a pair of Sixes
Seat 5: BE4077 mucked
Seat 6: MAO_DZEDYN_S folded before Flop (didn't bet)



PokerStars Hand #254282141776:  Hold'em No Limit ($0.50/$1.00 USD) - 2025/01/09 19:15:58 WET [2025/01/09 14:15:58 ET]
Table 'Dagmar II' 6-max Seat #3 is the button
Seat 1: ImaPeppaPig ($104.63 in chips) 
Seat 2: AlexPinsk1 ($110.64 in chips) 
Seat 3: sta$igk ($100 in chips) 
Seat 4: app1e_j@ck ($127.46 in chips) 
Seat 5: BE4077 ($54.17 in chips) 
Seat 6: MAO_DZEDYN_S ($185.59 in chips) 
app1e_j@ck: posts small blind $0.50
BE4077: posts big blind $1
*** HOLE CARDS ***
MAO_DZEDYN_S: folds 
ImaPeppaPig: folds 
AlexPinsk1: folds 
sta$igk: folds 
app1e_j@ck: raises $2 to $3
BE4077: raises $2 to $5
app1e_j@ck: calls $2
*** FLOP *** [3d 6h 8s]
app1e_j@ck: checks 
BE4077: checks 
*** TURN *** [3d 6h 8s] [4c]
app1e_j@ck: checks 
BE4077: checks 
*** RIVER *** [3d 6h 8s 4c] [5s]
app1e_j@ck: checks 
BE4077: checks 
*** SHOW DOWN ***
app1e_j@ck: shows [Ah Jd] (high card Ace)
BE4077: mucks hand 
app1e_j@ck collected $9.50 from pot
*** SUMMARY ***
Total pot $10 | Rake $0.50 
Board [3d 6h 8s 4c 5s]
Seat 1: ImaPeppaPig folded before Flop (didn't bet)
Seat 2: AlexPinsk1 folded before Flop (didn't bet)
Seat 3: sta$igk (button) folded before Flop (didn't bet)
Seat 4: app1e_j@ck (small blind) showed [Ah Jd] and won ($9.50) with high card Ace
Seat 5: BE4077 (big blind) mucked
Seat 6: MAO_DZEDYN_S folded before Flop (didn't bet)



PokerStars Hand #254282157532:  Hold'em No Limit ($0.50/$1.00 USD) - 2025/01/09 19:16:50 WET [2025/01/09 14:16:50 ET]
Table 'Dagmar II' 6-max Seat #4 is the button
Seat 1: ImaPeppaPig ($104.63 in chips) 
Seat 2: AlexPinsk1 ($110.64 in chips) 
Seat 3: sta$igk ($100 in chips) 
Seat 4: app1e_j@ck ($131.96 in chips) 
Seat 5: BE4077 ($49.17 in chips) 
Seat 6: MAO_DZEDYN_S ($185.59 in chips) 
BE4077: posts small blind $0.50
MAO_DZEDYN_S: posts big blind $1
*** HOLE CARDS ***
ImaPeppaPig: folds 
AlexPinsk1: folds 
sta$igk: folds 
app1e_j@ck: raises $1.50 to $2.50
BE4077: calls $2
MAO_DZEDYN_S: raises $10.68 to $13.18
app1e_j@ck: raises $118.78 to $131.96 and is all-in
BE4077: folds 
MAO_DZEDYN_S: folds 
Uncalled bet ($118.78) returned to app1e_j@ck
app1e_j@ck collected $28.86 from pot
app1e_j@ck: doesn't show hand 
*** SUMMARY ***
Total pot $28.86 | Rake $0 
Seat 1: ImaPeppaPig folded before Flop (didn't bet)
Seat 2: AlexPinsk1 folded before Flop (didn't bet)
Seat 3: sta$igk folded before Flop (didn't bet)
Seat 4: app1e_j@ck (button) collected ($28.86)
Seat 5: BE4077 (small blind) folded before Flop
Seat 6: MAO_DZEDYN_S (big blind) folded before Flop



PokerStars Hand #254282175442:  Hold'em No Limit ($0.50/$1.00 USD) - 2025/01/09 19:17:49 WET [2025/01/09 14:17:49 ET]
Table 'Dagmar II' 6-max Seat #5 is the button
Seat 1: ImaPeppaPig ($104.63 in chips) 
Seat 2: AlexPinsk1 ($110.64 in chips) 
Seat 3: sta$igk ($100 in chips) 
Seat 4: app1e_j@ck ($147.64 in chips) 
Seat 5: BE4077 ($46.67 in chips) 
Seat 6: MAO_DZEDYN_S ($172.41 in chips) 
MAO_DZEDYN_S: posts small blind $0.50
ImaPeppaPig: posts big blind $1
*** HOLE CARDS ***
AlexPinsk1: folds 
sta$igk: folds 
app1e_j@ck: folds 
BE4077: calls $1
MAO_DZEDYN_S: calls $0.50
ImaPeppaPig: checks 
*** FLOP *** [6h Th 8c]
MAO_DZEDYN_S: checks 
ImaPeppaPig: checks 
BE4077: checks 
*** TURN *** [6h Th 8c] [2d]
MAO_DZEDYN_S: checks 
ImaPeppaPig: checks 
BE4077: checks 
*** RIVER *** [6h Th 8c 2d] [7c]
MAO_DZEDYN_S: checks 
ImaPeppaPig: checks 
BE4077: checks 
*** SHOW DOWN ***
MAO_DZEDYN_S: shows [6c Qc] (a pair of Sixes)
ImaPeppaPig: shows [7h Ad] (a pair of Sevens)
BE4077: mucks hand 
ImaPeppaPig collected $2.85 from pot
*** SUMMARY ***
Total pot $3 | Rake $0.15 
Board [6h Th 8c 2d 7c]
Seat 1: ImaPeppaPig (big blind) showed [7h Ad] and won ($2.85) with a pair of Sevens
Seat 2: AlexPinsk1 folded before Flop (didn't bet)
Seat 3: sta$igk folded before Flop (didn't bet)
Seat 4: app1e_j@ck folded before Flop (didn't bet)
Seat 5: BE4077 (button) mucked
Seat 6: MAO_DZEDYN_S (small blind) showed [6c Qc] and lost with a pair of Sixes



PokerStars Hand #254282202589:  Hold'em No Limit ($0.50/$1.00 USD) - 2025/01/09 19:19:17 WET [2025/01/09 14:19:17 ET]
Table 'Dagmar II' 6-max Seat #6 is the button
Seat 1: ImaPeppaPig ($106.48 in chips) 
Seat 2: AlexPinsk1 ($110.64 in chips) 
Seat 3: sta$igk ($100 in chips) 
Seat 4: app1e_j@ck ($147.64 in chips) 
Seat 5: BE4077 ($45.67 in chips) 
Seat 6: MAO_DZEDYN_S ($171.41 in chips) 
ImaPeppaPig: posts small blind $0.50
AlexPinsk1: posts big blind $1
*** HOLE CARDS ***
sta$igk: folds 
app1e_j@ck: folds 
BE4077: folds 
MAO_DZEDYN_S: folds 
ImaPeppaPig: folds 
Uncalled bet ($0.50) returned to AlexPinsk1
AlexPinsk1 collected $1 from pot
AlexPinsk1: doesn't show hand 
*** SUMMARY ***
Total pot $1 | Rake $0 
Seat 1: ImaPeppaPig (small blind) folded before Flop
Seat 2: AlexPinsk1 (big blind) collected ($1)
Seat 3: sta$igk folded before Flop (didn't bet)
Seat 4: app1e_j@ck folded before Flop (didn't bet)
Seat 5: BE4077 folded before Flop (didn't bet)
Seat 6: MAO_DZEDYN_S (button) folded before Flop (didn't bet)



PokerStars Hand #254282206941:  Hold'em No Limit ($0.50/$1.00 USD) - 2025/01/09 19:19:30 WET [2025/01/09 14:19:30 ET]
Table 'Dagmar II' 6-max Seat #1 is the button
Seat 1: ImaPeppaPig ($105.98 in chips) 
Seat 2: AlexPinsk1 ($111.14 in chips) 
Seat 3: sta$igk ($100 in chips) 
Seat 4: app1e_j@ck ($147.64 in chips) 
Seat 5: BE4077 ($45.67 in chips) 
Seat 6: MAO_DZEDYN_S ($171.41 in chips) 
AlexPinsk1: posts small blind $0.50
sta$igk: posts big blind $1
*** HOLE CARDS ***
app1e_j@ck: folds 
BE4077: folds 
MAO_DZEDYN_S: folds 
ImaPeppaPig: folds 
AlexPinsk1: raises $2 to $3
sta$igk: raises $6 to $9
AlexPinsk1: folds 
Uncalled bet ($6) returned to sta$igk
sta$igk collected $6 from pot
sta$igk: doesn't show hand 
*** SUMMARY ***
Total pot $6 | Rake $0 
Seat 1: ImaPeppaPig (button) folded before Flop (didn't bet)
Seat 2: AlexPinsk1 (small blind) folded before Flop
Seat 3: sta$igk (big blind) collected ($6)
Seat 4: app1e_j@ck folded before Flop (didn't bet)
Seat 5: BE4077 folded before Flop (didn't bet)
Seat 6: MAO_DZEDYN_S folded before Flop (didn't bet)



PokerStars Hand #254282217437:  Hold'em No Limit ($0.50/$1.00 USD) - 2025/01/09 19:20:05 WET [2025/01/09 14:20:05 ET]
Table 'Dagmar II' 6-max Seat #2 is the button
Seat 1: ImaPeppaPig ($105.98 in chips) 
Seat 2: AlexPinsk1 ($108.14 in chips) 
Seat 3: sta$igk ($103 in chips) 
Seat 4: app1e_j@ck ($147.64 in chips) 
Seat 5: BE4077 ($45.67 in chips) 
Seat 6: MAO_DZEDYN_S ($171.41 in chips) 
sta$igk: posts small blind $0.50
app1e_j@ck: posts big blind $1
*** HOLE CARDS ***
BE4077: calls $1
MAO_DZEDYN_S: folds 
ImaPeppaPig: folds 
AlexPinsk1: folds 
sta$igk: folds 
app1e_j@ck: checks 
*** FLOP *** [Qs 4h 2d]
app1e_j@ck: checks 
BE4077: checks 
*** TURN *** [Qs 4h 2d] [3h]
app1e_j@ck: checks 
BE4077: checks 
*** RIVER *** [Qs 4h 2d 3h] [8h]
app1e_j@ck: checks 
BE4077: checks 
*** SHOW DOWN ***
app1e_j@ck: shows [Ks 7h] (high card King)
BE4077: mucks hand 
app1e_j@ck collected $2.38 from pot
*** SUMMARY ***
Total pot $2.50 | Rake $0.12 
Board [Qs 4h 2d 3h 8h]
Seat 1: ImaPeppaPig folded before Flop (didn't bet)
Seat 2: AlexPinsk1 (button) folded before Flop (didn't bet)
Seat 3: sta$igk (small blind) folded before Flop
Seat 4: app1e_j@ck (big blind) showed [Ks 7h] and won ($2.38) with high card King
Seat 5: BE4077 mucked
Seat 6: MAO_DZEDYN_S folded before Flop (didn't bet)



PokerStars Hand #254282227158:  Hold'em No Limit ($0.50/$1.00 USD) - 2025/01/09 19:20:36 WET [2025/01/09 14:20:36 ET]
Table 'Dagmar II' 6-max Seat #3 is the button
Seat 1: ImaPeppaPig ($105.98 in chips) 
Seat 2: AlexPinsk1 ($108.14 in chips) 
Seat 3: sta$igk ($102.50 in chips) 
Seat 4: app1e_j@ck ($149.02 in chips) 
Seat 5: BE4077 ($44.67 in chips) 
Seat 6: MAO_DZEDYN_S ($171.41 in chips) 
app1e_j@ck: posts small blind $0.50
BE4077: posts big blind $1
*** HOLE CARDS ***
MAO_DZEDYN_S: raises $1.75 to $2.75
ImaPeppaPig: folds 
AlexPinsk1: folds 
sta$igk: folds 
app1e_j@ck: folds 
BE4077: folds 
Uncalled bet ($1.75) returned to MAO_DZEDYN_S
MAO_DZEDYN_S collected $2.50 from pot
MAO_DZEDYN_S: doesn't show hand 
*** SUMMARY ***
Total pot $2.50 | Rake $0 
Seat 1: ImaPeppaPig folded before Flop (didn't bet)
Seat 2: AlexPinsk1 folded before Flop (didn't bet)
Seat 3: sta$igk (button) folded before Flop (didn't bet)
Seat 4: app1e_j@ck (small blind) folded before Flop
Seat 5: BE4077 (big blind) folded before Flop
Seat 6: MAO_DZEDYN_S collected ($2.50)



PokerStars Hand #254282239221:  Hold'em No Limit ($0.50/$1.00 USD) - 2025/01/09 19:21:15 WET [2025/01/09 14:21:15 ET]
Table 'Dagmar II' 6-max Seat #4 is the button
Seat 1: ImaPeppaPig ($105.98 in chips) 
Seat 2: AlexPinsk1 ($108.14 in chips) 
Seat 3: sta$igk ($102.50 in chips) 
Seat 4: app1e_j@ck ($148.52 in chips) 
Seat 5: BE4077 ($43.67 in chips) 
Seat 6: MAO_DZEDYN_S ($172.91 in chips) 
BE4077: posts small blind $0.50
MAO_DZEDYN_S: posts big blind $1
*** HOLE CARDS ***
ImaPeppaPig: folds 
AlexPinsk1: folds 
sta$igk: raises $1.50 to $2.50
app1e_j@ck: folds 
BE4077: calls $2
MAO_DZEDYN_S: calls $1.50
*** FLOP *** [4c Ac 5s]
BE4077: bets $3.56
MAO_DZEDYN_S: calls $3.56
sta$igk: folds 
*** TURN *** [4c Ac 5s] [5d]
BE4077: bets $13.89
MAO_DZEDYN_S: folds 
Uncalled bet ($13.89) returned to BE4077
BE4077 collected $13.89 from pot
*** SUMMARY ***
Total pot $14.62 | Rake $0.73 
Board [4c Ac 5s 5d]
Seat 1: ImaPeppaPig folded before Flop (didn't bet)
Seat 2: AlexPinsk1 folded before Flop (didn't bet)
Seat 3: sta$igk folded on the Flop
Seat 4: app1e_j@ck (button) folded before Flop (didn't bet)
Seat 5: BE4077 (small blind) collected ($13.89)
Seat 6: MAO_DZEDYN_S (big blind) folded on the Turn



PokerStars Hand #254282259166:  Hold'em No Limit ($0.50/$1.00 USD) - 2025/01/09 19:22:20 WET [2025/01/09 14:22:20 ET]
Table 'Dagmar II' 6-max Seat #5 is the button
Seat 1: ImaPeppaPig ($105.98 in chips) 
Seat 2: AlexPinsk1 ($108.14 in chips) 
Seat 3: sta$igk ($100 in chips) 
Seat 4: app1e_j@ck ($148.52 in chips) 
Seat 5: BE4077 ($51.50 in chips) 
Seat 6: MAO_DZEDYN_S ($166.85 in chips) 
MAO_DZEDYN_S: posts small blind $0.50
ImaPeppaPig: posts big blind $1
*** HOLE CARDS ***
AlexPinsk1: folds 
sta$igk: folds 
app1e_j@ck: folds 
BE4077: calls $1
MAO_DZEDYN_S: folds 
ImaPeppaPig: checks 
*** FLOP *** [Ac 6h 8h]
ImaPeppaPig: checks 
BE4077: checks 
*** TURN *** [Ac 6h 8h] [As]
ImaPeppaPig: bets $2
BE4077: folds 
Uncalled bet ($2) returned to ImaPeppaPig
ImaPeppaPig collected $2.38 from pot
ImaPeppaPig: doesn't show hand 
*** SUMMARY ***
Total pot $2.50 | Rake $0.12 
Board [Ac 6h 8h As]
Seat 1: ImaPeppaPig (big blind) collected ($2.38)
Seat 2: AlexPinsk1 folded before Flop (didn't bet)
Seat 3: sta$igk folded before Flop (didn't bet)
Seat 4: app1e_j@ck folded before Flop (didn't bet)
Seat 5: BE4077 (button) folded on the Turn
Seat 6: MAO_DZEDYN_S (small blind) folded before Flop



PokerStars Hand #254282269206:  Hold'em No Limit ($0.50/$1.00 USD) - 2025/01/09 19:22:53 WET [2025/01/09 14:22:53 ET]
Table 'Dagmar II' 6-max Seat #6 is the button
Seat 1: ImaPeppaPig ($107.36 in chips) 
Seat 2: AlexPinsk1 ($108.14 in chips) 
Seat 3: sta$igk ($100 in chips) 
Seat 4: app1e_j@ck ($148.52 in chips) 
Seat 5: BE4077 ($50.50 in chips) 
Seat 6: MAO_DZEDYN_S ($166.35 in chips) 
ImaPeppaPig: posts small blind $0.50
AlexPinsk1: posts big blind $1
*** HOLE CARDS ***
sta$igk: folds 
app1e_j@ck: folds 
BE4077: calls $1
MAO_DZEDYN_S: raises $3 to $4
ImaPeppaPig: folds 
AlexPinsk1: folds 
BE4077: calls $3
*** FLOP *** [5h As 4h]
BE4077: bets $4.51
MAO_DZEDYN_S: folds 
Uncalled bet ($4.51) returned to BE4077
BE4077 collected $9.02 from pot
*** SUMMARY ***
Total pot $9.50 | Rake $0.48 
Board [5h As 4h]
Seat 1: ImaPeppaPig (small blind) folded before Flop
Seat 2: AlexPinsk1 (big blind) folded before Flop
Seat 3: sta$igk folded before Flop (didn't bet)
Seat 4: app1e_j@ck folded before Flop (didn't bet)
Seat 5: BE4077 collected ($9.02)
Seat 6: MAO_DZEDYN_S (button) folded on the Flop



PokerStars Hand #254282286608:  Hold'em No Limit ($0.50/$1.00 USD) - 2025/01/09 19:23:51 WET [2025/01/09 14:23:51 ET]
Table 'Dagmar II' 6-max Seat #1 is the button
Seat 1: ImaPeppaPig ($106.86 in chips) 
Seat 2: AlexPinsk1 ($107.14 in chips) 
Seat 3: sta$igk ($100 in chips) 
Seat 4: app1e_j@ck ($148.52 in chips) 
Seat 5: BE4077 ($55.52 in chips) 
Seat 6: MAO_DZEDYN_S ($162.35 in chips) 
AlexPinsk1: posts small blind $0.50
sta$igk: posts big blind $1
*** HOLE CARDS ***
app1e_j@ck: folds 
BE4077: calls $1
MAO_DZEDYN_S: folds 
ImaPeppaPig: folds 
AlexPinsk1: folds 
sta$igk: checks 
*** FLOP *** [Ad 4h Qh]
sta$igk: checks 
BE4077: checks 
*** TURN *** [Ad 4h Qh] [Jd]
sta$igk: checks 
BE4077: bets $1
sta$igk: folds 
Uncalled bet ($1) returned to BE4077
BE4077 collected $2.38 from pot
*** SUMMARY ***
Total pot $2.50 | Rake $0.12 
Board [Ad 4h Qh Jd]
Seat 1: ImaPeppaPig (button) folded before Flop (didn't bet)
Seat 2: AlexPinsk1 (small blind) folded before Flop
Seat 3: sta$igk (big blind) folded on the Turn
Seat 4: app1e_j@ck folded before Flop (didn't bet)
Seat 5: BE4077 collected ($2.38)
Seat 6: MAO_DZEDYN_S folded before Flop (didn't bet)



PokerStars Hand #254282298451:  Hold'em No Limit ($0.50/$1.00 USD) - 2025/01/09 19:24:30 WET [2025/01/09 14:24:30 ET]
Table 'Dagmar II' 6-max Seat #2 is the button
Seat 1: ImaPeppaPig ($106.86 in chips) 
Seat 2: AlexPinsk1 ($106.64 in chips) 
Seat 3: sta$igk ($100 in chips) 
Seat 4: app1e_j@ck ($148.52 in chips) 
Seat 5: BE4077 ($56.90 in chips) 
Seat 6: MAO_DZEDYN_S ($162.35 in chips) 
sta$igk: posts small blind $0.50
app1e_j@ck: posts big blind $1
*** HOLE CARDS ***
BE4077: calls $1
MAO_DZEDYN_S: folds 
ImaPeppaPig: folds 
AlexPinsk1: folds 
sta$igk: folds 
app1e_j@ck: checks 
*** FLOP *** [5s 6c 9c]
app1e_j@ck: checks 
BE4077: checks 
*** TURN *** [5s 6c 9c] [2c]
app1e_j@ck: checks 
BE4077: checks 
*** RIVER *** [5s 6c 9c 2c] [6s]
app1e_j@ck: bets $1.59
BE4077: folds 
Uncalled bet ($1.59) returned to app1e_j@ck
app1e_j@ck collected $2.38 from pot
app1e_j@ck: doesn't show hand 
*** SUMMARY ***
Total pot $2.50 | Rake $0.12 
Board [5s 6c 9c 2c 6s]
Seat 1: ImaPeppaPig folded before Flop (didn't bet)
Seat 2: AlexPinsk1 (button) folded before Flop (didn't bet)
Seat 3: sta$igk (small blind) folded before Flop
Seat 4: app1e_j@ck (big blind) collected ($2.38)
Seat 5: BE4077 folded on the River
Seat 6: MAO_DZEDYN_S folded before Flop (didn't bet)



PokerStars Hand #254282308721:  Hold'em No Limit ($0.50/$1.00 USD) - 2025/01/09 19:25:04 WET [2025/01/09 14:25:04 ET]
Table 'Dagmar II' 6-max Seat #3 is the button
Seat 1: ImaPeppaPig ($106.86 in chips) 
Seat 2: AlexPinsk1 ($106.64 in chips) 
Seat 3: sta$igk ($100 in chips) 
Seat 4: app1e_j@ck ($149.90 in chips) 
Seat 5: BE4077 ($55.90 in chips) 
Seat 6: MAO_DZEDYN_S ($162.35 in chips) 
app1e_j@ck: posts small blind $0.50
BE4077: posts big blind $1
*** HOLE CARDS ***
MAO_DZEDYN_S: folds 
ImaPeppaPig: folds 
AlexPinsk1: folds 
sta$igk: raises $1.50 to $2.50
app1e_j@ck: folds 
BE4077: folds 
Uncalled bet ($1.50) returned to sta$igk
sta$igk collected $2.50 from pot
sta$igk: doesn't show hand 
*** SUMMARY ***
Total pot $2.50 | Rake $0 
Seat 1: ImaPeppaPig folded before Flop (didn't bet)
Seat 2: AlexPinsk1 folded before Flop (didn't bet)
Seat 3: sta$igk (button) collected ($2.50)
Seat 4: app1e_j@ck (small blind) folded before Flop
Seat 5: BE4077 (big blind) folded before Flop
Seat 6: MAO_DZEDYN_S folded before Flop (didn't bet)



PokerStars Hand #254282313313:  Hold'em No Limit ($0.50/$1.00 USD) - 2025/01/09 19:25:19 WET [2025/01/09 14:25:19 ET]
Table 'Dagmar II' 6-max Seat #4 is the button
Seat 1: ImaPeppaPig ($106.86 in chips) 
Seat 2: AlexPinsk1 ($106.64 in chips) 
Seat 3: sta$igk ($101.50 in chips) 
Seat 4: app1e_j@ck ($149.40 in chips) 
Seat 5: BE4077 ($54.90 in chips) 
Seat 6: MAO_DZEDYN_S ($162.35 in chips) 
BE4077: posts small blind $0.50
MAO_DZEDYN_S: posts big blind $1
*** HOLE CARDS ***
ImaPeppaPig: folds 
AlexPinsk1: folds 
sta$igk: folds 
app1e_j@ck: raises $1.50 to $2.50
BE4077: calls $2
MAO_DZEDYN_S: folds 
*** FLOP *** [8s Kh 5s]
BE4077: checks 
app1e_j@ck: bets $1.88
BE4077: folds 
Uncalled bet ($1.88) returned to app1e_j@ck
app1e_j@ck collected $5.70 from pot
app1e_j@ck: doesn't show hand 
*** SUMMARY ***
Total pot $6 | Rake $0.30 
Board [8s Kh 5s]
Seat 1: ImaPeppaPig folded before Flop (didn't bet)
Seat 2: AlexPinsk1 folded before Flop (didn't bet)
Seat 3: sta$igk folded before Flop (didn't bet)
Seat 4: app1e_j@ck (button) collected ($5.70)
Seat 5: BE4077 (small blind) folded on the Flop
Seat 6: MAO_DZEDYN_S (big blind) folded before Flop



PokerStars Hand #254282321262:  Hold'em No Limit ($0.50/$1.00 USD) - 2025/01/09 19:25:46 WET [2025/01/09 14:25:46 ET]
Table 'Dagmar II' 6-max Seat #5 is the button
Seat 1: ImaPeppaPig ($106.86 in chips) 
Seat 2: AlexPinsk1 ($106.64 in chips) 
Seat 3: sta$igk ($101.50 in chips) 
Seat 4: app1e_j@ck ($152.60 in chips) 
Seat 5: BE4077 ($52.40 in chips) 
Seat 6: MAO_DZEDYN_S ($161.35 in chips) 
MAO_DZEDYN_S: posts small blind $0.50
ImaPeppaPig: posts big blind $1
*** HOLE CARDS ***
AlexPinsk1: folds 
sta$igk: folds 
app1e_j@ck: folds 
BE4077: calls $1
MAO_DZEDYN_S: folds 
ImaPeppaPig: raises $4 to $5
BE4077: folds 
Uncalled bet ($4) returned to ImaPeppaPig
ImaPeppaPig collected $2.50 from pot
ImaPeppaPig: doesn't show hand 
*** SUMMARY ***
Total pot $2.50 | Rake $0 
Seat 1: ImaPeppaPig (big blind) collected ($2.50)
Seat 2: AlexPinsk1 folded before Flop (didn't bet)
Seat 3: sta$igk folded before Flop (didn't bet)
Seat 4: app1e_j@ck folded before Flop (didn't bet)
Seat 5: BE4077 (button) folded before Flop
Seat 6: MAO_DZEDYN_S (small blind) folded before Flop



PokerStars Hand #254282331424:  Hold'em No Limit ($0.50/$1.00 USD) - 2025/01/09 19:26:19 WET [2025/01/09 14:26:19 ET]
Table 'Dagmar II' 6-max Seat #6 is the button
Seat 1: ImaPeppaPig ($108.36 in chips) 
Seat 2: AlexPinsk1 ($106.64 in chips) 
Seat 3: sta$igk ($101.50 in chips) 
Seat 4: app1e_j@ck ($152.60 in chips) 
Seat 5: BE4077 ($51.40 in chips) 
Seat 6: MAO_DZEDYN_S ($160.85 in chips) 
ImaPeppaPig: posts small blind $0.50
AlexPinsk1: posts big blind $1
*** HOLE CARDS ***
sta$igk: folds 
app1e_j@ck: raises $1.50 to $2.50
BE4077: calls $2.50
MAO_DZEDYN_S: folds 
ImaPeppaPig: folds 
AlexPinsk1: folds 
*** FLOP *** [Th Ac 7d]
app1e_j@ck: checks 
BE4077: checks 
*** TURN *** [Th Ac 7d] [4d]
app1e_j@ck: bets $4.64
BE4077: folds 
Uncalled bet ($4.64) returned to app1e_j@ck
app1e_j@ck collected $6.18 from pot
app1e_j@ck: doesn't show hand 
*** SUMMARY ***
Total pot $6.50 | Rake $0.32 
Board [Th Ac 7d 4d]
Seat 1: ImaPeppaPig (small blind) folded before Flop
Seat 2: AlexPinsk1 (big blind) folded before Flop
Seat 3: sta$igk folded before Flop (didn't bet)
Seat 4: app1e_j@ck collected ($6.18)
Seat 5: BE4077 folded on the Turn
Seat 6: MAO_DZEDYN_S (button) folded before Flop (didn't bet)



PokerStars Hand #254282343833:  Hold'em No Limit ($0.50/$1.00 USD) - 2025/01/09 19:27:00 WET [2025/01/09 14:27:00 ET]
Table 'Dagmar II' 6-max Seat #1 is the button
Seat 1: ImaPeppaPig ($107.86 in chips) 
Seat 2: AlexPinsk1 ($105.64 in chips) 
Seat 3: sta$igk ($101.50 in chips) 
Seat 4: app1e_j@ck ($156.28 in chips) 
Seat 5: BE4077 ($48.90 in chips) 
Seat 6: MAO_DZEDYN_S ($160.85 in chips) 
AlexPinsk1: posts small blind $0.50
sta$igk: posts big blind $1
*** HOLE CARDS ***
app1e_j@ck: folds 
BE4077: calls $1
MAO_DZEDYN_S: folds 
ImaPeppaPig: folds 
AlexPinsk1: folds 
sta$igk: checks 
*** FLOP *** [5c Tc Kc]
sta$igk: checks 
BE4077: checks 
*** TURN *** [5c Tc Kc] [Ah]
sta$igk: checks 
BE4077: checks 
*** RIVER *** [5c Tc Kc Ah] [Ts]
sta$igk: bets $1.19
BE4077: folds 
Uncalled bet ($1.19) returned to sta$igk
sta$igk collected $2.38 from pot
sta$igk: doesn't show hand 
*** SUMMARY ***
Total pot $2.50 | Rake $0.12 
Board [5c Tc Kc Ah Ts]
Seat 1: ImaPeppaPig (button) folded before Flop (didn't bet)
Seat 2: AlexPinsk1 (small blind) folded before Flop
Seat 3: sta$igk (big blind) collected ($2.38)
Seat 4: app1e_j@ck folded before Flop (didn't bet)
Seat 5: BE4077 folded on the River
Seat 6: MAO_DZEDYN_S folded before Flop (didn't bet)



PokerStars Hand #254282355922:  Hold'em No Limit ($0.50/$1.00 USD) - 2025/01/09 19:27:39 WET [2025/01/09 14:27:39 ET]
Table 'Dagmar II' 6-max Seat #2 is the button
Seat 1: ImaPeppaPig ($107.86 in chips) 
Seat 2: AlexPinsk1 ($105.14 in chips) 
Seat 3: sta$igk ($102.88 in chips) 
Seat 4: app1e_j@ck ($156.28 in chips) 
Seat 5: BE4077 ($47.90 in chips) 
Seat 6: MAO_DZEDYN_S ($160.85 in chips) 
sta$igk: posts small blind $0.50
app1e_j@ck: posts big blind $1
*** HOLE CARDS ***
BE4077: calls $1
MAO_DZEDYN_S: folds 
ImaPeppaPig: folds 
AlexPinsk1: folds 
sta$igk: folds 
app1e_j@ck: checks 
*** FLOP *** [8h Td Th]
app1e_j@ck: bets $2.29
BE4077: folds 
Uncalled bet ($2.29) returned to app1e_j@ck
app1e_j@ck collected $2.38 from pot
app1e_j@ck: doesn't show hand 
*** SUMMARY ***
Total pot $2.50 | Rake $0.12 
Board [8h Td Th]
Seat 1: ImaPeppaPig folded before Flop (didn't bet)
Seat 2: AlexPinsk1 (button) folded before Flop (didn't bet)
Seat 3: sta$igk (small blind) folded before Flop
Seat 4: app1e_j@ck (big blind) collected ($2.38)
Seat 5: BE4077 folded on the Flop
Seat 6: MAO_DZEDYN_S folded before Flop (didn't bet)



PokerStars Hand #254282362642:  Hold'em No Limit ($0.50/$1.00 USD) - 2025/01/09 19:28:03 WET [2025/01/09 14:28:03 ET]
Table 'Dagmar II' 6-max Seat #3 is the button
Seat 1: ImaPeppaPig ($107.86 in chips) 
Seat 2: AlexPinsk1 ($105.14 in chips) 
Seat 3: sta$igk ($102.38 in chips) 
Seat 4: app1e_j@ck ($157.66 in chips) 
Seat 5: BE4077 ($46.90 in chips) 
Seat 6: MAO_DZEDYN_S ($160.85 in chips) 
app1e_j@ck: posts small blind $0.50
BE4077: posts big blind $1
*** HOLE CARDS ***
MAO_DZEDYN_S: folds 
ImaPeppaPig: folds 
AlexPinsk1: folds 
sta$igk: folds 
app1e_j@ck: folds 
Uncalled bet ($0.50) returned to BE4077
BE4077 collected $1 from pot
*** SUMMARY ***
Total pot $1 | Rake $0 
Seat 1: ImaPeppaPig folded before Flop (didn't bet)
Seat 2: AlexPinsk1 folded before Flop (didn't bet)
Seat 3: sta$igk (button) folded before Flop (didn't bet)
Seat 4: app1e_j@ck (small blind) folded before Flop
Seat 5: BE4077 (big blind) collected ($1)
Seat 6: MAO_DZEDYN_S folded before Flop (didn't bet)



PokerStars Hand #254282368016:  Hold'em No Limit ($0.50/$1.00 USD) - 2025/01/09 19:28:19 WET [2025/01/09 14:28:19 ET]
Table 'Dagmar II' 6-max Seat #4 is the button
Seat 1: ImaPeppaPig ($107.86 in chips) 
Seat 2: AlexPinsk1 ($105.14 in chips) 
Seat 3: sta$igk ($102.38 in chips) 
Seat 4: app1e_j@ck ($157.16 in chips) 
Seat 5: BE4077 ($47.40 in chips) 
Seat 6: MAO_DZEDYN_S ($160.85 in chips) 
BE4077: posts small blind $0.50
MAO_DZEDYN_S: posts big blind $1
*** HOLE CARDS ***
ImaPeppaPig: raises $1.50 to $2.50
AlexPinsk1: folds 
sta$igk: folds 
app1e_j@ck: folds 
BE4077: calls $2
MAO_DZEDYN_S: folds 
*** FLOP *** [8c 3h 7c]
BE4077: checks 
ImaPeppaPig: checks 
*** TURN *** [8c 3h 7c] [2c]
BE4077: checks 
ImaPeppaPig: bets $2
BE4077: calls $2
*** RIVER *** [8c 3h 7c 2c] [7s]
BE4077: checks 
ImaPeppaPig: checks 
*** SHOW DOWN ***
BE4077: shows [Td 6h] (a pair of Sevens)
ImaPeppaPig: shows [Kc Qd] (a pair of Sevens - King kicker)
ImaPeppaPig collected $9.50 from pot
*** SUMMARY ***
Total pot $10 | Rake $0.50 
Board [8c 3h 7c 2c 7s]
Seat 1: ImaPeppaPig showed [Kc Qd] and won ($9.50) with a pair of Sevens
Seat 2: AlexPinsk1 folded before Flop (didn't bet)
Seat 3: sta$igk folded before Flop (didn't bet)
Seat 4: app1e_j@ck (button) folded before Flop (didn't bet)
Seat 5: BE4077 (small blind) showed [Td 6h] and lost with a pair of Sevens
Seat 6: MAO_DZEDYN_S (big blind) folded before Flop



PokerStars Hand #254282376904:  Hold'em No Limit ($0.50/$1.00 USD) - 2025/01/09 19:28:49 WET [2025/01/09 14:28:49 ET]
Table 'Dagmar II' 6-max Seat #5 is the button
Seat 1: ImaPeppaPig ($112.86 in chips) 
Seat 2: AlexPinsk1 ($105.14 in chips) 
Seat 3: sta$igk ($102.38 in chips) 
Seat 4: app1e_j@ck ($157.16 in chips) 
Seat 5: BE4077 ($42.90 in chips) 
Seat 6: MAO_DZEDYN_S ($159.85 in chips) 
MAO_DZEDYN_S: posts small blind $0.50
ImaPeppaPig: posts big blind $1
*** HOLE CARDS ***
AlexPinsk1: folds 
sta$igk: folds 
app1e_j@ck: raises $1.50 to $2.50
BE4077: calls $2.50
MAO_DZEDYN_S: folds 
ImaPeppaPig: folds 
*** FLOP *** [Jh 4d Qd]
app1e_j@ck: bets $2.04
BE4077: folds 
Uncalled bet ($2.04) returned to app1e_j@ck
app1e_j@ck collected $6.18 from pot
app1e_j@ck: doesn't show hand 
*** SUMMARY ***
Total pot $6.50 | Rake $0.32 
Board [Jh 4d Qd]
Seat 1: ImaPeppaPig (big blind) folded before Flop
Seat 2: AlexPinsk1 folded before Flop (didn't bet)
Seat 3: sta$igk folded before Flop (didn't bet)
Seat 4: app1e_j@ck collected ($6.18)
Seat 5: BE4077 (button) folded on the Flop
Seat 6: MAO_DZEDYN_S (small blind) folded before Flop



PokerStars Hand #254282384217:  Hold'em No Limit ($0.50/$1.00 USD) - 2025/01/09 19:29:13 WET [2025/01/09 14:29:13 ET]
Table 'Dagmar II' 6-max Seat #6 is the button
Seat 1: ImaPeppaPig ($111.86 in chips) 
Seat 2: AlexPinsk1 ($105.14 in chips) 
Seat 3: sta$igk ($102.38 in chips) 
Seat 4: app1e_j@ck ($160.84 in chips) 
Seat 5: BE4077 ($40.40 in chips) 
Seat 6: MAO_DZEDYN_S ($159.35 in chips) 
ImaPeppaPig: posts small blind $0.50
AlexPinsk1: posts big blind $1
*** HOLE CARDS ***
sta$igk: folds 
app1e_j@ck: folds 
BE4077: folds 
MAO_DZEDYN_S: raises $1.50 to $2.50
ImaPeppaPig: folds 
AlexPinsk1: calls $1.50
*** FLOP *** [5d 6c 3s]
AlexPinsk1: checks 
MAO_DZEDYN_S: bets $3.92
AlexPinsk1: calls $3.92
*** TURN *** [5d 6c 3s] [9h]
AlexPinsk1: checks 
MAO_DZEDYN_S: checks 
*** RIVER *** [5d 6c 3s 9h] [5s]
AlexPinsk1: bets $19.50
MAO_DZEDYN_S: folds 
Uncalled bet ($19.50) returned to AlexPinsk1
AlexPinsk1 collected $12.67 from pot
AlexPinsk1: doesn't show hand 
*** SUMMARY ***
Total pot $13.34 | Rake $0.67 
Board [5d 6c 3s 9h 5s]
Seat 1: ImaPeppaPig (small blind) folded before Flop
Seat 2: AlexPinsk1 (big blind) collected ($12.67)
Seat 3: sta$igk folded before Flop (didn't bet)
Seat 4: app1e_j@ck folded before Flop (didn't bet)
Seat 5: BE4077 folded before Flop (didn't bet)
Seat 6: MAO_DZEDYN_S (button) folded on the River



PokerStars Hand #254282422975:  Hold'em No Limit ($0.50/$1.00 USD) - 2025/01/09 19:31:17 WET [2025/01/09 14:31:17 ET]
Table 'Dagmar II' 6-max Seat #1 is the button
Seat 1: ImaPeppaPig ($111.36 in chips) 
Seat 2: AlexPinsk1 ($111.39 in chips) 
Seat 3: sta$igk ($102.38 in chips) 
Seat 4: app1e_j@ck ($160.84 in chips) 
Seat 5: BE4077 ($40.40 in chips) 
Seat 6: MAO_DZEDYN_S ($152.93 in chips) 
AlexPinsk1: posts small blind $0.50
sta$igk: posts big blind $1
*** HOLE CARDS ***
app1e_j@ck: raises $1.50 to $2.50
BE4077: folds 
MAO_DZEDYN_S: folds 
ImaPeppaPig: folds 
AlexPinsk1: folds 
sta$igk: folds 
Uncalled bet ($1.50) returned to app1e_j@ck
app1e_j@ck collected $2.50 from pot
app1e_j@ck: doesn't show hand 
*** SUMMARY ***
Total pot $2.50 | Rake $0 
Seat 1: ImaPeppaPig (button) folded before Flop (didn't bet)
Seat 2: AlexPinsk1 (small blind) folded before Flop
Seat 3: sta$igk (big blind) folded before Flop
Seat 4: app1e_j@ck collected ($2.50)
Seat 5: BE4077 folded before Flop (didn't bet)
Seat 6: MAO_DZEDYN_S folded before Flop (didn't bet)



PokerStars Hand #254282429713:  Hold'em No Limit ($0.50/$1.00 USD) - 2025/01/09 19:31:39 WET [2025/01/09 14:31:39 ET]
Table 'Dagmar II' 6-max Seat #2 is the button
Seat 1: ImaPeppaPig ($111.36 in chips) 
Seat 2: AlexPinsk1 ($110.89 in chips) 
Seat 3: sta$igk ($101.38 in chips) 
Seat 4: app1e_j@ck ($162.34 in chips) 
Seat 5: BE4077 ($40.40 in chips) 
Seat 6: MAO_DZEDYN_S ($152.93 in chips) 
sta$igk: posts small blind $0.50
app1e_j@ck: posts big blind $1
*** HOLE CARDS ***
BE4077: calls $1
MAO_DZEDYN_S: folds 
ImaPeppaPig: folds 
AlexPinsk1: raises $3.50 to $4.50
sta$igk: folds 
app1e_j@ck: folds 
BE4077: calls $3.50
*** FLOP *** [Ac Kd Jd]
BE4077: checks 
AlexPinsk1: checks 
*** TURN *** [Ac Kd Jd] [Tc]
BE4077: checks 
AlexPinsk1: bets $7.49
BE4077: folds 
Uncalled bet ($7.49) returned to AlexPinsk1
AlexPinsk1 collected $9.98 from pot
AlexPinsk1: doesn't show hand 
*** SUMMARY ***
Total pot $10.50 | Rake $0.52 
Board [Ac Kd Jd Tc]
Seat 1: ImaPeppaPig folded before Flop (didn't bet)
Seat 2: AlexPinsk1 (button) collected ($9.98)
Seat 3: sta$igk (small blind) folded before Flop
Seat 4: app1e_j@ck (big blind) folded before Flop
Seat 5: BE4077 folded on the Turn
Seat 6: MAO_DZEDYN_S folded before Flop (didn't bet)



PokerStars Hand #254282446781:  Hold'em No Limit ($0.50/$1.00 USD) - 2025/01/09 19:32:36 WET [2025/01/09 14:32:36 ET]
Table 'Dagmar II' 6-max Seat #3 is the button
Seat 1: ImaPeppaPig ($111.36 in chips) 
Seat 2: AlexPinsk1 ($116.37 in chips) 
Seat 3: sta$igk ($100.88 in chips) 
Seat 4: app1e_j@ck ($161.34 in chips) 
Seat 5: BE4077 ($35.90 in chips) 
Seat 6: MAO_DZEDYN_S ($152.93 in chips) 
app1e_j@ck: posts small blind $0.50
BE4077: posts big blind $1
*** HOLE CARDS ***
MAO_DZEDYN_S: folds 
ImaPeppaPig: raises $1.50 to $2.50
AlexPinsk1: folds 
sta$igk: folds 
app1e_j@ck: folds 
BE4077: raises $5.50 to $8
ImaPeppaPig: raises $103.36 to $111.36 and is all-in
BE4077: calls $27.90 and is all-in
Uncalled bet ($75.46) returned to ImaPeppaPig
*** FLOP *** [2c Jd Jc]
*** TURN *** [2c Jd Jc] [6c]
*** RIVER *** [2c Jd Jc 6c] [Th]
*** SHOW DOWN ***
BE4077: shows [5s Tc] (two pair, Jacks and Tens)
ImaPeppaPig: shows [As Kd] (a pair of Jacks)
BE4077 collected $69.80 from pot
*** SUMMARY ***
Total pot $72.30 | Rake $2.50 
Board [2c Jd Jc 6c Th]
Seat 1: ImaPeppaPig showed [As Kd] and lost with a pair of Jacks
Seat 2: AlexPinsk1 folded before Flop (didn't bet)
Seat 3: sta$igk (button) folded before Flop (didn't bet)
Seat 4: app1e_j@ck (small blind) folded before Flop
Seat 5: BE4077 (big blind) showed [5s Tc] and won ($69.80) with two pair, Jacks and Tens
Seat 6: MAO_DZEDYN_S folded before Flop (didn't bet)



PokerStars Hand #254282460605:  Hold'em No Limit ($0.50/$1.00 USD) - 2025/01/09 19:33:22 WET [2025/01/09 14:33:22 ET]
Table 'Dagmar II' 6-max Seat #4 is the button
Seat 1: ImaPeppaPig ($100 in chips) 
Seat 2: AlexPinsk1 ($116.37 in chips) 
Seat 3: sta$igk ($100.88 in chips) 
Seat 4: app1e_j@ck ($160.84 in chips) 
Seat 5: BE4077 ($69.80 in chips) 
Seat 6: MAO_DZEDYN_S ($152.93 in chips) 
BE4077: posts small blind $0.50
MAO_DZEDYN_S: posts big blind $1
*** HOLE CARDS ***
ImaPeppaPig: folds 
AlexPinsk1: folds 
sta$igk: folds 
app1e_j@ck: raises $1.50 to $2.50
BE4077: calls $2
MAO_DZEDYN_S: calls $1.50
*** FLOP *** [3d Jc Qd]
BE4077: checks 
MAO_DZEDYN_S: checks 
app1e_j@ck: checks 
*** TURN *** [3d Jc Qd] [9h]
BE4077: checks 
MAO_DZEDYN_S: checks 
app1e_j@ck: bets $5.84
BE4077: folds 
MAO_DZEDYN_S: folds 
Uncalled bet ($5.84) returned to app1e_j@ck
app1e_j@ck collected $7.12 from pot
app1e_j@ck: doesn't show hand 
*** SUMMARY ***
Total pot $7.50 | Rake $0.38 
Board [3d Jc Qd 9h]
Seat 1: ImaPeppaPig folded before Flop (didn't bet)
Seat 2: AlexPinsk1 folded before Flop (didn't bet)
Seat 3: sta$igk folded before Flop (didn't bet)
Seat 4: app1e_j@ck (button) collected ($7.12)
Seat 5: BE4077 (small blind) folded on the Turn
Seat 6: MAO_DZEDYN_S (big blind) folded on the Turn



PokerStars Hand #254282479039:  Hold'em No Limit ($0.50/$1.00 USD) - 2025/01/09 19:34:22 WET [2025/01/09 14:34:22 ET]
Table 'Dagmar II' 6-max Seat #5 is the button
Seat 1: ImaPeppaPig ($100 in chips) 
Seat 2: AlexPinsk1 ($116.37 in chips) 
Seat 3: sta$igk ($100.88 in chips) 
Seat 4: app1e_j@ck ($165.46 in chips) 
Seat 5: BE4077 ($67.30 in chips) 
Seat 6: MAO_DZEDYN_S ($150.43 in chips) 
MAO_DZEDYN_S: posts small blind $0.50
ImaPeppaPig: posts big blind $1
*** HOLE CARDS ***
AlexPinsk1: folds 
sta$igk: folds 
app1e_j@ck: folds 
BE4077: calls $1
MAO_DZEDYN_S: raises $3.50 to $4.50
ImaPeppaPig: folds 
BE4077: folds 
Uncalled bet ($3.50) returned to MAO_DZEDYN_S
MAO_DZEDYN_S collected $3 from pot
MAO_DZEDYN_S: doesn't show hand 
*** SUMMARY ***
Total pot $3 | Rake $0 
Seat 1: ImaPeppaPig (big blind) folded before Flop
Seat 2: AlexPinsk1 folded before Flop (didn't bet)
Seat 3: sta$igk folded before Flop (didn't bet)
Seat 4: app1e_j@ck folded before Flop (didn't bet)
Seat 5: BE4077 (button) folded before Flop
Seat 6: MAO_DZEDYN_S (small blind) collected ($3)



PokerStars Hand #254282485864:  Hold'em No Limit ($0.50/$1.00 USD) - 2025/01/09 19:34:44 WET [2025/01/09 14:34:44 ET]
Table 'Dagmar II' 6-max Seat #6 is the button
Seat 1: ImaPeppaPig ($100 in chips) 
Seat 2: AlexPinsk1 ($116.37 in chips) 
Seat 3: sta$igk ($100.88 in chips) 
Seat 4: app1e_j@ck ($165.46 in chips) 
Seat 5: BE4077 ($66.30 in chips) 
Seat 6: MAO_DZEDYN_S ($152.43 in chips) 
ImaPeppaPig: posts small blind $0.50
AlexPinsk1: posts big blind $1
*** HOLE CARDS ***
sta$igk: folds 
app1e_j@ck: folds 
BE4077: calls $1
MAO_DZEDYN_S: raises $3 to $4
ImaPeppaPig: folds 
AlexPinsk1: calls $3
BE4077: folds 
*** FLOP *** [6c 3h Ad]
AlexPinsk1: checks 
MAO_DZEDYN_S: bets $2.71
AlexPinsk1: folds 
Uncalled bet ($2.71) returned to MAO_DZEDYN_S
MAO_DZEDYN_S collected $9.02 from pot
MAO_DZEDYN_S: doesn't show hand 
*** SUMMARY ***
Total pot $9.50 | Rake $0.48 
Board [6c 3h Ad]
Seat 1: ImaPeppaPig (small blind) folded before Flop
Seat 2: AlexPinsk1 (big blind) folded on the Flop
Seat 3: sta$igk folded before Flop (didn't bet)
Seat 4: app1e_j@ck folded before Flop (didn't bet)
Seat 5: BE4077 folded before Flop
Seat 6: MAO_DZEDYN_S (button) collected ($9.02)



PokerStars Hand #254282497668:  Hold'em No Limit ($0.50/$1.00 USD) - 2025/01/09 19:35:23 WET [2025/01/09 14:35:23 ET]
Table 'Dagmar II' 6-max Seat #1 is the button
Seat 1: ImaPeppaPig ($100 in chips) 
Seat 2: AlexPinsk1 ($112.37 in chips) 
Seat 3: sta$igk ($100.88 in chips) 
Seat 4: app1e_j@ck ($165.46 in chips) 
Seat 5: BE4077 ($65.30 in chips) 
Seat 6: MAO_DZEDYN_S ($157.45 in chips) 
AlexPinsk1: posts small blind $0.50
sta$igk: posts big blind $1
*** HOLE CARDS ***
app1e_j@ck: raises $2 to $3
BE4077: folds 
MAO_DZEDYN_S: folds 
ImaPeppaPig: folds 
AlexPinsk1: folds 
sta$igk: folds 
Uncalled bet ($2) returned to app1e_j@ck
app1e_j@ck collected $2.50 from pot
app1e_j@ck: doesn't show hand 
*** SUMMARY ***
Total pot $2.50 | Rake $0 
Seat 1: ImaPeppaPig (button) folded before Flop (didn't bet)
Seat 2: AlexPinsk1 (small blind) folded before Flop
Seat 3: sta$igk (big blind) folded before Flop
Seat 4: app1e_j@ck collected ($2.50)
Seat 5: BE4077 folded before Flop (didn't bet)
Seat 6: MAO_DZEDYN_S folded before Flop (didn't bet)



PokerStars Hand #254282501742:  Hold'em No Limit ($0.50/$1.00 USD) - 2025/01/09 19:35:37 WET [2025/01/09 14:35:37 ET]
Table 'Dagmar II' 6-max Seat #2 is the button
Seat 1: ImaPeppaPig ($100 in chips) 
Seat 2: AlexPinsk1 ($111.87 in chips) 
Seat 3: sta$igk ($100 in chips) 
Seat 4: app1e_j@ck ($166.96 in chips) 
Seat 5: BE4077 ($65.30 in chips) 
Seat 6: MAO_DZEDYN_S ($157.45 in chips) 
sta$igk: posts small blind $0.50
app1e_j@ck: posts big blind $1
*** HOLE CARDS ***
BE4077: calls $1
MAO_DZEDYN_S: folds 
ImaPeppaPig: folds 
AlexPinsk1: raises $2.50 to $3.50
sta$igk: folds 
app1e_j@ck: folds 
BE4077: calls $2.50
*** FLOP *** [Kc 2h 9c]
BE4077: checks 
AlexPinsk1: bets $4.04
BE4077: calls $4.04
*** TURN *** [Kc 2h 9c] [4c]
BE4077: checks 
AlexPinsk1: checks 
*** RIVER *** [Kc 2h 9c 4c] [2c]
BE4077: checks 
AlexPinsk1: checks 
*** SHOW DOWN ***
BE4077: shows [6d 8d] (a pair of Deuces)
AlexPinsk1: shows [Ad 4d] (two pair, Fours and Deuces)
AlexPinsk1 collected $15.75 from pot
*** SUMMARY ***
Total pot $16.58 | Rake $0.83 
Board [Kc 2h 9c 4c 2c]
Seat 1: ImaPeppaPig folded before Flop (didn't bet)
Seat 2: AlexPinsk1 (button) showed [Ad 4d] and won ($15.75) with two pair, Fours and Deuces
Seat 3: sta$igk (small blind) folded before Flop
Seat 4: app1e_j@ck (big blind) folded before Flop
Seat 5: BE4077 showed [6d 8d] and lost with a pair of Deuces
Seat 6: MAO_DZEDYN_S folded before Flop (didn't bet)



PokerStars Hand #254282513774:  Hold'em No Limit ($0.50/$1.00 USD) - 2025/01/09 19:36:17 WET [2025/01/09 14:36:17 ET]
Table 'Dagmar II' 6-max Seat #3 is the button
Seat 1: ImaPeppaPig ($100 in chips) 
Seat 2: AlexPinsk1 ($120.08 in chips) 
Seat 3: sta$igk ($100 in chips) 
Seat 4: app1e_j@ck ($165.96 in chips) 
Seat 5: BE4077 ($57.76 in chips) 
Seat 6: MAO_DZEDYN_S ($157.45 in chips) 
app1e_j@ck: posts small blind $0.50
BE4077: posts big blind $1
*** HOLE CARDS ***
MAO_DZEDYN_S: raises $1.25 to $2.25
ImaPeppaPig: folds 
AlexPinsk1: folds 
sta$igk: folds 
app1e_j@ck: folds 
BE4077: folds 
Uncalled bet ($1.25) returned to MAO_DZEDYN_S
MAO_DZEDYN_S collected $2.50 from pot
MAO_DZEDYN_S: doesn't show hand 
*** SUMMARY ***
Total pot $2.50 | Rake $0 
Seat 1: ImaPeppaPig folded before Flop (didn't bet)
Seat 2: AlexPinsk1 folded before Flop (didn't bet)
Seat 3: sta$igk (button) folded before Flop (didn't bet)
Seat 4: app1e_j@ck (small blind) folded before Flop
Seat 5: BE4077 (big blind) folded before Flop
Seat 6: MAO_DZEDYN_S collected ($2.50)



PokerStars Hand #254282521322:  Hold'em No Limit ($0.50/$1.00 USD) - 2025/01/09 19:36:43 WET [2025/01/09 14:36:43 ET]
Table 'Dagmar II' 6-max Seat #4 is the button
Seat 1: ImaPeppaPig ($100 in chips) 
Seat 2: AlexPinsk1 ($120.08 in chips) 
Seat 3: sta$igk ($100 in chips) 
Seat 4: app1e_j@ck ($165.46 in chips) 
Seat 5: BE4077 ($56.76 in chips) 
Seat 6: MAO_DZEDYN_S ($158.95 in chips) 
BE4077: posts small blind $0.50
MAO_DZEDYN_S: posts big blind $1
*** HOLE CARDS ***
ImaPeppaPig: folds 
AlexPinsk1: folds 
sta$igk: folds 
app1e_j@ck: raises $1.50 to $2.50
BE4077: calls $2
MAO_DZEDYN_S: folds 
*** FLOP *** [4d Qd Th]
BE4077: checks 
app1e_j@ck: checks 
*** TURN *** [4d Qd Th] [7d]
BE4077: checks 
app1e_j@ck: checks 
*** RIVER *** [4d Qd Th 7d] [3h]
BE4077: checks 
app1e_j@ck: checks 
*** SHOW DOWN ***
BE4077: shows [2c 2s] (a pair of Deuces)
app1e_j@ck: shows [Jh 7h] (a pair of Sevens)
app1e_j@ck collected $5.70 from pot
*** SUMMARY ***
Total pot $6 | Rake $0.30 
Board [4d Qd Th 7d 3h]
Seat 1: ImaPeppaPig folded before Flop (didn't bet)
Seat 2: AlexPinsk1 folded before Flop (didn't bet)
Seat 3: sta$igk folded before Flop (didn't bet)
Seat 4: app1e_j@ck (button) showed [Jh 7h] and won ($5.70) with a pair of Sevens
Seat 5: BE4077 (small blind) showed [2c 2s] and lost with a pair of Deuces
Seat 6: MAO_DZEDYN_S (big blind) folded before Flop



PokerStars Hand #254282539378:  Hold'em No Limit ($0.50/$1.00 USD) - 2025/01/09 19:37:43 WET [2025/01/09 14:37:43 ET]
Table 'Dagmar II' 6-max Seat #5 is the button
Seat 1: ImaPeppaPig ($100 in chips) 
Seat 2: AlexPinsk1 ($120.08 in chips) 
Seat 3: sta$igk ($100 in chips) 
Seat 4: app1e_j@ck ($168.66 in chips) 
Seat 5: BE4077 ($54.26 in chips) 
Seat 6: MAO_DZEDYN_S ($157.95 in chips) 
MAO_DZEDYN_S: posts small blind $0.50
ImaPeppaPig: posts big blind $1
*** HOLE CARDS ***
AlexPinsk1: folds 
sta$igk: folds 
app1e_j@ck: raises $1.50 to $2.50
BE4077: folds 
MAO_DZEDYN_S: folds 
ImaPeppaPig: folds 
Uncalled bet ($1.50) returned to app1e_j@ck
app1e_j@ck collected $2.50 from pot
app1e_j@ck: doesn't show hand 
*** SUMMARY ***
Total pot $2.50 | Rake $0 
Seat 1: ImaPeppaPig (big blind) folded before Flop
Seat 2: AlexPinsk1 folded before Flop (didn't bet)
Seat 3: sta$igk folded before Flop (didn't bet)
Seat 4: app1e_j@ck collected ($2.50)
Seat 5: BE4077 (button) folded before Flop (didn't bet)
Seat 6: MAO_DZEDYN_S (small blind) folded before Flop



PokerStars Hand #254282546857:  Hold'em No Limit ($0.50/$1.00 USD) - 2025/01/09 19:38:07 WET [2025/01/09 14:38:07 ET]
Table 'Dagmar II' 6-max Seat #6 is the button
Seat 1: ImaPeppaPig ($100 in chips) 
Seat 2: AlexPinsk1 ($120.08 in chips) 
Seat 3: sta$igk ($100 in chips) 
Seat 4: app1e_j@ck ($170.16 in chips) 
Seat 5: BE4077 ($54.26 in chips) 
Seat 6: MAO_DZEDYN_S ($157.45 in chips) 
ImaPeppaPig: posts small blind $0.50
AlexPinsk1: posts big blind $1
*** HOLE CARDS ***
sta$igk: raises $1.50 to $2.50
app1e_j@ck: folds 
BE4077: folds 
MAO_DZEDYN_S: folds 
ImaPeppaPig: folds 
AlexPinsk1: calls $1.50
*** FLOP *** [Jc Qh 9d]
AlexPinsk1: checks 
sta$igk: bets $1.72
AlexPinsk1: folds 
Uncalled bet ($1.72) returned to sta$igk
sta$igk collected $5.22 from pot
sta$igk: doesn't show hand 
*** SUMMARY ***
Total pot $5.50 | Rake $0.28 
Board [Jc Qh 9d]
Seat 1: ImaPeppaPig (small blind) folded before Flop
Seat 2: AlexPinsk1 (big blind) folded on the Flop
Seat 3: sta$igk collected ($5.22)
Seat 4: app1e_j@ck folded before Flop (didn't bet)
Seat 5: BE4077 folded before Flop (didn't bet)
Seat 6: MAO_DZEDYN_S (button) folded before Flop (didn't bet)



PokerStars Hand #254282558490:  Hold'em No Limit ($0.50/$1.00 USD) - 2025/01/09 19:38:45 WET [2025/01/09 14:38:45 ET]
Table 'Dagmar II' 6-max Seat #1 is the button
Seat 1: ImaPeppaPig ($100 in chips) 
Seat 2: AlexPinsk1 ($117.58 in chips) 
Seat 3: sta$igk ($102.72 in chips) 
Seat 4: app1e_j@ck ($170.16 in chips) 
Seat 5: BE4077 ($54.26 in chips) 
Seat 6: MAO_DZEDYN_S ($157.45 in chips) 
AlexPinsk1: posts small blind $0.50
sta$igk: posts big blind $1
*** HOLE CARDS ***
app1e_j@ck: raises $1.50 to $2.50
BE4077: calls $2.50
MAO_DZEDYN_S: folds 
ImaPeppaPig: raises $7.50 to $10
AlexPinsk1: folds 
sta$igk: folds 
app1e_j@ck: calls $7.50
BE4077: folds 
*** FLOP *** [9c Kh 2c]
app1e_j@ck: checks 
ImaPeppaPig: bets $7.07
app1e_j@ck: folds 
Uncalled bet ($7.07) returned to ImaPeppaPig
ImaPeppaPig collected $22.80 from pot
ImaPeppaPig: doesn't show hand 
*** SUMMARY ***
Total pot $24 | Rake $1.20 
Board [9c Kh 2c]
Seat 1: ImaPeppaPig (button) collected ($22.80)
Seat 2: AlexPinsk1 (small blind) folded before Flop
Seat 3: sta$igk (big blind) folded before Flop
Seat 4: app1e_j@ck folded on the Flop
Seat 5: BE4077 folded before Flop
Seat 6: MAO_DZEDYN_S folded before Flop (didn't bet)



PokerStars Hand #254282575381:  Hold'em No Limit ($0.50/$1.00 USD) - 2025/01/09 19:39:39 WET [2025/01/09 14:39:39 ET]
Table 'Dagmar II' 6-max Seat #2 is the button
Seat 1: ImaPeppaPig ($112.80 in chips) 
Seat 2: AlexPinsk1 ($117.08 in chips) 
Seat 3: sta$igk ($101.72 in chips) 
Seat 4: app1e_j@ck ($160.16 in chips) 
Seat 5: BE4077 ($51.76 in chips) 
Seat 6: MAO_DZEDYN_S ($157.45 in chips) 
sta$igk: posts small blind $0.50
app1e_j@ck: posts big blind $1
*** HOLE CARDS ***
BE4077: folds 
MAO_DZEDYN_S: raises $1.25 to $2.25
ImaPeppaPig: folds 
AlexPinsk1: folds 
sta$igk: folds 
app1e_j@ck: folds 
Uncalled bet ($1.25) returned to MAO_DZEDYN_S
MAO_DZEDYN_S collected $2.50 from pot
MAO_DZEDYN_S: doesn't show hand 
*** SUMMARY ***
Total pot $2.50 | Rake $0 
Seat 1: ImaPeppaPig folded before Flop (didn't bet)
Seat 2: AlexPinsk1 (button) folded before Flop (didn't bet)
Seat 3: sta$igk (small blind) folded before Flop
Seat 4: app1e_j@ck (big blind) folded before Flop
Seat 5: BE4077 folded before Flop (didn't bet)
Seat 6: MAO_DZEDYN_S collected ($2.50)



PokerStars Hand #254282583341:  Hold'em No Limit ($0.50/$1.00 USD) - 2025/01/09 19:40:05 WET [2025/01/09 14:40:05 ET]
Table 'Dagmar II' 6-max Seat #3 is the button
Seat 1: ImaPeppaPig ($112.80 in chips) 
Seat 2: AlexPinsk1 ($117.08 in chips) 
Seat 3: sta$igk ($101.22 in chips) 
Seat 4: app1e_j@ck ($159.16 in chips) 
Seat 5: BE4077 ($51.76 in chips) 
Seat 6: MAO_DZEDYN_S ($158.95 in chips) 
app1e_j@ck: posts small blind $0.50
BE4077: posts big blind $1
*** HOLE CARDS ***
MAO_DZEDYN_S: folds 
ImaPeppaPig: folds 
AlexPinsk1: folds 
sta$igk: folds 
app1e_j@ck: raises $2 to $3
BE4077: calls $2
*** FLOP *** [8d As 2c]
app1e_j@ck: checks 
BE4077: checks 
*** TURN *** [8d As 2c] [9d]
app1e_j@ck: checks 
BE4077: checks 
*** RIVER *** [8d As 2c 9d] [7s]
app1e_j@ck: bets $1.88
BE4077: folds 
Uncalled bet ($1.88) returned to app1e_j@ck
app1e_j@ck collected $5.70 from pot
app1e_j@ck: doesn't show hand 
*** SUMMARY ***
Total pot $6 | Rake $0.30 
Board [8d As 2c 9d 7s]
Seat 1: ImaPeppaPig folded before Flop (didn't bet)
Seat 2: AlexPinsk1 folded before Flop (didn't bet)
Seat 3: sta$igk (button) folded before Flop (didn't bet)
Seat 4: app1e_j@ck (small blind) collected ($5.70)
Seat 5: BE4077 (big blind) folded on the River
Seat 6: MAO_DZEDYN_S folded before Flop (didn't bet)



PokerStars Hand #254282593073:  Hold'em No Limit ($0.50/$1.00 USD) - 2025/01/09 19:40:37 WET [2025/01/09 14:40:37 ET]
Table 'Dagmar II' 6-max Seat #4 is the button
Seat 1: ImaPeppaPig ($112.80 in chips) 
Seat 2: AlexPinsk1 ($117.08 in chips) 
Seat 3: sta$igk ($101.22 in chips) 
Seat 4: app1e_j@ck ($161.86 in chips) 
Seat 5: BE4077 ($48.76 in chips) 
Seat 6: MAO_DZEDYN_S ($158.95 in chips) 
BE4077: posts small blind $0.50
MAO_DZEDYN_S: posts big blind $1
*** HOLE CARDS ***
ImaPeppaPig: folds 
AlexPinsk1: folds 
sta$igk: raises $1.50 to $2.50
app1e_j@ck: folds 
BE4077: folds 
MAO_DZEDYN_S: folds 
Uncalled bet ($1.50) returned to sta$igk
sta$igk collected $2.50 from pot
sta$igk: doesn't show hand 
*** SUMMARY ***
Total pot $2.50 | Rake $0 
Seat 1: ImaPeppaPig folded before Flop (didn't bet)
Seat 2: AlexPinsk1 folded before Flop (didn't bet)
Seat 3: sta$igk collected ($2.50)
Seat 4: app1e_j@ck (button) folded before Flop (didn't bet)
Seat 5: BE4077 (small blind) folded before Flop
Seat 6: MAO_DZEDYN_S (big blind) folded before Flop



PokerStars Hand #254282597773:  Hold'em No Limit ($0.50/$1.00 USD) - 2025/01/09 19:40:52 WET [2025/01/09 14:40:52 ET]
Table 'Dagmar II' 6-max Seat #5 is the button
Seat 1: ImaPeppaPig ($112.80 in chips) 
Seat 2: AlexPinsk1 ($117.08 in chips) 
Seat 3: sta$igk ($102.72 in chips) 
Seat 4: app1e_j@ck ($161.86 in chips) 
Seat 5: BE4077 ($48.26 in chips) 
Seat 6: MAO_DZEDYN_S ($157.95 in chips) 
MAO_DZEDYN_S: posts small blind $0.50
ImaPeppaPig: posts big blind $1
*** HOLE CARDS ***
AlexPinsk1: folds 
sta$igk: raises $1.50 to $2.50
app1e_j@ck: folds 
BE4077: folds 
MAO_DZEDYN_S: folds 
ImaPeppaPig: folds 
Uncalled bet ($1.50) returned to sta$igk
sta$igk collected $2.50 from pot
sta$igk: doesn't show hand 
*** SUMMARY ***
Total pot $2.50 | Rake $0 
Seat 1: ImaPeppaPig (big blind) folded before Flop
Seat 2: AlexPinsk1 folded before Flop (didn't bet)
Seat 3: sta$igk collected ($2.50)
Seat 4: app1e_j@ck folded before Flop (didn't bet)
Seat 5: BE4077 (button) folded before Flop (didn't bet)
Seat 6: MAO_DZEDYN_S (small blind) folded before Flop



PokerStars Hand #254282601908:  Hold'em No Limit ($0.50/$1.00 USD) - 2025/01/09 19:41:05 WET [2025/01/09 14:41:05 ET]
Table 'Dagmar II' 6-max Seat #6 is the button
Seat 1: ImaPeppaPig ($111.80 in chips) 
Seat 2: AlexPinsk1 ($117.08 in chips) 
Seat 3: sta$igk ($104.22 in chips) 
Seat 4: app1e_j@ck ($161.86 in chips) 
Seat 5: BE4077 ($48.26 in chips) 
Seat 6: MAO_DZEDYN_S ($157.45 in chips) 
ImaPeppaPig: posts small blind $0.50
AlexPinsk1: posts big blind $1
*** HOLE CARDS ***
sta$igk: folds 
app1e_j@ck: raises $1.50 to $2.50
BE4077: folds 
MAO_DZEDYN_S: raises $6 to $8.50
ImaPeppaPig: folds 
AlexPinsk1: folds 
app1e_j@ck: folds 
Uncalled bet ($6) returned to MAO_DZEDYN_S
MAO_DZEDYN_S collected $6.50 from pot
MAO_DZEDYN_S: doesn't show hand 
*** SUMMARY ***
Total pot $6.50 | Rake $0 
Seat 1: ImaPeppaPig (small blind) folded before Flop
Seat 2: AlexPinsk1 (big blind) folded before Flop
Seat 3: sta$igk folded before Flop (didn't bet)
Seat 4: app1e_j@ck folded before Flop
Seat 5: BE4077 folded before Flop (didn't bet)
Seat 6: MAO_DZEDYN_S (button) collected ($6.50)



PokerStars Hand #254282615155:  Hold'em No Limit ($0.50/$1.00 USD) - 2025/01/09 19:41:48 WET [2025/01/09 14:41:48 ET]
Table 'Dagmar II' 6-max Seat #1 is the button
Seat 1: ImaPeppaPig ($111.30 in chips) 
Seat 2: AlexPinsk1 ($116.08 in chips) 
Seat 3: sta$igk ($104.22 in chips) 
Seat 4: app1e_j@ck ($159.36 in chips) 
Seat 5: BE4077 ($48.26 in chips) 
Seat 6: MAO_DZEDYN_S ($161.45 in chips) 
AlexPinsk1: posts small blind $0.50
sta$igk: posts big blind $1
*** HOLE CARDS ***
app1e_j@ck: folds 
BE4077: folds 
MAO_DZEDYN_S: folds 
ImaPeppaPig: folds 
AlexPinsk1: folds 
Uncalled bet ($0.50) returned to sta$igk
sta$igk collected $1 from pot
sta$igk: doesn't show hand 
*** SUMMARY ***
Total pot $1 | Rake $0 
Seat 1: ImaPeppaPig (button) folded before Flop (didn't bet)
Seat 2: AlexPinsk1 (small blind) folded before Flop
Seat 3: sta$igk (big blind) collected ($1)
Seat 4: app1e_j@ck folded before Flop (didn't bet)
Seat 5: BE4077 folded before Flop (didn't bet)
Seat 6: MAO_DZEDYN_S folded before Flop (didn't bet)



PokerStars Hand #254282618655:  Hold'em No Limit ($0.50/$1.00 USD) - 2025/01/09 19:42:00 WET [2025/01/09 14:42:00 ET]
Table 'Dagmar II' 6-max Seat #2 is the button
Seat 1: ImaPeppaPig ($111.30 in chips) 
Seat 2: AlexPinsk1 ($115.58 in chips) 
Seat 3: sta$igk ($104.72 in chips) 
Seat 4: app1e_j@ck ($159.36 in chips) 
Seat 5: BE4077 ($48.26 in chips) 
Seat 6: MAO_DZEDYN_S ($161.45 in chips) 
sta$igk: posts small blind $0.50
app1e_j@ck: posts big blind $1
*** HOLE CARDS ***
BE4077: calls $1
MAO_DZEDYN_S: folds 
ImaPeppaPig: folds 
AlexPinsk1: folds 
sta$igk: folds 
app1e_j@ck: checks 
*** FLOP *** [Jh 9d 2s]
app1e_j@ck: checks 
BE4077: checks 
*** TURN *** [Jh 9d 2s] [Tc]
app1e_j@ck: checks 
BE4077: checks 
*** RIVER *** [Jh 9d 2s Tc] [9c]
app1e_j@ck: bets $1.59
BE4077: calls $1.59
*** SHOW DOWN ***
app1e_j@ck: shows [8h Kc] (a pair of Nines)
BE4077: shows [Ac Ts] (two pair, Tens and Nines)
BE4077 collected $5.40 from pot
*** SUMMARY ***
Total pot $5.68 | Rake $0.28 
Board [Jh 9d 2s Tc 9c]
Seat 1: ImaPeppaPig folded before Flop (didn't bet)
Seat 2: AlexPinsk1 (button) folded before Flop (didn't bet)
Seat 3: sta$igk (small blind) folded before Flop
Seat 4: app1e_j@ck (big blind) showed [8h Kc] and lost with a pair of Nines
Seat 5: BE4077 showed [Ac Ts] and won ($5.40) with two pair, Tens and Nines
Seat 6: MAO_DZEDYN_S folded before Flop (didn't bet)



PokerStars Hand #254282630109:  Hold'em No Limit ($0.50/$1.00 USD) - 2025/01/09 19:42:37 WET [2025/01/09 14:42:37 ET]
Table 'Dagmar II' 6-max Seat #3 is the button
Seat 1: ImaPeppaPig ($111.30 in chips) 
Seat 2: AlexPinsk1 ($115.58 in chips) 
Seat 3: sta$igk ($104.22 in chips) 
Seat 4: app1e_j@ck ($156.77 in chips) 
Seat 5: BE4077 ($51.07 in chips) 
Seat 6: MAO_DZEDYN_S ($161.45 in chips) 
app1e_j@ck: posts small blind $0.50
BE4077: posts big blind $1
*** HOLE CARDS ***
MAO_DZEDYN_S: folds 
ImaPeppaPig: folds 
AlexPinsk1: folds 
sta$igk: folds 
app1e_j@ck: calls $0.50
BE4077: checks 
*** FLOP *** [Th Ts 9s]
app1e_j@ck: checks 
BE4077: checks 
*** TURN *** [Th Ts 9s] [Kc]
app1e_j@ck: checks 
BE4077: checks 
*** RIVER *** [Th Ts 9s Kc] [7s]
app1e_j@ck: checks 
BE4077: bets $1
app1e_j@ck: folds 
Uncalled bet ($1) returned to BE4077
BE4077 collected $1.90 from pot
*** SUMMARY ***
Total pot $2 | Rake $0.10 
Board [Th Ts 9s Kc 7s]
Seat 1: ImaPeppaPig folded before Flop (didn't bet)
Seat 2: AlexPinsk1 folded before Flop (didn't bet)
Seat 3: sta$igk (button) folded before Flop (didn't bet)
Seat 4: app1e_j@ck (small blind) folded on the River
Seat 5: BE4077 (big blind) collected ($1.90)
Seat 6: MAO_DZEDYN_S folded before Flop (didn't bet)



PokerStars Hand #254282653700:  Hold'em No Limit ($0.50/$1.00 USD) - 2025/01/09 19:43:53 WET [2025/01/09 14:43:53 ET]
Table 'Dagmar II' 6-max Seat #4 is the button
Seat 1: ImaPeppaPig ($111.30 in chips) 
Seat 2: AlexPinsk1 ($115.58 in chips) 
Seat 3: sta$igk ($104.22 in chips) 
Seat 4: app1e_j@ck ($155.77 in chips) 
Seat 5: BE4077 ($51.97 in chips) 
Seat 6: MAO_DZEDYN_S ($161.45 in chips) 
BE4077: posts small blind $0.50
MAO_DZEDYN_S: posts big blind $1
*** HOLE CARDS ***
ImaPeppaPig: folds 
AlexPinsk1: raises $1.50 to $2.50
sta$igk: folds 
app1e_j@ck: folds 
BE4077: folds 
MAO_DZEDYN_S: folds 
Uncalled bet ($1.50) returned to AlexPinsk1
AlexPinsk1 collected $2.50 from pot
AlexPinsk1: doesn't show hand 
*** SUMMARY ***
Total pot $2.50 | Rake $0 
Seat 1: ImaPeppaPig folded before Flop (didn't bet)
Seat 2: AlexPinsk1 collected ($2.50)
Seat 3: sta$igk folded before Flop (didn't bet)
Seat 4: app1e_j@ck (button) folded before Flop (didn't bet)
Seat 5: BE4077 (small blind) folded before Flop
Seat 6: MAO_DZEDYN_S (big blind) folded before Flop



PokerStars Hand #254282659169:  Hold'em No Limit ($0.50/$1.00 USD) - 2025/01/09 19:44:10 WET [2025/01/09 14:44:10 ET]
Table 'Dagmar II' 6-max Seat #5 is the button
Seat 1: ImaPeppaPig ($111.30 in chips) 
Seat 2: AlexPinsk1 ($117.08 in chips) 
Seat 3: sta$igk ($104.22 in chips) 
Seat 4: app1e_j@ck ($155.77 in chips) 
Seat 5: BE4077 ($51.47 in chips) 
Seat 6: MAO_DZEDYN_S ($160.45 in chips) 
MAO_DZEDYN_S: posts small blind $0.50
ImaPeppaPig: posts big blind $1
*** HOLE CARDS ***
AlexPinsk1: folds 
sta$igk: folds 
app1e_j@ck: folds 
BE4077: calls $1
MAO_DZEDYN_S: folds 
ImaPeppaPig: checks 
*** FLOP *** [Qd Qs 7c]
ImaPeppaPig: checks 
BE4077: checks 
*** TURN *** [Qd Qs 7c] [Tc]
ImaPeppaPig: checks 
BE4077: checks 
*** RIVER *** [Qd Qs 7c Tc] [2h]
ImaPeppaPig: checks 
BE4077: checks 
*** SHOW DOWN ***
ImaPeppaPig: shows [9c As] (a pair of Queens)
BE4077: mucks hand 
ImaPeppaPig collected $2.38 from pot
*** SUMMARY ***
Total pot $2.50 | Rake $0.12 
Board [Qd Qs 7c Tc 2h]
Seat 1: ImaPeppaPig (big blind) showed [9c As] and won ($2.38) with a pair of Queens
Seat 2: AlexPinsk1 folded before Flop (didn't bet)
Seat 3: sta$igk folded before Flop (didn't bet)
Seat 4: app1e_j@ck folded before Flop (didn't bet)
Seat 5: BE4077 (button) mucked
Seat 6: MAO_DZEDYN_S (small blind) folded before Flop



PokerStars Hand #254282669808:  Hold'em No Limit ($0.50/$1.00 USD) - 2025/01/09 19:44:45 WET [2025/01/09 14:44:45 ET]
Table 'Dagmar II' 6-max Seat #6 is the button
Seat 1: ImaPeppaPig ($112.68 in chips) 
Seat 2: AlexPinsk1 ($117.08 in chips) 
Seat 3: sta$igk ($104.22 in chips) 
Seat 4: app1e_j@ck ($155.77 in chips) 
Seat 5: BE4077 ($50.47 in chips) 
Seat 6: MAO_DZEDYN_S ($159.95 in chips) 
ImaPeppaPig: posts small blind $0.50
AlexPinsk1: posts big blind $1
*** HOLE CARDS ***
sta$igk: folds 
app1e_j@ck: folds 
BE4077: folds 
MAO_DZEDYN_S: folds 
ImaPeppaPig: raises $2 to $3
AlexPinsk1: raises $6 to $9
ImaPeppaPig: folds 
Uncalled bet ($6) returned to AlexPinsk1
AlexPinsk1 collected $6 from pot
AlexPinsk1: doesn't show hand 
*** SUMMARY ***
Total pot $6 | Rake $0 
Seat 1: ImaPeppaPig (small blind) folded before Flop
Seat 2: AlexPinsk1 (big blind) collected ($6)
Seat 3: sta$igk folded before Flop (didn't bet)
Seat 4: app1e_j@ck folded before Flop (didn't bet)
Seat 5: BE4077 folded before Flop (didn't bet)
Seat 6: MAO_DZEDYN_S (button) folded before Flop (didn't bet)



PokerStars Hand #254282680204:  Hold'em No Limit ($0.50/$1.00 USD) - 2025/01/09 19:45:18 WET [2025/01/09 14:45:18 ET]
Table 'Dagmar II' 6-max Seat #1 is the button
Seat 1: ImaPeppaPig ($109.68 in chips) 
Seat 2: AlexPinsk1 ($120.08 in chips) 
Seat 3: sta$igk ($104.22 in chips) 
Seat 4: app1e_j@ck ($155.77 in chips) 
Seat 5: BE4077 ($50.47 in chips) 
Seat 6: MAO_DZEDYN_S ($159.95 in chips) 
AlexPinsk1: posts small blind $0.50
sta$igk: posts big blind $1
*** HOLE CARDS ***
app1e_j@ck: folds 
BE4077: folds 
MAO_DZEDYN_S: folds 
ImaPeppaPig: folds 
AlexPinsk1: folds 
Uncalled bet ($0.50) returned to sta$igk
sta$igk collected $1 from pot
sta$igk: doesn't show hand 
*** SUMMARY ***
Total pot $1 | Rake $0 
Seat 1: ImaPeppaPig (button) folded before Flop (didn't bet)
Seat 2: AlexPinsk1 (small blind) folded before Flop
Seat 3: sta$igk (big blind) collected ($1)
Seat 4: app1e_j@ck folded before Flop (didn't bet)
Seat 5: BE4077 folded before Flop (didn't bet)
Seat 6: MAO_DZEDYN_S folded before Flop (didn't bet)



PokerStars Hand #254282685400:  Hold'em No Limit ($0.50/$1.00 USD) - 2025/01/09 19:45:35 WET [2025/01/09 14:45:35 ET]
Table 'Dagmar II' 6-max Seat #2 is the button
Seat 1: ImaPeppaPig ($109.68 in chips) 
Seat 2: AlexPinsk1 ($119.58 in chips) 
Seat 3: sta$igk ($104.72 in chips) 
Seat 4: app1e_j@ck ($155.77 in chips) 
Seat 5: BE4077 ($50.47 in chips) 
Seat 6: MAO_DZEDYN_S ($159.95 in chips) 
sta$igk: posts small blind $0.50
app1e_j@ck: posts big blind $1
*** HOLE CARDS ***
BE4077: folds 
MAO_DZEDYN_S: folds 
ImaPeppaPig: folds 
AlexPinsk1: folds 
sta$igk: folds 
Uncalled bet ($0.50) returned to app1e_j@ck
app1e_j@ck collected $1 from pot
app1e_j@ck: doesn't show hand 
*** SUMMARY ***
Total pot $1 | Rake $0 
Seat 1: ImaPeppaPig folded before Flop (didn't bet)
Seat 2: AlexPinsk1 (button) folded before Flop (didn't bet)
Seat 3: sta$igk (small blind) folded before Flop
Seat 4: app1e_j@ck (big blind) collected ($1)
Seat 5: BE4077 folded before Flop (didn't bet)
Seat 6: MAO_DZEDYN_S folded before Flop (didn't bet)



PokerStars Hand #254282691108:  Hold'em No Limit ($0.50/$1.00 USD) - 2025/01/09 19:45:53 WET [2025/01/09 14:45:53 ET]
Table 'Dagmar II' 6-max Seat #3 is the button
Seat 1: ImaPeppaPig ($109.68 in chips) 
Seat 2: AlexPinsk1 ($119.58 in chips) 
Seat 3: sta$igk ($104.22 in chips) 
Seat 4: app1e_j@ck ($156.27 in chips) 
Seat 5: BE4077 ($50.47 in chips) 
Seat 6: MAO_DZEDYN_S ($159.95 in chips) 
app1e_j@ck: posts small blind $0.50
BE4077: posts big blind $1
*** HOLE CARDS ***
MAO_DZEDYN_S: raises $1.75 to $2.75
ImaPeppaPig: folds 
AlexPinsk1: folds 
sta$igk: folds 
app1e_j@ck: folds 
BE4077: folds 
Uncalled bet ($1.75) returned to MAO_DZEDYN_S
MAO_DZEDYN_S collected $2.50 from pot
MAO_DZEDYN_S: doesn't show hand 
*** SUMMARY ***
Total pot $2.50 | Rake $0 
Seat 1: ImaPeppaPig folded before Flop (didn't bet)
Seat 2: AlexPinsk1 folded before Flop (didn't bet)
Seat 3: sta$igk (button) folded before Flop (didn't bet)
Seat 4: app1e_j@ck (small blind) folded before Flop
Seat 5: BE4077 (big blind) folded before Flop
Seat 6: MAO_DZEDYN_S collected ($2.50)



PokerStars Hand #254282695432:  Hold'em No Limit ($0.50/$1.00 USD) - 2025/01/09 19:46:07 WET [2025/01/09 14:46:07 ET]
Table 'Dagmar II' 6-max Seat #4 is the button
Seat 1: ImaPeppaPig ($109.68 in chips) 
Seat 2: AlexPinsk1 ($119.58 in chips) 
Seat 3: sta$igk ($104.22 in chips) 
Seat 4: app1e_j@ck ($155.77 in chips) 
Seat 5: BE4077 ($49.47 in chips) 
Seat 6: MAO_DZEDYN_S ($161.45 in chips) 
BE4077: posts small blind $0.50
MAO_DZEDYN_S: posts big blind $1
*** HOLE CARDS ***
ImaPeppaPig: folds 
AlexPinsk1: raises $1.50 to $2.50
sta$igk: folds 
app1e_j@ck: folds 
BE4077: folds 
MAO_DZEDYN_S: folds 
Uncalled bet ($1.50) returned to AlexPinsk1
AlexPinsk1 collected $2.50 from pot
AlexPinsk1: doesn't show hand 
*** SUMMARY ***
Total pot $2.50 | Rake $0 
Seat 1: ImaPeppaPig folded before Flop (didn't bet)
Seat 2: AlexPinsk1 collected ($2.50)
Seat 3: sta$igk folded before Flop (didn't bet)
Seat 4: app1e_j@ck (button) folded before Flop (didn't bet)
Seat 5: BE4077 (small blind) folded before Flop
Seat 6: MAO_DZEDYN_S (big blind) folded before Flop



PokerStars Hand #254282700898:  Hold'em No Limit ($0.50/$1.00 USD) - 2025/01/09 19:46:25 WET [2025/01/09 14:46:25 ET]
Table 'Dagmar II' 6-max Seat #5 is the button
Seat 1: ImaPeppaPig ($109.68 in chips) 
Seat 2: AlexPinsk1 ($121.08 in chips) 
Seat 3: sta$igk ($104.22 in chips) 
Seat 4: app1e_j@ck ($155.77 in chips) 
Seat 5: BE4077 ($48.97 in chips) 
Seat 6: MAO_DZEDYN_S ($160.45 in chips) 
MAO_DZEDYN_S: posts small blind $0.50
ImaPeppaPig: posts big blind $1
*** HOLE CARDS ***
AlexPinsk1: folds 
sta$igk: folds 
app1e_j@ck: folds 
BE4077: folds 
MAO_DZEDYN_S: folds 
Uncalled bet ($0.50) returned to ImaPeppaPig
ImaPeppaPig collected $1 from pot
ImaPeppaPig: doesn't show hand 
*** SUMMARY ***
Total pot $1 | Rake $0 
Seat 1: ImaPeppaPig (big blind) collected ($1)
Seat 2: AlexPinsk1 folded before Flop (didn't bet)
Seat 3: sta$igk folded before Flop (didn't bet)
Seat 4: app1e_j@ck folded before Flop (didn't bet)
Seat 5: BE4077 (button) folded before Flop (didn't bet)
Seat 6: MAO_DZEDYN_S (small blind) folded before Flop



PokerStars Hand #254282706769:  Hold'em No Limit ($0.50/$1.00 USD) - 2025/01/09 19:46:44 WET [2025/01/09 14:46:44 ET]
Table 'Dagmar II' 6-max Seat #6 is the button
Seat 1: ImaPeppaPig ($110.18 in chips) 
Seat 2: AlexPinsk1 ($121.08 in chips) 
Seat 3: sta$igk ($104.22 in chips) 
Seat 4: app1e_j@ck ($155.77 in chips) 
Seat 5: BE4077 ($48.97 in chips) 
Seat 6: MAO_DZEDYN_S ($159.95 in chips) 
ImaPeppaPig: posts small blind $0.50
AlexPinsk1: posts big blind $1
*** HOLE CARDS ***
sta$igk: raises $1.50 to $2.50
app1e_j@ck: folds 
BE4077: folds 
MAO_DZEDYN_S: folds 
ImaPeppaPig: folds 
AlexPinsk1: calls $1.50
*** FLOP *** [2c 9h 8c]
AlexPinsk1: checks 
sta$igk: checks 
*** TURN *** [2c 9h 8c] [4c]
AlexPinsk1: bets $1.72
sta$igk: calls $1.72
*** RIVER *** [2c 9h 8c 4c] [7h]
AlexPinsk1: checks 
sta$igk: checks 
*** SHOW DOWN ***
AlexPinsk1: shows [8s Ts] (a pair of Eights)
sta$igk: mucks hand 
AlexPinsk1 collected $8.49 from pot
*** SUMMARY ***
Total pot $8.94 | Rake $0.45 
Board [2c 9h 8c 4c 7h]
Seat 1: ImaPeppaPig (small blind) folded before Flop
Seat 2: AlexPinsk1 (big blind) showed [8s Ts] and won ($8.49) with a pair of Eights
Seat 3: sta$igk mucked
Seat 4: app1e_j@ck folded before Flop (didn't bet)
Seat 5: BE4077 folded before Flop (didn't bet)
Seat 6: MAO_DZEDYN_S (button) folded before Flop (didn't bet)



PokerStars Hand #254282723821:  Hold'em No Limit ($0.50/$1.00 USD) - 2025/01/09 19:47:38 WET [2025/01/09 14:47:38 ET]
Table 'Dagmar II' 6-max Seat #1 is the button
Seat 1: ImaPeppaPig ($109.68 in chips) 
Seat 2: AlexPinsk1 ($125.35 in chips) 
Seat 3: sta$igk ($100 in chips) 
Seat 4: app1e_j@ck ($155.77 in chips) 
Seat 5: BE4077 ($48.97 in chips) 
Seat 6: MAO_DZEDYN_S ($159.95 in chips) 
AlexPinsk1: posts small blind $0.50
sta$igk: posts big blind $1
*** HOLE CARDS ***
app1e_j@ck: folds 
BE4077: calls $1
MAO_DZEDYN_S: folds 
ImaPeppaPig: folds 
AlexPinsk1: folds 
sta$igk: checks 
*** FLOP *** [9d Qc Tc]
sta$igk: checks 
BE4077: checks 
*** TURN *** [9d Qc Tc] [6s]
sta$igk: checks 
BE4077: checks 
*** RIVER *** [9d Qc Tc 6s] [Ks]
sta$igk: checks 
BE4077: checks 
*** SHOW DOWN ***
sta$igk: shows [8d Th] (a pair of Tens)
BE4077: mucks hand 
sta$igk collected $2.38 from pot
*** SUMMARY ***
Total pot $2.50 | Rake $0.12 
Board [9d Qc Tc 6s Ks]
Seat 1: ImaPeppaPig (button) folded before Flop (didn't bet)
Seat 2: AlexPinsk1 (small blind) folded before Flop
Seat 3: sta$igk (big blind) showed [8d Th] and won ($2.38) with a pair of Tens
Seat 4: app1e_j@ck folded before Flop (didn't bet)
Seat 5: BE4077 mucked
Seat 6: MAO_DZEDYN_S folded before Flop (didn't bet)



PokerStars Hand #254282735216:  Hold'em No Limit ($0.50/$1.00 USD) - 2025/01/09 19:48:15 WET [2025/01/09 14:48:15 ET]
Table 'Dagmar II' 6-max Seat #2 is the button
Seat 1: ImaPeppaPig ($109.68 in chips) 
Seat 2: AlexPinsk1 ($124.85 in chips) 
Seat 3: sta$igk ($101.38 in chips) 
Seat 4: app1e_j@ck ($155.77 in chips) 
Seat 5: BE4077 ($47.97 in chips) 
Seat 6: MAO_DZEDYN_S ($159.95 in chips) 
sta$igk: posts small blind $0.50
app1e_j@ck: posts big blind $1
*** HOLE CARDS ***
BE4077: calls $1
MAO_DZEDYN_S: folds 
ImaPeppaPig: folds 
AlexPinsk1: raises $2.50 to $3.50
sta$igk: folds 
app1e_j@ck: folds 
BE4077: calls $2.50
*** FLOP *** [2c 6d Ts]
BE4077: checks 
AlexPinsk1: checks 
*** TURN *** [2c 6d Ts] [5h]
BE4077: checks 
AlexPinsk1: checks 
*** RIVER *** [2c 6d Ts 5h] [9h]
BE4077: checks 
AlexPinsk1: checks 
*** SHOW DOWN ***
BE4077: shows [7s Ks] (high card King)
AlexPinsk1: shows [4c Ac] (high card Ace)
AlexPinsk1 collected $8.08 from pot
*** SUMMARY ***
Total pot $8.50 | Rake $0.42 
Board [2c 6d Ts 5h 9h]
Seat 1: ImaPeppaPig folded before Flop (didn't bet)
Seat 2: AlexPinsk1 (button) showed [4c Ac] and won ($8.08) with high card Ace
Seat 3: sta$igk (small blind) folded before Flop
Seat 4: app1e_j@ck (big blind) folded before Flop
Seat 5: BE4077 showed [7s Ks] and lost with high card King
Seat 6: MAO_DZEDYN_S folded before Flop (didn't bet)



PokerStars Hand #254282748415:  Hold'em No Limit ($0.50/$1.00 USD) - 2025/01/09 19:48:58 WET [2025/01/09 14:48:58 ET]
Table 'Dagmar II' 6-max Seat #3 is the button
Seat 1: ImaPeppaPig ($109.68 in chips) 
Seat 2: AlexPinsk1 ($129.43 in chips) 
Seat 3: sta$igk ($100.88 in chips) 
Seat 4: app1e_j@ck ($154.77 in chips) 
Seat 5: BE4077 ($44.47 in chips) 
Seat 6: MAO_DZEDYN_S ($159.95 in chips) 
app1e_j@ck: posts small blind $0.50
BE4077: posts big blind $1
*** HOLE CARDS ***
MAO_DZEDYN_S: folds 
ImaPeppaPig: folds 
AlexPinsk1: folds 
sta$igk: folds 
app1e_j@ck: raises $2 to $3
BE4077: calls $2
*** FLOP *** [2c 4c 7d]
app1e_j@ck: bets $1.88
BE4077: calls $1.88
*** TURN *** [2c 4c 7d] [Ks]
app1e_j@ck: bets $6.18
BE4077: calls $6.18
*** RIVER *** [2c 4c 7d Ks] [8h]
app1e_j@ck: bets $14.01
BE4077: calls $14.01
*** SHOW DOWN ***
app1e_j@ck: shows [Jc Qc] (high card King)
BE4077: shows [Ah Ad] (a pair of Aces)
BE4077 collected $47.64 from pot
*** SUMMARY ***
Total pot $50.14 | Rake $2.50 
Board [2c 4c 7d Ks 8h]
Seat 1: ImaPeppaPig folded before Flop (didn't bet)
Seat 2: AlexPinsk1 folded before Flop (didn't bet)
Seat 3: sta$igk (button) folded before Flop (didn't bet)
Seat 4: app1e_j@ck (small blind) showed [Jc Qc] and lost with high card King
Seat 5: BE4077 (big blind) showed [Ah Ad] and won ($47.64) with a pair of Aces
Seat 6: MAO_DZEDYN_S folded before Flop (didn't bet)



PokerStars Hand #254282763271:  Hold'em No Limit ($0.50/$1.00 USD) - 2025/01/09 19:49:46 WET [2025/01/09 14:49:46 ET]
Table 'Dagmar II' 6-max Seat #4 is the button
Seat 1: ImaPeppaPig ($109.68 in chips) 
Seat 2: AlexPinsk1 ($129.43 in chips) 
Seat 3: sta$igk ($100.88 in chips) 
Seat 4: app1e_j@ck ($129.70 in chips) 
Seat 5: BE4077 ($67.04 in chips) 
Seat 6: MAO_DZEDYN_S ($159.95 in chips) 
BE4077: posts small blind $0.50
MAO_DZEDYN_S: posts big blind $1
*** HOLE CARDS ***
ImaPeppaPig: folds 
AlexPinsk1: folds 
sta$igk: folds 
app1e_j@ck: raises $1.50 to $2.50
BE4077: calls $2
MAO_DZEDYN_S: folds 
*** FLOP *** [Td Kc Kd]
BE4077: checks 
app1e_j@ck: bets $1.88
BE4077: folds 
Uncalled bet ($1.88) returned to app1e_j@ck
app1e_j@ck collected $5.70 from pot
app1e_j@ck: doesn't show hand 
*** SUMMARY ***
Total pot $6 | Rake $0.30 
Board [Td Kc Kd]
Seat 1: ImaPeppaPig folded before Flop (didn't bet)
Seat 2: AlexPinsk1 folded before Flop (didn't bet)
Seat 3: sta$igk folded before Flop (didn't bet)
Seat 4: app1e_j@ck (button) collected ($5.70)
Seat 5: BE4077 (small blind) folded on the Flop
Seat 6: MAO_DZEDYN_S (big blind) folded before Flop



PokerStars Hand #254282778442:  Hold'em No Limit ($0.50/$1.00 USD) - 2025/01/09 19:50:35 WET [2025/01/09 14:50:35 ET]
Table 'Dagmar II' 6-max Seat #5 is the button
Seat 1: ImaPeppaPig ($109.68 in chips) 
Seat 2: AlexPinsk1 ($129.43 in chips) 
Seat 3: sta$igk ($100.88 in chips) 
Seat 4: app1e_j@ck ($132.90 in chips) 
Seat 5: BE4077 ($64.54 in chips) 
Seat 6: MAO_DZEDYN_S ($158.95 in chips) 
MAO_DZEDYN_S: posts small blind $0.50
ImaPeppaPig: posts big blind $1
*** HOLE CARDS ***
AlexPinsk1: raises $1.50 to $2.50
sta$igk: folds 
app1e_j@ck: folds 
BE4077: calls $2.50
MAO_DZEDYN_S: folds 
ImaPeppaPig: calls $1.50
*** FLOP *** [5s 8s Jh]
ImaPeppaPig: checks 
AlexPinsk1: bets $3.80
BE4077: folds 
ImaPeppaPig: folds 
Uncalled bet ($3.80) returned to AlexPinsk1
AlexPinsk1 collected $7.60 from pot
AlexPinsk1: doesn't show hand 
*** SUMMARY ***
Total pot $8 | Rake $0.40 
Board [5s 8s Jh]
Seat 1: ImaPeppaPig (big blind) folded on the Flop
Seat 2: AlexPinsk1 collected ($7.60)
Seat 3: sta$igk folded before Flop (didn't bet)
Seat 4: app1e_j@ck folded before Flop (didn't bet)
Seat 5: BE4077 (button) folded on the Flop
Seat 6: MAO_DZEDYN_S (small blind) folded before Flop



PokerStars Hand #254282788807:  Hold'em No Limit ($0.50/$1.00 USD) - 2025/01/09 19:51:09 WET [2025/01/09 14:51:09 ET]
Table 'Dagmar II' 6-max Seat #6 is the button
Seat 1: ImaPeppaPig ($107.18 in chips) 
Seat 2: AlexPinsk1 ($134.53 in chips) 
Seat 3: sta$igk ($100.88 in chips) 
Seat 4: app1e_j@ck ($132.90 in chips) 
Seat 5: BE4077 ($62.04 in chips) 
Seat 6: MAO_DZEDYN_S ($158.45 in chips) 
ImaPeppaPig: posts small blind $0.50
AlexPinsk1: posts big blind $1
*** HOLE CARDS ***
sta$igk: folds 
app1e_j@ck: folds 
BE4077: calls $1
MAO_DZEDYN_S: raises $2.50 to $3.50
ImaPeppaPig: folds 
AlexPinsk1: folds 
BE4077: calls $2.50
*** FLOP *** [7s Qd 3c]
BE4077: checks 
MAO_DZEDYN_S: bets $2.42
BE4077: folds 
Uncalled bet ($2.42) returned to MAO_DZEDYN_S
MAO_DZEDYN_S collected $8.08 from pot
MAO_DZEDYN_S: doesn't show hand 
*** SUMMARY ***
Total pot $8.50 | Rake $0.42 
Board [7s Qd 3c]
Seat 1: ImaPeppaPig (small blind) folded before Flop
Seat 2: AlexPinsk1 (big blind) folded before Flop
Seat 3: sta$igk folded before Flop (didn't bet)
Seat 4: app1e_j@ck folded before Flop (didn't bet)
Seat 5: BE4077 folded on the Flop
Seat 6: MAO_DZEDYN_S (button) collected ($8.08)



PokerStars Hand #254282803051:  Hold'em No Limit ($0.50/$1.00 USD) - 2025/01/09 19:51:55 WET [2025/01/09 14:51:55 ET]
Table 'Dagmar II' 6-max Seat #1 is the button
Seat 1: ImaPeppaPig ($106.68 in chips) 
Seat 2: AlexPinsk1 ($133.53 in chips) 
Seat 3: sta$igk ($100.88 in chips) 
Seat 4: app1e_j@ck ($132.90 in chips) 
Seat 5: BE4077 ($58.54 in chips) 
Seat 6: MAO_DZEDYN_S ($163.03 in chips) 
AlexPinsk1: posts small blind $0.50
sta$igk: posts big blind $1
*** HOLE CARDS ***
app1e_j@ck: raises $1.50 to $2.50
BE4077: calls $2.50
MAO_DZEDYN_S: folds 
ImaPeppaPig: calls $2.50
AlexPinsk1: folds 
sta$igk: folds 
*** FLOP *** [Kd 6d Kh]
app1e_j@ck: checks 
BE4077: checks 
ImaPeppaPig: checks 
*** TURN *** [Kd 6d Kh] [2s]
app1e_j@ck: checks 
BE4077: checks 
ImaPeppaPig: checks 
*** RIVER *** [Kd 6d Kh 2s] [4c]
app1e_j@ck: checks 
BE4077: checks 
ImaPeppaPig: checks 
*** SHOW DOWN ***
app1e_j@ck: shows [Ac Qc] (a pair of Kings)
BE4077: mucks hand 
ImaPeppaPig: mucks hand 
app1e_j@ck collected $8.55 from pot
*** SUMMARY ***
Total pot $9 | Rake $0.45 
Board [Kd 6d Kh 2s 4c]
Seat 1: ImaPeppaPig (button) mucked
Seat 2: AlexPinsk1 (small blind) folded before Flop
Seat 3: sta$igk (big blind) folded before Flop
Seat 4: app1e_j@ck showed [Ac Qc] and won ($8.55) with a pair of Kings
Seat 5: BE4077 mucked
Seat 6: MAO_DZEDYN_S folded before Flop (didn't bet)



PokerStars Hand #254282818878:  Hold'em No Limit ($0.50/$1.00 USD) - 2025/01/09 19:52:45 WET [2025/01/09 14:52:45 ET]
Table 'Dagmar II' 6-max Seat #2 is the button
Seat 1: ImaPeppaPig ($104.18 in chips) 
Seat 2: AlexPinsk1 ($133.03 in chips) 
Seat 3: sta$igk ($100 in chips) 
Seat 4: app1e_j@ck ($138.95 in chips) 
Seat 5: BE4077 ($56.04 in chips) 
Seat 6: MAO_DZEDYN_S ($163.03 in chips) 
sta$igk: posts small blind $0.50
app1e_j@ck: posts big blind $1
*** HOLE CARDS ***
BE4077: calls $1
MAO_DZEDYN_S: folds 
ImaPeppaPig: folds 
AlexPinsk1: folds 
sta$igk: folds 
app1e_j@ck: checks 
*** FLOP *** [Kd 8d 3c]
app1e_j@ck: checks 
BE4077: checks 
*** TURN *** [Kd 8d 3c] [As]
app1e_j@ck: bets $1.79
BE4077: folds 
Uncalled bet ($1.79) returned to app1e_j@ck
app1e_j@ck collected $2.38 from pot
app1e_j@ck: doesn't show hand 
*** SUMMARY ***
Total pot $2.50 | Rake $0.12 
Board [Kd 8d 3c As]
Seat 1: ImaPeppaPig folded before Flop (didn't bet)
Seat 2: AlexPinsk1 (button) folded before Flop (didn't bet)
Seat 3: sta$igk (small blind) folded before Flop
Seat 4: app1e_j@ck (big blind) collected ($2.38)
Seat 5: BE4077 folded on the Turn
Seat 6: MAO_DZEDYN_S folded before Flop (didn't bet)



PokerStars Hand #254282833453:  Hold'em No Limit ($0.50/$1.00 USD) - 2025/01/09 19:53:33 WET [2025/01/09 14:53:33 ET]
Table 'Dagmar II' 6-max Seat #3 is the button
Seat 1: ImaPeppaPig ($104.18 in chips) 
Seat 2: AlexPinsk1 ($133.03 in chips) 
Seat 3: sta$igk ($100 in chips) 
Seat 4: app1e_j@ck ($140.33 in chips) 
Seat 5: BE4077 ($55.04 in chips) 
Seat 6: MAO_DZEDYN_S ($163.03 in chips) 
app1e_j@ck: posts small blind $0.50
BE4077: posts big blind $1
*** HOLE CARDS ***
MAO_DZEDYN_S: folds 
ImaPeppaPig: folds 
AlexPinsk1: folds 
sta$igk: folds 
app1e_j@ck: raises $2 to $3
BE4077: calls $2
*** FLOP *** [Qd 7d 9c]
app1e_j@ck: checks 
BE4077: checks 
*** TURN *** [Qd 7d 9c] [7c]
app1e_j@ck: checks 
BE4077: checks 
*** RIVER *** [Qd 7d 9c 7c] [Kd]
app1e_j@ck: bets $4.28
BE4077: folds 
Uncalled bet ($4.28) returned to app1e_j@ck
app1e_j@ck collected $5.70 from pot
app1e_j@ck: doesn't show hand 
*** SUMMARY ***
Total pot $6 | Rake $0.30 
Board [Qd 7d 9c 7c Kd]
Seat 1: ImaPeppaPig folded before Flop (didn't bet)
Seat 2: AlexPinsk1 folded before Flop (didn't bet)
Seat 3: sta$igk (button) folded before Flop (didn't bet)
Seat 4: app1e_j@ck (small blind) collected ($5.70)
Seat 5: BE4077 (big blind) folded on the River
Seat 6: MAO_DZEDYN_S folded before Flop (didn't bet)



PokerStars Hand #254282846749:  Hold'em No Limit ($0.50/$1.00 USD) - 2025/01/09 19:54:15 WET [2025/01/09 14:54:15 ET]
Table 'Dagmar II' 6-max Seat #4 is the button
Seat 1: ImaPeppaPig ($104.18 in chips) 
Seat 2: AlexPinsk1 ($133.03 in chips) 
Seat 3: sta$igk ($100 in chips) 
Seat 4: app1e_j@ck ($143.03 in chips) 
Seat 5: BE4077 ($52.04 in chips) 
Seat 6: MAO_DZEDYN_S ($163.03 in chips) 
BE4077: posts small blind $0.50
MAO_DZEDYN_S: posts big blind $1
*** HOLE CARDS ***
ImaPeppaPig: folds 
AlexPinsk1: raises $1.50 to $2.50
sta$igk: folds 
app1e_j@ck: folds 
BE4077: calls $2
MAO_DZEDYN_S: calls $1.50
*** FLOP *** [Jd Ah Kd]
BE4077: bets $3.56
MAO_DZEDYN_S: folds 
AlexPinsk1: calls $3.56
*** TURN *** [Jd Ah Kd] [Td]
BE4077: bets $6.95
AlexPinsk1: calls $6.95
*** RIVER *** [Jd Ah Kd Td] [8c]
BE4077: bets $39.03 and is all-in
AlexPinsk1: folds 
Uncalled bet ($39.03) returned to BE4077
BE4077 collected $27.09 from pot
*** SUMMARY ***
Total pot $28.52 | Rake $1.43 
Board [Jd Ah Kd Td 8c]
Seat 1: ImaPeppaPig folded before Flop (didn't bet)
Seat 2: AlexPinsk1 folded on the River
Seat 3: sta$igk folded before Flop (didn't bet)
Seat 4: app1e_j@ck (button) folded before Flop (didn't bet)
Seat 5: BE4077 (small blind) collected ($27.09)
Seat 6: MAO_DZEDYN_S (big blind) folded on the Flop



PokerStars Hand #254282868089:  Hold'em No Limit ($0.50/$1.00 USD) - 2025/01/09 19:55:31 WET [2025/01/09 14:55:31 ET]
Table 'Dagmar II' 6-max Seat #5 is the button
Seat 1: ImaPeppaPig ($104.18 in chips) 
Seat 2: AlexPinsk1 ($120.02 in chips) 
Seat 3: sta$igk ($100 in chips) 
Seat 4: app1e_j@ck ($143.03 in chips) 
Seat 5: BE4077 ($66.12 in chips) 
Seat 6: MAO_DZEDYN_S ($160.53 in chips) 
MAO_DZEDYN_S: posts small blind $0.50
ImaPeppaPig: posts big blind $1
*** HOLE CARDS ***
AlexPinsk1: folds 
sta$igk: folds 
app1e_j@ck: folds 
BE4077: calls $1
MAO_DZEDYN_S: folds 
ImaPeppaPig: checks 
*** FLOP *** [7h Ks 8c]
ImaPeppaPig: checks 
BE4077: checks 
*** TURN *** [7h Ks 8c] [Kc]
ImaPeppaPig: bets $2
BE4077: calls $2
*** RIVER *** [7h Ks 8c Kc] [Qs]
ImaPeppaPig: checks 
BE4077: checks 
*** SHOW DOWN ***
ImaPeppaPig: shows [As 8d] (two pair, Kings and Eights)
BE4077: shows [3s Kd] (three of a kind, Kings)
BE4077 collected $6.18 from pot
*** SUMMARY ***
Total pot $6.50 | Rake $0.32 
Board [7h Ks 8c Kc Qs]
Seat 1: ImaPeppaPig (big blind) showed [As 8d] and lost with two pair, Kings and Eights
Seat 2: AlexPinsk1 folded before Flop (didn't bet)
Seat 3: sta$igk folded before Flop (didn't bet)
Seat 4: app1e_j@ck folded before Flop (didn't bet)
Seat 5: BE4077 (button) showed [3s Kd] and won ($6.18) with three of a kind, Kings
Seat 6: MAO_DZEDYN_S (small blind) folded before Flop



PokerStars Hand #254282874360:  Hold'em No Limit ($0.50/$1.00 USD) - 2025/01/09 19:56:00 WET [2025/01/09 14:56:00 ET]
Table 'Dagmar II' 6-max Seat #6 is the button
Seat 1: ImaPeppaPig ($101.18 in chips) 
Seat 2: AlexPinsk1 ($120.02 in chips) 
Seat 3: sta$igk ($100 in chips) 
Seat 4: app1e_j@ck ($143.03 in chips) 
Seat 5: BE4077 ($69.30 in chips) 
Seat 6: MAO_DZEDYN_S ($160.03 in chips) 
ImaPeppaPig: posts small blind $0.50
AlexPinsk1: posts big blind $1
*** HOLE CARDS ***
sta$igk: folds 
app1e_j@ck: folds 
BE4077: calls $1
MAO_DZEDYN_S: folds 
ImaPeppaPig: folds 
AlexPinsk1: checks 
*** FLOP *** [4h 6c 5c]
AlexPinsk1: bets $1
BE4077: calls $1
*** TURN *** [4h 6c 5c] [9h]
AlexPinsk1: checks 
BE4077: checks 
*** RIVER *** [4h 6c 5c 9h] [Qs]
AlexPinsk1: checks 
BE4077: checks 
*** SHOW DOWN ***
AlexPinsk1: shows [5s Kh] (a pair of Fives)
BE4077: shows [Th 6d] (a pair of Sixes)
BE4077 collected $4.28 from pot
*** SUMMARY ***
Total pot $4.50 | Rake $0.22 
Board [4h 6c 5c 9h Qs]
Seat 1: ImaPeppaPig (small blind) folded before Flop
Seat 2: AlexPinsk1 (big blind) showed [5s Kh] and lost with a pair of Fives
Seat 3: sta$igk folded before Flop (didn't bet)
Seat 4: app1e_j@ck folded before Flop (didn't bet)
Seat 5: BE4077 showed [Th 6d] and won ($4.28) with a pair of Sixes
Seat 6: MAO_DZEDYN_S (button) folded before Flop (didn't bet)



PokerStars Hand #254282884938:  Hold'em No Limit ($0.50/$1.00 USD) - 2025/01/09 19:56:47 WET [2025/01/09 14:56:47 ET]
Table 'Dagmar II' 6-max Seat #1 is the button
Seat 1: ImaPeppaPig ($100.68 in chips) 
Seat 2: AlexPinsk1 ($118.02 in chips) 
Seat 3: sta$igk ($100 in chips) 
Seat 4: app1e_j@ck ($143.03 in chips) 
Seat 5: BE4077 ($71.58 in chips) 
Seat 6: MAO_DZEDYN_S ($160.03 in chips) 
AlexPinsk1: posts small blind $0.50
sta$igk: posts big blind $1
*** HOLE CARDS ***
app1e_j@ck: folds 
BE4077: folds 
MAO_DZEDYN_S: folds 
ImaPeppaPig: folds 
AlexPinsk1: folds 
Uncalled bet ($0.50) returned to sta$igk
sta$igk collected $1 from pot
sta$igk: doesn't show hand 
*** SUMMARY ***
Total pot $1 | Rake $0 
Seat 1: ImaPeppaPig (button) folded before Flop (didn't bet)
Seat 2: AlexPinsk1 (small blind) folded before Flop
Seat 3: sta$igk (big blind) collected ($1)
Seat 4: app1e_j@ck folded before Flop (didn't bet)
Seat 5: BE4077 folded before Flop (didn't bet)
Seat 6: MAO_DZEDYN_S folded before Flop (didn't bet)



PokerStars Hand #254282888355:  Hold'em No Limit ($0.50/$1.00 USD) - 2025/01/09 19:57:03 WET [2025/01/09 14:57:03 ET]
Table 'Dagmar II' 6-max Seat #2 is the button
Seat 1: ImaPeppaPig ($100.68 in chips) 
Seat 2: AlexPinsk1 ($117.52 in chips) 
Seat 3: sta$igk ($100.50 in chips) 
Seat 4: app1e_j@ck ($143.03 in chips) 
Seat 5: BE4077 ($71.58 in chips) 
Seat 6: MAO_DZEDYN_S ($160.03 in chips) 
sta$igk: posts small blind $0.50
app1e_j@ck: posts big blind $1
*** HOLE CARDS ***
BE4077: folds 
MAO_DZEDYN_S: folds 
ImaPeppaPig: folds 
AlexPinsk1: raises $1.50 to $2.50
sta$igk: folds 
app1e_j@ck: folds 
Uncalled bet ($1.50) returned to AlexPinsk1
AlexPinsk1 collected $2.50 from pot
AlexPinsk1: doesn't show hand 
*** SUMMARY ***
Total pot $2.50 | Rake $0 
Seat 1: ImaPeppaPig folded before Flop (didn't bet)
Seat 2: AlexPinsk1 (button) collected ($2.50)
Seat 3: sta$igk (small blind) folded before Flop
Seat 4: app1e_j@ck (big blind) folded before Flop
Seat 5: BE4077 folded before Flop (didn't bet)
Seat 6: MAO_DZEDYN_S folded before Flop (didn't bet)



PokerStars Hand #254282895489:  Hold'em No Limit ($0.50/$1.00 USD) - 2025/01/09 19:57:34 WET [2025/01/09 14:57:34 ET]
Table 'Dagmar II' 6-max Seat #3 is the button
Seat 1: ImaPeppaPig ($100.68 in chips) 
Seat 2: AlexPinsk1 ($119.02 in chips) 
Seat 3: sta$igk ($100 in chips) 
Seat 4: app1e_j@ck ($142.03 in chips) 
Seat 5: BE4077 ($71.58 in chips) 
Seat 6: MAO_DZEDYN_S ($160.03 in chips) 
app1e_j@ck: posts small blind $0.50
BE4077: posts big blind $1
*** HOLE CARDS ***
MAO_DZEDYN_S: folds 
ImaPeppaPig: folds 
AlexPinsk1: folds 
sta$igk: folds 
app1e_j@ck: raises $2 to $3
BE4077: folds 
Uncalled bet ($2) returned to app1e_j@ck
app1e_j@ck collected $2 from pot
app1e_j@ck: doesn't show hand 
*** SUMMARY ***
Total pot $2 | Rake $0 
Seat 1: ImaPeppaPig folded before Flop (didn't bet)
Seat 2: AlexPinsk1 folded before Flop (didn't bet)
Seat 3: sta$igk (button) folded before Flop (didn't bet)
Seat 4: app1e_j@ck (small blind) collected ($2)
Seat 5: BE4077 (big blind) folded before Flop
Seat 6: MAO_DZEDYN_S folded before Flop (didn't bet)



PokerStars Hand #254282899342:  Hold'em No Limit ($0.50/$1.00 USD) - 2025/01/09 19:57:52 WET [2025/01/09 14:57:52 ET]
Table 'Dagmar II' 6-max Seat #4 is the button
Seat 1: ImaPeppaPig ($100.68 in chips) 
Seat 2: AlexPinsk1 ($119.02 in chips) 
Seat 3: sta$igk ($100 in chips) 
Seat 4: app1e_j@ck ($143.03 in chips) 
Seat 5: BE4077 ($70.58 in chips) 
Seat 6: MAO_DZEDYN_S ($160.03 in chips) 
BE4077: posts small blind $0.50
MAO_DZEDYN_S: posts big blind $1
*** HOLE CARDS ***
ImaPeppaPig: folds 
AlexPinsk1: folds 
sta$igk: folds 
app1e_j@ck: folds 
BE4077: calls $0.50
MAO_DZEDYN_S: checks 
*** FLOP *** [Ah Qd 6s]
BE4077: checks 
MAO_DZEDYN_S: bets $1
BE4077: calls $1
*** TURN *** [Ah Qd 6s] [8h]
BE4077: checks 
MAO_DZEDYN_S: bets $3.70
BE4077: folds 
Uncalled bet ($3.70) returned to MAO_DZEDYN_S
MAO_DZEDYN_S collected $3.80 from pot
MAO_DZEDYN_S: doesn't show hand 
*** SUMMARY ***
Total pot $4 | Rake $0.20 
Board [Ah Qd 6s 8h]
Seat 1: ImaPeppaPig folded before Flop (didn't bet)
Seat 2: AlexPinsk1 folded before Flop (didn't bet)
Seat 3: sta$igk folded before Flop (didn't bet)
Seat 4: app1e_j@ck (button) folded before Flop (didn't bet)
Seat 5: BE4077 (small blind) folded on the Turn
Seat 6: MAO_DZEDYN_S (big blind) collected ($3.80)



PokerStars Hand #254282910953:  Hold'em No Limit ($0.50/$1.00 USD) - 2025/01/09 19:58:43 WET [2025/01/09 14:58:43 ET]
Table 'Dagmar II' 6-max Seat #5 is the button
Seat 1: ImaPeppaPig ($100.68 in chips) 
Seat 2: AlexPinsk1 ($119.02 in chips) 
Seat 3: sta$igk ($100 in chips) 
Seat 4: app1e_j@ck ($143.03 in chips) 
Seat 5: BE4077 ($68.58 in chips) 
Seat 6: MAO_DZEDYN_S ($161.83 in chips) 
MAO_DZEDYN_S: posts small blind $0.50
ImaPeppaPig: posts big blind $1
*** HOLE CARDS ***
AlexPinsk1: folds 
sta$igk: folds 
app1e_j@ck: raises $1.50 to $2.50
BE4077: folds 
MAO_DZEDYN_S: folds 
ImaPeppaPig: calls $1.50
*** FLOP *** [3s Th Jh]
ImaPeppaPig: checks 
app1e_j@ck: checks 
*** TURN *** [3s Th Jh] [Qc]
ImaPeppaPig: checks 
app1e_j@ck: checks 
*** RIVER *** [3s Th Jh Qc] [Kd]
ImaPeppaPig: checks 
app1e_j@ck: checks 
*** SHOW DOWN ***
ImaPeppaPig: shows [4s 7s] (high card King)
app1e_j@ck: shows [9s 9d] (a straight, Nine to King)
app1e_j@ck collected $5.22 from pot
*** SUMMARY ***
Total pot $5.50 | Rake $0.28 
Board [3s Th Jh Qc Kd]
Seat 1: ImaPeppaPig (big blind) showed [4s 7s] and lost with high card King
Seat 2: AlexPinsk1 folded before Flop (didn't bet)
Seat 3: sta$igk folded before Flop (didn't bet)
Seat 4: app1e_j@ck showed [9s 9d] and won ($5.22) with a straight, Nine to King
Seat 5: BE4077 (button) folded before Flop (didn't bet)
Seat 6: MAO_DZEDYN_S (small blind) folded before Flop



PokerStars Hand #254282921996:  Hold'em No Limit ($0.50/$1.00 USD) - 2025/01/09 19:59:31 WET [2025/01/09 14:59:31 ET]
Table 'Dagmar II' 6-max Seat #6 is the button
Seat 1: ImaPeppaPig ($100 in chips) 
Seat 2: AlexPinsk1 ($119.02 in chips) 
Seat 3: sta$igk ($100 in chips) 
Seat 4: app1e_j@ck ($145.75 in chips) 
Seat 5: BE4077 ($68.58 in chips) 
Seat 6: MAO_DZEDYN_S ($161.33 in chips) 
ImaPeppaPig: posts small blind $0.50
AlexPinsk1: posts big blind $1
*** HOLE CARDS ***
sta$igk: folds 
app1e_j@ck: folds 
BE4077: calls $1
MAO_DZEDYN_S: folds 
ImaPeppaPig: folds 
AlexPinsk1: checks 
*** FLOP *** [2s Ks 7s]
AlexPinsk1: checks 
BE4077: bets $1
AlexPinsk1: calls $1
*** TURN *** [2s Ks 7s] [5s]
AlexPinsk1: checks 
BE4077: bets $1
AlexPinsk1: calls $1
*** RIVER *** [2s Ks 7s 5s] [Qc]
AlexPinsk1: checks 
BE4077: checks 
*** SHOW DOWN ***
AlexPinsk1: shows [5c 9s] (a flush, King high)
BE4077: mucks hand 
AlexPinsk1 collected $6.18 from pot
*** SUMMARY ***
Total pot $6.50 | Rake $0.32 
Board [2s Ks 7s 5s Qc]
Seat 1: ImaPeppaPig (small blind) folded before Flop
Seat 2: AlexPinsk1 (big blind) showed [5c 9s] and won ($6.18) with a flush, King high
Seat 3: sta$igk folded before Flop (didn't bet)
Seat 4: app1e_j@ck folded before Flop (didn't bet)
Seat 5: BE4077 mucked
Seat 6: MAO_DZEDYN_S (button) folded before Flop (didn't bet)



PokerStars Hand #254282937665:  Hold'em No Limit ($0.50/$1.00 USD) - 2025/01/09 20:00:39 WET [2025/01/09 15:00:39 ET]
Table 'Dagmar II' 6-max Seat #1 is the button
Seat 1: ImaPeppaPig ($100 in chips) 
Seat 2: AlexPinsk1 ($122.20 in chips) 
Seat 3: sta$igk ($100 in chips) 
Seat 4: app1e_j@ck ($145.75 in chips) 
Seat 5: BE4077 ($65.58 in chips) 
Seat 6: MAO_DZEDYN_S ($161.33 in chips) 
AlexPinsk1: posts small blind $0.50
sta$igk: posts big blind $1
*** HOLE CARDS ***
app1e_j@ck: folds 
BE4077: calls $1
MAO_DZEDYN_S: folds 
ImaPeppaPig: folds 
AlexPinsk1: calls $0.50
sta$igk: checks 
*** FLOP *** [Jc 8c 9d]
AlexPinsk1: bets $1.50
sta$igk: folds 
BE4077: calls $1.50
*** TURN *** [Jc 8c 9d] [9s]
AlexPinsk1: bets $3
BE4077: calls $3
*** RIVER *** [Jc 8c 9d 9s] [6s]
AlexPinsk1: bets $11
BE4077: folds 
Uncalled bet ($11) returned to AlexPinsk1
AlexPinsk1 collected $11.40 from pot
AlexPinsk1: doesn't show hand 
*** SUMMARY ***
Total pot $12 | Rake $0.60 
Board [Jc 8c 9d 9s 6s]
Seat 1: ImaPeppaPig (button) folded before Flop (didn't bet)
Seat 2: AlexPinsk1 (small blind) collected ($11.40)
Seat 3: sta$igk (big blind) folded on the Flop
Seat 4: app1e_j@ck folded before Flop (didn't bet)
Seat 5: BE4077 folded on the River
Seat 6: MAO_DZEDYN_S folded before Flop (didn't bet)



PokerStars Hand #254282950064:  Hold'em No Limit ($0.50/$1.00 USD) - 2025/01/09 20:01:25 WET [2025/01/09 15:01:25 ET]
Table 'Dagmar II' 6-max Seat #2 is the button
Seat 1: ImaPeppaPig ($100 in chips) 
Seat 2: AlexPinsk1 ($128.10 in chips) 
Seat 3: sta$igk ($100 in chips) 
Seat 4: app1e_j@ck ($145.75 in chips) 
Seat 5: BE4077 ($60.08 in chips) 
Seat 6: MAO_DZEDYN_S ($161.33 in chips) 
sta$igk: posts small blind $0.50
app1e_j@ck: posts big blind $1
*** HOLE CARDS ***
BE4077: calls $1
MAO_DZEDYN_S: folds 
ImaPeppaPig: folds 
AlexPinsk1: raises $2.50 to $3.50
sta$igk: folds 
app1e_j@ck: folds 
BE4077: calls $2.50
*** FLOP *** [Qc 7h 8s]
BE4077: bets $1
AlexPinsk1: raises $7 to $8
BE4077: folds 
Uncalled bet ($7) returned to AlexPinsk1
AlexPinsk1 collected $9.98 from pot
AlexPinsk1: doesn't show hand 
*** SUMMARY ***
Total pot $10.50 | Rake $0.52 
Board [Qc 7h 8s]
Seat 1: ImaPeppaPig folded before Flop (didn't bet)
Seat 2: AlexPinsk1 (button) collected ($9.98)
Seat 3: sta$igk (small blind) folded before Flop
Seat 4: app1e_j@ck (big blind) folded before Flop
Seat 5: BE4077 folded on the Flop
Seat 6: MAO_DZEDYN_S folded before Flop (didn't bet)



PokerStars Hand #254282960721:  Hold'em No Limit ($0.50/$1.00 USD) - 2025/01/09 20:02:00 WET [2025/01/09 15:02:00 ET]
Table 'Dagmar II' 6-max Seat #3 is the button
Seat 1: ImaPeppaPig ($100 in chips) 
Seat 2: AlexPinsk1 ($133.58 in chips) 
Seat 3: sta$igk ($100 in chips) 
Seat 4: app1e_j@ck ($144.75 in chips) 
Seat 5: BE4077 ($55.58 in chips) 
Seat 6: MAO_DZEDYN_S ($161.33 in chips) 
app1e_j@ck: posts small blind $0.50
BE4077: posts big blind $1
*** HOLE CARDS ***
MAO_DZEDYN_S: folds 
ImaPeppaPig: raises $1.50 to $2.50
AlexPinsk1: folds 
sta$igk: folds 
app1e_j@ck: folds 
BE4077: calls $1.50
*** FLOP *** [3c 6c 8s]
BE4077: bets $1
ImaPeppaPig: calls $1
*** TURN *** [3c 6c 8s] [Kc]
BE4077: checks 
ImaPeppaPig: checks 
*** RIVER *** [3c 6c 8s Kc] [2s]
BE4077: checks 
ImaPeppaPig: checks 
*** SHOW DOWN ***
BE4077: shows [8h Ts] (a pair of Eights)
ImaPeppaPig: mucks hand 
BE4077 collected $7.12 from pot
*** SUMMARY ***
Total pot $7.50 | Rake $0.38 
Board [3c 6c 8s Kc 2s]
Seat 1: ImaPeppaPig mucked
Seat 2: AlexPinsk1 folded before Flop (didn't bet)
Seat 3: sta$igk (button) folded before Flop (didn't bet)
Seat 4: app1e_j@ck (small blind) folded before Flop
Seat 5: BE4077 (big blind) showed [8h Ts] and won ($7.12) with a pair of Eights
Seat 6: MAO_DZEDYN_S folded before Flop (didn't bet)



PokerStars Hand #254282970609:  Hold'em No Limit ($0.50/$1.00 USD) - 2025/01/09 20:02:33 WET [2025/01/09 15:02:33 ET]
Table 'Dagmar II' 6-max Seat #4 is the button
Seat 1: ImaPeppaPig ($100 in chips) 
Seat 2: AlexPinsk1 ($133.58 in chips) 
Seat 3: sta$igk ($100 in chips) 
Seat 4: app1e_j@ck ($144.25 in chips) 
Seat 5: BE4077 ($59.20 in chips) 
Seat 6: MAO_DZEDYN_S ($161.33 in chips) 
BE4077: posts small blind $0.50
MAO_DZEDYN_S: posts big blind $1
*** HOLE CARDS ***
ImaPeppaPig: folds 
AlexPinsk1: raises $1.50 to $2.50
sta$igk: folds 
app1e_j@ck: folds 
BE4077: calls $2
MAO_DZEDYN_S: calls $1.50
*** FLOP *** [3c Qh Jd]
BE4077: checks 
MAO_DZEDYN_S: checks 
AlexPinsk1: checks 
*** TURN *** [3c Qh Jd] [6h]
BE4077: checks 
MAO_DZEDYN_S: bets $5.34
AlexPinsk1: folds 
BE4077: folds 
Uncalled bet ($5.34) returned to MAO_DZEDYN_S
MAO_DZEDYN_S collected $7.12 from pot
MAO_DZEDYN_S: doesn't show hand 
*** SUMMARY ***
Total pot $7.50 | Rake $0.38 
Board [3c Qh Jd 6h]
Seat 1: ImaPeppaPig folded before Flop (didn't bet)
Seat 2: AlexPinsk1 folded on the Turn
Seat 3: sta$igk folded before Flop (didn't bet)
Seat 4: app1e_j@ck (button) folded before Flop (didn't bet)
Seat 5: BE4077 (small blind) folded on the Turn
Seat 6: MAO_DZEDYN_S (big blind) collected ($7.12)



PokerStars Hand #254282995805:  Hold'em No Limit ($0.50/$1.00 USD) - 2025/01/09 20:03:53 WET [2025/01/09 15:03:53 ET]
Table 'Dagmar II' 6-max Seat #5 is the button
Seat 1: ImaPeppaPig ($100 in chips) 
Seat 2: AlexPinsk1 ($131.08 in chips) 
Seat 3: sta$igk ($100 in chips) 
Seat 4: app1e_j@ck ($144.25 in chips) 
Seat 5: BE4077 ($56.70 in chips) 
Seat 6: MAO_DZEDYN_S ($165.95 in chips) 
MAO_DZEDYN_S: posts small blind $0.50
ImaPeppaPig: posts big blind $1
*** HOLE CARDS ***
AlexPinsk1: folds 
sta$igk: raises $1.50 to $2.50
app1e_j@ck: raises $6.50 to $9
BE4077: calls $9
MAO_DZEDYN_S: folds 
ImaPeppaPig: folds 
sta$igk: folds 
*** FLOP *** [8c 6d Ac]
app1e_j@ck: bets $9.40
BE4077: raises $38.30 to $47.70 and is all-in
app1e_j@ck: calls $38.30
*** TURN *** [8c 6d Ac] [3c]
*** RIVER *** [8c 6d Ac 3c] [5d]
*** SHOW DOWN ***
app1e_j@ck: shows [Js As] (a pair of Aces)
BE4077: shows [Th 9h] (high card Ace)
app1e_j@ck collected $114.90 from pot
*** SUMMARY ***
Total pot $117.40 | Rake $2.50 
Board [8c 6d Ac 3c 5d]
Seat 1: ImaPeppaPig (big blind) folded before Flop
Seat 2: AlexPinsk1 folded before Flop (didn't bet)
Seat 3: sta$igk folded before Flop
Seat 4: app1e_j@ck showed [Js As] and won ($114.90) with a pair of Aces
Seat 5: BE4077 (button) showed [Th 9h] and lost with high card Ace
Seat 6: MAO_DZEDYN_S (small blind) folded before Flop



PokerStars Hand #254283008034:  Hold'em No Limit ($0.50/$1.00 USD) - 2025/01/09 20:04:32 WET [2025/01/09 15:04:32 ET]
Table 'Dagmar II' 6-max Seat #6 is the button
Seat 5: BE4077 ($0 in chips) is sitting out
Seat 1: ImaPeppaPig ($100 in chips) 
Seat 2: AlexPinsk1 ($131.08 in chips) 
Seat 3: sta$igk ($100 in chips) 
Seat 4: app1e_j@ck ($202.45 in chips) 
Seat 6: MAO_DZEDYN_S ($165.45 in chips) 
ImaPeppaPig: posts small blind $0.50
AlexPinsk1: posts big blind $1
*** HOLE CARDS ***
sta$igk: folds 
app1e_j@ck: folds 
MAO_DZEDYN_S: folds 
BE4077 leaves the table
ImaPeppaPig: folds 
Uncalled bet ($0.50) returned to AlexPinsk1
AlexPinsk1 collected $1 from pot
AlexPinsk1: doesn't show hand 
*** SUMMARY ***
Total pot $1 | Rake $0 
Seat 5: BE4077
Seat 1: ImaPeppaPig (small blind) folded before Flop
Seat 2: AlexPinsk1 (big blind) collected ($1)
Seat 3: sta$igk folded before Flop (didn't bet)
Seat 4: app1e_j@ck folded before Flop (didn't bet)
Seat 6: MAO_DZEDYN_S (button) folded before Flop (didn't bet)



PokerStars Hand #254283012250:  Hold'em No Limit ($0.50/$1.00 USD) - 2025/01/09 20:04:45 WET [2025/01/09 15:04:45 ET]
Table 'Dagmar II' 6-max Seat #1 is the button
Seat 1: ImaPeppaPig ($100 in chips) 
Seat 2: AlexPinsk1 ($131.58 in chips) 
Seat 3: sta$igk ($100 in chips) 
Seat 4: app1e_j@ck ($202.45 in chips) 
Seat 6: MAO_DZEDYN_S ($165.45 in chips) 
AlexPinsk1: posts small blind $0.50
sta$igk: posts big blind $1
*** HOLE CARDS ***
app1e_j@ck: raises $1.50 to $2.50
MAO_DZEDYN_S: folds 
ImaPeppaPig: folds 
AlexPinsk1: raises $9 to $11.50
sta$igk: folds 
app1e_j@ck: folds 
Uncalled bet ($9) returned to AlexPinsk1
AlexPinsk1 collected $6 from pot
AlexPinsk1: doesn't show hand 
*** SUMMARY ***
Total pot $6 | Rake $0 
Seat 1: ImaPeppaPig (button) folded before Flop (didn't bet)
Seat 2: AlexPinsk1 (small blind) collected ($6)
Seat 3: sta$igk (big blind) folded before Flop
Seat 4: app1e_j@ck folded before Flop
Seat 6: MAO_DZEDYN_S folded before Flop (didn't bet)



PokerStars Hand #254283022309:  Hold'em No Limit ($0.50/$1.00 USD) - 2025/01/09 20:05:15 WET [2025/01/09 15:05:15 ET]
Table 'Dagmar II' 6-max Seat #2 is the button
Seat 1: ImaPeppaPig ($100 in chips) 
Seat 2: AlexPinsk1 ($135.08 in chips) 
Seat 3: sta$igk ($100 in chips) 
Seat 4: app1e_j@ck ($199.95 in chips) 
Seat 6: MAO_DZEDYN_S ($165.45 in chips) 
sta$igk: posts small blind $0.50
app1e_j@ck: posts big blind $1
*** HOLE CARDS ***
MAO_DZEDYN_S: raises $1.25 to $2.25
ImaPeppaPig: folds 
AlexPinsk1: folds 
sta$igk: folds 
app1e_j@ck: folds 
Uncalled bet ($1.25) returned to MAO_DZEDYN_S
MAO_DZEDYN_S collected $2.50 from pot
MAO_DZEDYN_S: doesn't show hand 
*** SUMMARY ***
Total pot $2.50 | Rake $0 
Seat 1: ImaPeppaPig folded before Flop (didn't bet)
Seat 2: AlexPinsk1 (button) folded before Flop (didn't bet)
Seat 3: sta$igk (small blind) folded before Flop
Seat 4: app1e_j@ck (big blind) folded before Flop
Seat 6: MAO_DZEDYN_S collected ($2.50)



PokerStars Hand #254283026320:  Hold'em No Limit ($0.50/$1.00 USD) - 2025/01/09 20:05:27 WET [2025/01/09 15:05:27 ET]
Table 'Dagmar II' 6-max Seat #3 is the button
Seat 6: MAO_DZEDYN_S ($166.95 in chips) is sitting out
Seat 1: ImaPeppaPig ($100 in chips) 
Seat 2: AlexPinsk1 ($135.08 in chips) 
Seat 3: sta$igk ($100 in chips) 
Seat 4: app1e_j@ck ($198.95 in chips) 
app1e_j@ck: posts small blind $0.50
MAO_DZEDYN_S: is sitting out 
ImaPeppaPig: posts big blind $1
*** HOLE CARDS ***
AlexPinsk1: folds 
MAO_DZEDYN_S leaves the table
sta$igk: raises $1.50 to $2.50
app1e_j@ck: raises $10 to $12.50
ImaPeppaPig: folds 
sta$igk: folds 
Uncalled bet ($10) returned to app1e_j@ck
app1e_j@ck collected $6 from pot
app1e_j@ck: doesn't show hand 
*** SUMMARY ***
Total pot $6 | Rake $0 
Seat 6: MAO_DZEDYN_S
Seat 1: ImaPeppaPig (big blind) folded before Flop
Seat 2: AlexPinsk1 folded before Flop (didn't bet)
Seat 3: sta$igk (button) folded before Flop
Seat 4: app1e_j@ck (small blind) collected ($6)



PokerStars Hand #254283030720:  Hold'em No Limit ($0.50/$1.00 USD) - 2025/01/09 20:05:41 WET [2025/01/09 15:05:41 ET]
Table 'Dagmar II' 6-max Seat #1 is the button
Seat 2: AlexPinsk1 ($135.08 in chips) is sitting out
Seat 3: sta$igk ($100 in chips) is sitting out
Seat 1: ImaPeppaPig ($100 in chips) 
Seat 4: app1e_j@ck ($202.45 in chips) 
ImaPeppaPig: posts small blind $0.50
AlexPinsk1: is sitting out 
sta$igk: is sitting out 
app1e_j@ck: posts big blind $1
*** HOLE CARDS ***
sta$igk leaves the table
ImaPeppaPig: folds 
Uncalled bet ($0.50) returned to app1e_j@ck
app1e_j@ck collected $1 from pot
app1e_j@ck: doesn't show hand 
*** SUMMARY ***
Total pot $1 | Rake $0 
Seat 2: AlexPinsk1
Seat 3: sta$igk
Seat 1: ImaPeppaPig (button) (small blind) folded before Flop
Seat 4: app1e_j@ck (big blind) collected ($1)



