PokerStars Hand #254288344443:  Hold'em No Limit ($0.50/$1.00 USD) - 2025/01/09 0:34:15 WET [2025/01/09 19:34:15 ET]
Table 'Altais II' 6-max Seat #4 is the button
Seat 2: GuigaMan ($100 in chips) 
Seat 4: nikalas22 ($100 in chips) 
nikalas22: posts small blind $0.50
GuigaMan: posts big blind $1
*** HOLE CARDS ***
nikalas22: raises $1.50 to $2.50
GuigaMan: raises $8.50 to $11
nikalas22: raises $13 to $24
GuigaMan: folds 
Uncalled bet ($13) returned to nikalas22
nikalas22 collected $22 from pot
nikalas22: doesn't show hand 
*** SUMMARY ***
Total pot $22 | Rake $0 
Seat 2: GuigaMan (big blind) folded before Flop
Seat 4: nikalas22 (button) (small blind) collected ($22)



PokerStars Hand #254288351786:  Hold'em No Limit ($0.50/$1.00 USD) - 2025/01/09 0:34:49 WET [2025/01/09 19:34:49 ET]
Table 'Altais II' 6-max Seat #2 is the button
Seat 2: GuigaMan ($100 in chips) 
Seat 4: nikalas22 ($111 in chips) 
GuigaMan: posts small blind $0.50
nikalas22: posts big blind $1
*** HOLE CARDS ***
GuigaMan: folds 
Uncalled bet ($0.50) returned to nikalas22
nikalas22 collected $1 from pot
nikalas22: doesn't show hand 
*** SUMMARY ***
Total pot $1 | Rake $0 
Seat 2: GuigaMan (button) (small blind) folded before Flop
Seat 4: nikalas22 (big blind) collected ($1)



PokerStars Hand #254288419162:  Hold'em No Limit ($0.50/$1.00 USD) - 2025/01/09 0:40:11 WET [2025/01/09 19:40:11 ET]
Table 'Altais II' 6-max Seat #3 is the button
Seat 1: LuckyShikari ($10 in chips) 
Seat 2: GuigaMan ($100 in chips) 
Seat 3: rrrro ($100 in chips) 
Seat 4: nikalas22 ($111.50 in chips) 
nikalas22: posts small blind $0.50
LuckyShikari: posts big blind $1
*** HOLE CARDS ***
GuigaMan: folds 
rrrro: folds 
nikalas22: folds 
Uncalled bet ($0.50) returned to LuckyShikari
LuckyShikari collected $1 from pot
LuckyShikari: doesn't show hand 
*** SUMMARY ***
Total pot $1 | Rake $0 
Seat 1: LuckyShikari (big blind) collected ($1)
Seat 2: GuigaMan folded before Flop (didn't bet)
Seat 3: rrrro (button) folded before Flop (didn't bet)
Seat 4: nikalas22 (small blind) folded before Flop



PokerStars Hand #254288424854:  Hold'em No Limit ($0.50/$1.00 USD) - 2025/01/09 0:40:38 WET [2025/01/09 19:40:38 ET]
Table 'Altais II' 6-max Seat #4 is the button
Seat 1: LuckyShikari ($100 in chips) 
Seat 2: GuigaMan ($100 in chips) 
Seat 3: rrrro ($100 in chips) 
Seat 4: nikalas22 ($111 in chips) 
LuckyShikari: posts small blind $0.50
GuigaMan: posts big blind $1
*** HOLE CARDS ***
rrrro: raises $1.30 to $2.30
nikalas22: folds 
LuckyShikari: folds 
GuigaMan: folds 
Uncalled bet ($1.30) returned to rrrro
rrrro collected $2.50 from pot
rrrro: doesn't show hand 
*** SUMMARY ***
Total pot $2.50 | Rake $0 
Seat 1: LuckyShikari (small blind) folded before Flop
Seat 2: GuigaMan (big blind) folded before Flop
Seat 3: rrrro collected ($2.50)
Seat 4: nikalas22 (button) folded before Flop (didn't bet)



PokerStars Hand #254288428993:  Hold'em No Limit ($0.50/$1.00 USD) - 2025/01/09 0:40:58 WET [2025/01/09 19:40:58 ET]
Table 'Altais II' 6-max Seat #1 is the button
Seat 1: LuckyShikari ($100 in chips) 
Seat 2: GuigaMan ($100 in chips) 
Seat 3: rrrro ($101.50 in chips) 
Seat 4: nikalas22 ($111 in chips) 
GuigaMan: posts small blind $0.50
rrrro: posts big blind $1
*** HOLE CARDS ***
nikalas22: raises $1.50 to $2.50
LuckyShikari: folds 
GuigaMan: folds 
ermescorrea joins the table at seat #6 
ermescorrea is disconnected 
rrrro: folds 
Uncalled bet ($1.50) returned to nikalas22
nikalas22 collected $2.50 from pot
nikalas22: doesn't show hand 
*** SUMMARY ***
Total pot $2.50 | Rake $0 
Seat 1: LuckyShikari (button) folded before Flop (didn't bet)
Seat 2: GuigaMan (small blind) folded before Flop
Seat 3: rrrro (big blind) folded before Flop
Seat 4: nikalas22 collected ($2.50)



PokerStars Hand #254288432298:  Hold'em No Limit ($0.50/$1.00 USD) - 2025/01/09 0:41:14 WET [2025/01/09 19:41:14 ET]
Table 'Altais II' 6-max Seat #2 is the button
Seat 1: LuckyShikari ($100 in chips) 
Seat 2: GuigaMan ($100 in chips) 
Seat 3: rrrro ($100.50 in chips) 
Seat 4: nikalas22 ($112.50 in chips) 
Seat 6: ermescorrea ($10.38 in chips) 
rrrro: posts small blind $0.50
nikalas22: posts big blind $1
ermescorrea: posts big blind $1
*** HOLE CARDS ***
ermescorrea: raises $9.38 to $10.38 and is all-in
LuckyShikari: folds 
GuigaMan: folds 
rrrro: folds 
nikalas22: folds 
Uncalled bet ($9.38) returned to ermescorrea
ermescorrea collected $2.50 from pot
ermescorrea: doesn't show hand 
*** SUMMARY ***
Total pot $2.50 | Rake $0 
Seat 1: LuckyShikari folded before Flop (didn't bet)
Seat 2: GuigaMan (button) folded before Flop (didn't bet)
Seat 3: rrrro (small blind) folded before Flop
Seat 4: nikalas22 (big blind) folded before Flop
Seat 6: ermescorrea collected ($2.50)



PokerStars Hand #254288435416:  Hold'em No Limit ($0.50/$1.00 USD) - 2025/01/09 0:41:29 WET [2025/01/09 19:41:29 ET]
Table 'Altais II' 6-max Seat #3 is the button
Seat 1: LuckyShikari ($100 in chips) 
Seat 2: GuigaMan ($100 in chips) 
Seat 3: rrrro ($100 in chips) 
Seat 4: nikalas22 ($111.50 in chips) 
Seat 6: ermescorrea ($11.88 in chips) 
nikalas22: posts small blind $0.50
ermescorrea: posts big blind $1
*** HOLE CARDS ***
LuckyShikari: folds 
GuigaMan: raises $1.10 to $2.10
rrrro: folds 
nikalas22: folds 
jeilsons joins the table at seat #5 
ermescorrea: calls $1.10
*** FLOP *** [3h 2s 9h]
ermescorrea: checks 
GuigaMan: checks 
*** TURN *** [3h 2s 9h] [5c]
ermescorrea: bets $2.23
GuigaMan: calls $2.23
*** RIVER *** [3h 2s 9h 5c] [6d]
ermescorrea: bets $7.55 and is all-in
GuigaMan: folds 
Uncalled bet ($7.55) returned to ermescorrea
ermescorrea collected $8.70 from pot
ermescorrea: doesn't show hand 
*** SUMMARY ***
Total pot $9.16 | Rake $0.46 
Board [3h 2s 9h 5c 6d]
Seat 1: LuckyShikari folded before Flop (didn't bet)
Seat 2: GuigaMan folded on the River
Seat 3: rrrro (button) folded before Flop (didn't bet)
Seat 4: nikalas22 (small blind) folded before Flop
Seat 6: ermescorrea (big blind) collected ($8.70)



PokerStars Hand #254288449956:  Hold'em No Limit ($0.50/$1.00 USD) - 2025/01/09 0:42:39 WET [2025/01/09 19:42:39 ET]
Table 'Altais II' 6-max Seat #4 is the button
Seat 5: jeilsons ($100 in chips) is sitting out
Seat 1: LuckyShikari ($100 in chips) 
Seat 2: GuigaMan ($100 in chips) 
Seat 3: rrrro ($100 in chips) 
Seat 4: nikalas22 ($111 in chips) 
Seat 6: ermescorrea ($16.25 in chips) 
ermescorrea: posts small blind $0.50
LuckyShikari: posts big blind $1
*** HOLE CARDS ***
GuigaMan: raises $1.10 to $2.10
rrrro: raises $4.90 to $7
nikalas22: folds 
ermescorrea: folds 
jeilsons leaves the table
LuckyShikari: folds 
GuigaMan: calls $4.90
*** FLOP *** [Th 2c 8c]
GuigaMan: checks 
rrrro: bets $7.36
Spanky2Jacks joins the table at seat #5 
GuigaMan: calls $7.36
*** TURN *** [Th 2c 8c] [5s]
GuigaMan: checks 
Spanky2Jacks is disconnected 
rrrro: checks 
*** RIVER *** [Th 2c 8c 5s] [8d]
GuigaMan: bets $8.61
rrrro: raises $22.97 to $31.58
GuigaMan: folds 
Uncalled bet ($22.97) returned to rrrro
rrrro collected $45.07 from pot
rrrro: doesn't show hand 
*** SUMMARY ***
Total pot $47.44 | Rake $2.37 
Board [Th 2c 8c 5s 8d]
Seat 5: jeilsons
Seat 1: LuckyShikari (big blind) folded before Flop
Seat 2: GuigaMan folded on the River
Seat 3: rrrro collected ($45.07)
Seat 4: nikalas22 (button) folded before Flop (didn't bet)
Seat 6: ermescorrea (small blind) folded before Flop



PokerStars Hand #254288476255:  Hold'em No Limit ($0.50/$1.00 USD) - 2025/01/09 0:44:47 WET [2025/01/09 19:44:47 ET]
Table 'Altais II' 6-max Seat #6 is the button
Seat 1: LuckyShikari ($100 in chips) 
Seat 2: GuigaMan ($100 in chips) 
Seat 3: rrrro ($122.10 in chips) 
Seat 4: nikalas22 ($111 in chips) 
Seat 5: Spanky2Jacks ($62.92 in chips) 
Seat 6: ermescorrea ($15.75 in chips) 
LuckyShikari: posts small blind $0.50
GuigaMan: posts big blind $1
Spanky2Jacks: posts big blind $1
*** HOLE CARDS ***
rrrro: folds 
nikalas22: folds 
Spanky2Jacks: checks 
ermescorrea: raises $14.75 to $15.75 and is all-in
LuckyShikari: folds 
GuigaMan: folds 
Spanky2Jacks: folds 
Uncalled bet ($14.75) returned to ermescorrea
ermescorrea collected $3.50 from pot
ermescorrea: doesn't show hand 
*** SUMMARY ***
Total pot $3.50 | Rake $0 
Seat 1: LuckyShikari (small blind) folded before Flop
Seat 2: GuigaMan (big blind) folded before Flop
Seat 3: rrrro folded before Flop (didn't bet)
Seat 4: nikalas22 folded before Flop (didn't bet)
Seat 5: Spanky2Jacks folded before Flop (didn't bet)
Seat 6: ermescorrea (button) collected ($3.50)



PokerStars Hand #254288481440:  Hold'em No Limit ($0.50/$1.00 USD) - 2025/01/09 0:45:12 WET [2025/01/09 19:45:12 ET]
Table 'Altais II' 6-max Seat #1 is the button
Seat 1: LuckyShikari ($100 in chips) 
Seat 2: GuigaMan ($100 in chips) 
Seat 3: rrrro ($122.10 in chips) 
Seat 4: nikalas22 ($111 in chips) 
Seat 5: Spanky2Jacks ($61.92 in chips) 
Seat 6: ermescorrea ($18.25 in chips) 
GuigaMan: posts small blind $0.50
rrrro: posts big blind $1
*** HOLE CARDS ***
nikalas22: folds 
Spanky2Jacks: folds 
ermescorrea: folds 
LuckyShikari: raises $1.25 to $2.25
GuigaMan: folds 
rrrro: raises $10.75 to $13
LuckyShikari: calls $10.75
*** FLOP *** [Kh As Ad]
rrrro: bets $6.30
LuckyShikari: calls $6.30
*** TURN *** [Kh As Ad] [5h]
rrrro: checks 
LuckyShikari: checks 
*** RIVER *** [Kh As Ad 5h] [6h]
rrrro: checks 
LuckyShikari: checks 
*** SHOW DOWN ***
rrrro: shows [3h Ah] (a flush, Ace high)
LuckyShikari: mucks hand 
rrrro collected $37.14 from pot
*** SUMMARY ***
Total pot $39.10 | Rake $1.96 
Board [Kh As Ad 5h 6h]
Seat 1: LuckyShikari (button) mucked
Seat 2: GuigaMan (small blind) folded before Flop
Seat 3: rrrro (big blind) showed [3h Ah] and won ($37.14) with a flush, Ace high
Seat 4: nikalas22 folded before Flop (didn't bet)
Seat 5: Spanky2Jacks folded before Flop (didn't bet)
Seat 6: ermescorrea folded before Flop (didn't bet)



PokerStars Hand #254288502814:  Hold'em No Limit ($0.50/$1.00 USD) - 2025/01/09 0:46:58 WET [2025/01/09 19:46:58 ET]
Table 'Altais II' 6-max Seat #2 is the button
Seat 1: LuckyShikari ($100 in chips) 
Seat 2: GuigaMan ($100 in chips) 
Seat 3: rrrro ($139.94 in chips) 
Seat 4: nikalas22 ($111 in chips) 
Seat 5: Spanky2Jacks ($61.92 in chips) 
Seat 6: ermescorrea ($18.25 in chips) 
rrrro: posts small blind $0.50
nikalas22: posts big blind $1
*** HOLE CARDS ***
Spanky2Jacks: folds 
ermescorrea: folds 
LuckyShikari: folds 
GuigaMan: folds 
rrrro: folds 
Uncalled bet ($0.50) returned to nikalas22
nikalas22 collected $1 from pot
nikalas22: doesn't show hand 
*** SUMMARY ***
Total pot $1 | Rake $0 
Seat 1: LuckyShikari folded before Flop (didn't bet)
Seat 2: GuigaMan (button) folded before Flop (didn't bet)
Seat 3: rrrro (small blind) folded before Flop
Seat 4: nikalas22 (big blind) collected ($1)
Seat 5: Spanky2Jacks folded before Flop (didn't bet)
Seat 6: ermescorrea folded before Flop (didn't bet)



PokerStars Hand #254288506151:  Hold'em No Limit ($0.50/$1.00 USD) - 2025/01/09 0:47:14 WET [2025/01/09 19:47:14 ET]
Table 'Altais II' 6-max Seat #3 is the button
Seat 1: LuckyShikari ($100 in chips) 
Seat 2: GuigaMan ($100 in chips) 
Seat 3: rrrro ($139.44 in chips) 
Seat 4: nikalas22 ($111.50 in chips) 
Seat 5: Spanky2Jacks ($61.92 in chips) 
Seat 6: ermescorrea ($18.25 in chips) 
nikalas22: posts small blind $0.50
Spanky2Jacks: posts big blind $1
*** HOLE CARDS ***
ermescorrea: raises $17.25 to $18.25 and is all-in
LuckyShikari: folds 
GuigaMan: calls $18.25
rrrro: folds 
nikalas22: folds 
Spanky2Jacks: folds 
*** FLOP *** [2h 6d 4c]
*** TURN *** [2h 6d 4c] [6c]
*** RIVER *** [2h 6d 4c 6c] [5h]
*** SHOW DOWN ***
ermescorrea: shows [Ah 6h] (three of a kind, Sixes)
GuigaMan: shows [7c 7d] (two pair, Sevens and Sixes)
ermescorrea collected $36.10 from pot
*** SUMMARY ***
Total pot $38 | Rake $1.90 
Board [2h 6d 4c 6c 5h]
Seat 1: LuckyShikari folded before Flop (didn't bet)
Seat 2: GuigaMan showed [7c 7d] and lost with two pair, Sevens and Sixes
Seat 3: rrrro (button) folded before Flop (didn't bet)
Seat 4: nikalas22 (small blind) folded before Flop
Seat 5: Spanky2Jacks (big blind) folded before Flop
Seat 6: ermescorrea showed [Ah 6h] and won ($36.10) with three of a kind, Sixes



PokerStars Hand #254288515198:  Hold'em No Limit ($0.50/$1.00 USD) - 2025/01/09 0:47:58 WET [2025/01/09 19:47:58 ET]
Table 'Altais II' 6-max Seat #4 is the button
Seat 1: LuckyShikari ($100 in chips) 
Seat 2: GuigaMan ($100 in chips) 
Seat 3: rrrro ($139.44 in chips) 
Seat 4: nikalas22 ($111 in chips) 
Seat 5: Spanky2Jacks ($60.92 in chips) 
Seat 6: ermescorrea ($36.10 in chips) 
Spanky2Jacks: posts small blind $0.50
ermescorrea: posts big blind $1
*** HOLE CARDS ***
LuckyShikari: folds 
GuigaMan: raises $1.10 to $2.10
rrrro: folds 
nikalas22: folds 
Spanky2Jacks: folds 
ermescorrea: folds 
Uncalled bet ($1.10) returned to GuigaMan
GuigaMan collected $2.50 from pot
GuigaMan: doesn't show hand 
*** SUMMARY ***
Total pot $2.50 | Rake $0 
Seat 1: LuckyShikari folded before Flop (didn't bet)
Seat 2: GuigaMan collected ($2.50)
Seat 3: rrrro folded before Flop (didn't bet)
Seat 4: nikalas22 (button) folded before Flop (didn't bet)
Seat 5: Spanky2Jacks (small blind) folded before Flop
Seat 6: ermescorrea (big blind) folded before Flop



PokerStars Hand #254288518488:  Hold'em No Limit ($0.50/$1.00 USD) - 2025/01/09 0:48:14 WET [2025/01/09 19:48:14 ET]
Table 'Altais II' 6-max Seat #5 is the button
Seat 1: LuckyShikari ($100 in chips) 
Seat 2: GuigaMan ($101.50 in chips) 
Seat 3: rrrro ($139.44 in chips) 
Seat 4: nikalas22 ($111 in chips) 
Seat 5: Spanky2Jacks ($60.42 in chips) 
Seat 6: ermescorrea ($35.10 in chips) 
ermescorrea: posts small blind $0.50
LuckyShikari: posts big blind $1
*** HOLE CARDS ***
GuigaMan: raises $1.10 to $2.10
rrrro: raises $4.40 to $6.50
nikalas22: folds 
Spanky2Jacks: folds 
ermescorrea: folds 
LuckyShikari: folds 
GuigaMan: folds 
Uncalled bet ($4.40) returned to rrrro
rrrro collected $5.70 from pot
rrrro: doesn't show hand 
*** SUMMARY ***
Total pot $5.70 | Rake $0 
Seat 1: LuckyShikari (big blind) folded before Flop
Seat 2: GuigaMan folded before Flop
Seat 3: rrrro collected ($5.70)
Seat 4: nikalas22 folded before Flop (didn't bet)
Seat 5: Spanky2Jacks (button) folded before Flop (didn't bet)
Seat 6: ermescorrea (small blind) folded before Flop



PokerStars Hand #254288524513:  Hold'em No Limit ($0.50/$1.00 USD) - 2025/01/09 0:48:44 WET [2025/01/09 19:48:44 ET]
Table 'Altais II' 6-max Seat #6 is the button
Seat 1: LuckyShikari ($100 in chips) 
Seat 2: GuigaMan ($100 in chips) 
Seat 3: rrrro ($143.04 in chips) 
Seat 4: nikalas22 ($111 in chips) 
Seat 5: Spanky2Jacks ($60.42 in chips) 
Seat 6: ermescorrea ($34.60 in chips) 
LuckyShikari: posts small blind $0.50
GuigaMan: posts big blind $1
*** HOLE CARDS ***
rrrro: folds 
nikalas22: folds 
Spanky2Jacks: folds 
ermescorrea: folds 
LuckyShikari: raises $2 to $3
GuigaMan: raises $6 to $9
LuckyShikari: folds 
Uncalled bet ($6) returned to GuigaMan
GuigaMan collected $6 from pot
GuigaMan: doesn't show hand 
*** SUMMARY ***
Total pot $6 | Rake $0 
Seat 1: LuckyShikari (small blind) folded before Flop
Seat 2: GuigaMan (big blind) collected ($6)
Seat 3: rrrro folded before Flop (didn't bet)
Seat 4: nikalas22 folded before Flop (didn't bet)
Seat 5: Spanky2Jacks folded before Flop (didn't bet)
Seat 6: ermescorrea (button) folded before Flop (didn't bet)



PokerStars Hand #254288530868:  Hold'em No Limit ($0.50/$1.00 USD) - 2025/01/09 0:49:16 WET [2025/01/09 19:49:16 ET]
Table 'Altais II' 6-max Seat #1 is the button
Seat 1: LuckyShikari ($100 in chips) 
Seat 2: GuigaMan ($103 in chips) 
Seat 3: rrrro ($143.04 in chips) 
Seat 4: nikalas22 ($111 in chips) 
Seat 5: Spanky2Jacks ($60.42 in chips) 
Seat 6: ermescorrea ($34.60 in chips) 
GuigaMan: posts small blind $0.50
rrrro: posts big blind $1
*** HOLE CARDS ***
nikalas22: folds 
Spanky2Jacks: folds 
ermescorrea: raises $1.22 to $2.22
LuckyShikari: folds 
GuigaMan: folds 
rrrro: calls $1.22
*** FLOP *** [6d 7c Qh]
rrrro: checks 
ermescorrea: bets $3.18
rrrro: folds 
Uncalled bet ($3.18) returned to ermescorrea
ermescorrea collected $4.69 from pot
*** SUMMARY ***
Total pot $4.94 | Rake $0.25 
Board [6d 7c Qh]
Seat 1: LuckyShikari (button) folded before Flop (didn't bet)
Seat 2: GuigaMan (small blind) folded before Flop
Seat 3: rrrro (big blind) folded on the Flop
Seat 4: nikalas22 folded before Flop (didn't bet)
Seat 5: Spanky2Jacks folded before Flop (didn't bet)
Seat 6: ermescorrea collected ($4.69)



PokerStars Hand #254288545502:  Hold'em No Limit ($0.50/$1.00 USD) - 2025/01/09 0:50:29 WET [2025/01/09 19:50:29 ET]
Table 'Altais II' 6-max Seat #2 is the button
Seat 1: LuckyShikari ($100 in chips) 
Seat 2: GuigaMan ($102.50 in chips) 
Seat 3: rrrro ($140.82 in chips) 
Seat 4: nikalas22 ($111 in chips) 
Seat 5: Spanky2Jacks ($60.42 in chips) 
Seat 6: ermescorrea ($37.07 in chips) 
rrrro: posts small blind $0.50
nikalas22: posts big blind $1
*** HOLE CARDS ***
Spanky2Jacks: folds 
ermescorrea: folds 
ermescorrea leaves the table
LuckyShikari: raises $1 to $2
GuigaMan: folds 
rrrro: raises $8 to $10
nikalas22: folds 
LuckyShikari: folds 
Uncalled bet ($8) returned to rrrro
rrrro collected $5 from pot
rrrro: doesn't show hand 
*** SUMMARY ***
Total pot $5 | Rake $0 
Seat 1: LuckyShikari folded before Flop
Seat 2: GuigaMan (button) folded before Flop (didn't bet)
Seat 3: rrrro (small blind) collected ($5)
Seat 4: nikalas22 (big blind) folded before Flop
Seat 5: Spanky2Jacks folded before Flop (didn't bet)
Seat 6: ermescorrea folded before Flop (didn't bet)



PokerStars Hand #254288550980:  Hold'em No Limit ($0.50/$1.00 USD) - 2025/01/09 0:50:56 WET [2025/01/09 19:50:56 ET]
Table 'Altais II' 6-max Seat #3 is the button
Seat 1: LuckyShikari ($100 in chips) 
Seat 2: GuigaMan ($102.50 in chips) 
Seat 3: rrrro ($143.82 in chips) 
Seat 4: nikalas22 ($110 in chips) 
Seat 5: Spanky2Jacks ($60.42 in chips) 
nikalas22: posts small blind $0.50
Spanky2Jacks: posts big blind $1
*** HOLE CARDS ***
LuckyShikari: raises $1.25 to $2.25
GuigaMan: folds 
rrrro: folds 
nikalas22: folds 
Spanky2Jacks: folds 
Uncalled bet ($1.25) returned to LuckyShikari
LuckyShikari collected $2.50 from pot
LuckyShikari: doesn't show hand 
*** SUMMARY ***
Total pot $2.50 | Rake $0 
Seat 1: LuckyShikari collected ($2.50)
Seat 2: GuigaMan folded before Flop (didn't bet)
Seat 3: rrrro (button) folded before Flop (didn't bet)
Seat 4: nikalas22 (small blind) folded before Flop
Seat 5: Spanky2Jacks (big blind) folded before Flop



PokerStars Hand #254288556084:  Hold'em No Limit ($0.50/$1.00 USD) - 2025/01/09 0:51:22 WET [2025/01/09 19:51:22 ET]
Table 'Altais II' 6-max Seat #4 is the button
Seat 1: LuckyShikari ($101.50 in chips) 
Seat 2: GuigaMan ($102.50 in chips) 
Seat 3: rrrro ($143.82 in chips) 
Seat 4: nikalas22 ($109.50 in chips) 
Seat 5: Spanky2Jacks ($59.42 in chips) 
Spanky2Jacks: posts small blind $0.50
LuckyShikari: posts big blind $1
*** HOLE CARDS ***
GuigaMan: folds 
rrrro: folds 
nikalas22: folds 
Spanky2Jacks: calls $0.50
LuckyShikari: checks 
*** FLOP *** [Kc 6s 8s]
Spanky2Jacks: checks 
LuckyShikari: checks 
*** TURN *** [Kc 6s 8s] [7c]
Spanky2Jacks: checks 
LuckyShikari: checks 
*** RIVER *** [Kc 6s 8s 7c] [8d]
Spanky2Jacks: bets $2
LuckyShikari: folds 
Uncalled bet ($2) returned to Spanky2Jacks
Spanky2Jacks collected $1.90 from pot
*** SUMMARY ***
Total pot $2 | Rake $0.10 
Board [Kc 6s 8s 7c 8d]
Seat 1: LuckyShikari (big blind) folded on the River
Seat 2: GuigaMan folded before Flop (didn't bet)
Seat 3: rrrro folded before Flop (didn't bet)
Seat 4: nikalas22 (button) folded before Flop (didn't bet)
Seat 5: Spanky2Jacks (small blind) collected ($1.90)



PokerStars Hand #254288566238:  Hold'em No Limit ($0.50/$1.00 USD) - 2025/01/09 0:52:13 WET [2025/01/09 19:52:13 ET]
Table 'Altais II' 6-max Seat #5 is the button
Seat 1: LuckyShikari ($100.50 in chips) 
Seat 2: GuigaMan ($102.50 in chips) 
Seat 3: rrrro ($143.82 in chips) 
Seat 4: nikalas22 ($109.50 in chips) 
Seat 5: Spanky2Jacks ($60.32 in chips) 
LuckyShikari: posts small blind $0.50
GuigaMan: posts big blind $1
*** HOLE CARDS ***
rrrro: folds 
nikalas22: raises $1.50 to $2.50
Spanky2Jacks: calls $2.50
LuckyShikari: folds 
GuigaMan: folds 
*** FLOP *** [Qh 2d 9c]
chenconhaste joins the table at seat #6 
nikalas22: checks 
Spanky2Jacks: checks 
*** TURN *** [Qh 2d 9c] [5h]
nikalas22: bets $1.85
Spanky2Jacks: calls $1.85
*** RIVER *** [Qh 2d 9c 5h] [9h]
nikalas22: bets $7.27
Spanky2Jacks: raises $7.27 to $14.54
nikalas22: calls $7.27
*** SHOW DOWN ***
Spanky2Jacks: shows [5s 5d] (a full house, Fives full of Nines)
nikalas22: mucks hand 
Spanky2Jacks collected $37.32 from pot
*** SUMMARY ***
Total pot $39.28 | Rake $1.96 
Board [Qh 2d 9c 5h 9h]
Seat 1: LuckyShikari (small blind) folded before Flop
Seat 2: GuigaMan (big blind) folded before Flop
Seat 3: rrrro folded before Flop (didn't bet)
Seat 4: nikalas22 mucked
Seat 5: Spanky2Jacks (button) showed [5s 5d] and won ($37.32) with a full house, Fives full of Nines



PokerStars Hand #254288579655:  Hold'em No Limit ($0.50/$1.00 USD) - 2025/01/09 0:53:21 WET [2025/01/09 19:53:21 ET]
Table 'Altais II' 6-max Seat #1 is the button
Seat 6: chenconhaste ($100 in chips) is sitting out
Seat 1: LuckyShikari ($100 in chips) 
Seat 2: GuigaMan ($101.50 in chips) 
Seat 3: rrrro ($143.82 in chips) 
Seat 4: nikalas22 ($100 in chips) 
Seat 5: Spanky2Jacks ($78.75 in chips) 
GuigaMan: posts small blind $0.50
rrrro: posts big blind $1
chenconhaste: sits out 
*** HOLE CARDS ***
nikalas22: folds 
Spanky2Jacks: raises $2.50 to $3.50
LuckyShikari: folds 
GuigaMan: folds 
rrrro: folds 
Uncalled bet ($2.50) returned to Spanky2Jacks
Spanky2Jacks collected $2.50 from pot
*** SUMMARY ***
Total pot $2.50 | Rake $0 
Seat 6: chenconhaste
Seat 1: LuckyShikari (button) folded before Flop (didn't bet)
Seat 2: GuigaMan (small blind) folded before Flop
Seat 3: rrrro (big blind) folded before Flop
Seat 4: nikalas22 folded before Flop (didn't bet)
Seat 5: Spanky2Jacks collected ($2.50)



PokerStars Hand #254288587028:  Hold'em No Limit ($0.50/$1.00 USD) - 2025/01/09 0:53:58 WET [2025/01/09 19:53:58 ET]
Table 'Altais II' 6-max Seat #2 is the button
Seat 6: chenconhaste ($100 in chips) is sitting out
Seat 1: LuckyShikari ($100 in chips) 
Seat 2: GuigaMan ($101 in chips) 
Seat 3: rrrro ($142.82 in chips) 
Seat 4: nikalas22 ($100 in chips) 
Seat 5: Spanky2Jacks ($80.25 in chips) 
rrrro: posts small blind $0.50
nikalas22: posts big blind $1
chenconhaste: sits out 
*** HOLE CARDS ***
Spanky2Jacks: raises $2.50 to $3.50
LuckyShikari: folds 
GuigaMan: calls $3.50
rrrro: folds 
nikalas22: folds 
*** FLOP *** [9h 9s 8d]
Spanky2Jacks: checks 
GuigaMan: bets $2.42
Spanky2Jacks: calls $2.42
*** TURN *** [9h 9s 8d] [2d]
Spanky2Jacks: checks 
GuigaMan: checks 
*** RIVER *** [9h 9s 8d 2d] [Jd]
Spanky2Jacks: checks 
GuigaMan: bets $9.50
Spanky2Jacks: folds 
Uncalled bet ($9.50) returned to GuigaMan
GuigaMan collected $12.67 from pot
GuigaMan: doesn't show hand 
*** SUMMARY ***
Total pot $13.34 | Rake $0.67 
Board [9h 9s 8d 2d Jd]
Seat 6: chenconhaste
Seat 1: LuckyShikari folded before Flop (didn't bet)
Seat 2: GuigaMan (button) collected ($12.67)
Seat 3: rrrro (small blind) folded before Flop
Seat 4: nikalas22 (big blind) folded before Flop
Seat 5: Spanky2Jacks folded on the River



PokerStars Hand #254288604557:  Hold'em No Limit ($0.50/$1.00 USD) - 2025/01/09 0:55:33 WET [2025/01/09 19:55:33 ET]
Table 'Altais II' 6-max Seat #3 is the button
Seat 6: chenconhaste ($100 in chips) is sitting out
Seat 1: LuckyShikari ($100 in chips) 
Seat 2: GuigaMan ($107.75 in chips) 
Seat 3: rrrro ($142.32 in chips) 
Seat 4: nikalas22 ($100 in chips) 
Seat 5: Spanky2Jacks ($74.33 in chips) 
nikalas22: posts small blind $0.50
Spanky2Jacks: posts big blind $1
chenconhaste: sits out 
*** HOLE CARDS ***
LuckyShikari: folds 
GuigaMan: folds 
rrrro: folds 
nikalas22: folds 
Uncalled bet ($0.50) returned to Spanky2Jacks
Spanky2Jacks collected $1 from pot
*** SUMMARY ***
Total pot $1 | Rake $0 
Seat 6: chenconhaste
Seat 1: LuckyShikari folded before Flop (didn't bet)
Seat 2: GuigaMan folded before Flop (didn't bet)
Seat 3: rrrro (button) folded before Flop (didn't bet)
Seat 4: nikalas22 (small blind) folded before Flop
Seat 5: Spanky2Jacks (big blind) collected ($1)



PokerStars Hand #254288606374:  Hold'em No Limit ($0.50/$1.00 USD) - 2025/01/09 0:55:45 WET [2025/01/09 19:55:45 ET]
Table 'Altais II' 6-max Seat #4 is the button
Seat 1: LuckyShikari ($100 in chips) 
Seat 2: GuigaMan ($107.75 in chips) 
Seat 3: rrrro ($142.32 in chips) 
Seat 4: nikalas22 ($100 in chips) 
Seat 5: Spanky2Jacks ($74.83 in chips) 
Seat 6: chenconhaste ($100 in chips) 
Spanky2Jacks: posts small blind $0.50
chenconhaste: posts big blind $1
*** HOLE CARDS ***
LuckyShikari: folds 
GuigaMan: folds 
rrrro: folds 
nikalas22: folds 
Spanky2Jacks: calls $0.50
chenconhaste: raises $3 to $4
Spanky2Jacks: folds 
Uncalled bet ($3) returned to chenconhaste
chenconhaste collected $2 from pot
*** SUMMARY ***
Total pot $2 | Rake $0 
Seat 1: LuckyShikari folded before Flop (didn't bet)
Seat 2: GuigaMan folded before Flop (didn't bet)
Seat 3: rrrro folded before Flop (didn't bet)
Seat 4: nikalas22 (button) folded before Flop (didn't bet)
Seat 5: Spanky2Jacks (small blind) folded before Flop
Seat 6: chenconhaste (big blind) collected ($2)



PokerStars Hand #254288610452:  Hold'em No Limit ($0.50/$1.00 USD) - 2025/01/09 0:56:11 WET [2025/01/09 19:56:11 ET]
Table 'Altais II' 6-max Seat #5 is the button
Seat 1: LuckyShikari ($100 in chips) 
Seat 2: GuigaMan ($107.75 in chips) 
Seat 3: rrrro ($142.32 in chips) 
Seat 4: nikalas22 ($100 in chips) 
Seat 5: Spanky2Jacks ($73.83 in chips) 
Seat 6: chenconhaste ($101 in chips) 
chenconhaste: posts small blind $0.50
LuckyShikari: posts big blind $1
*** HOLE CARDS ***
GuigaMan: raises $1.10 to $2.10
rrrro: folds 
nikalas22: folds 
Spanky2Jacks: folds 
chenconhaste: folds 
LuckyShikari: folds 
Uncalled bet ($1.10) returned to GuigaMan
GuigaMan collected $2.50 from pot
GuigaMan: doesn't show hand 
*** SUMMARY ***
Total pot $2.50 | Rake $0 
Seat 1: LuckyShikari (big blind) folded before Flop
Seat 2: GuigaMan collected ($2.50)
Seat 3: rrrro folded before Flop (didn't bet)
Seat 4: nikalas22 folded before Flop (didn't bet)
Seat 5: Spanky2Jacks (button) folded before Flop (didn't bet)
Seat 6: chenconhaste (small blind) folded before Flop



PokerStars Hand #254288612890:  Hold'em No Limit ($0.50/$1.00 USD) - 2025/01/09 0:56:26 WET [2025/01/09 19:56:26 ET]
Table 'Altais II' 6-max Seat #6 is the button
Seat 1: LuckyShikari ($100 in chips) 
Seat 2: GuigaMan ($109.25 in chips) 
Seat 3: rrrro ($142.32 in chips) 
Seat 4: nikalas22 ($100 in chips) 
Seat 5: Spanky2Jacks ($73.83 in chips) 
Seat 6: chenconhaste ($100.50 in chips) 
LuckyShikari: posts small blind $0.50
GuigaMan: posts big blind $1
*** HOLE CARDS ***
rrrro: folds 
nikalas22: folds 
Spanky2Jacks: raises $2.50 to $3.50
chenconhaste: folds 
LuckyShikari: folds 
GuigaMan: folds 
Uncalled bet ($2.50) returned to Spanky2Jacks
Spanky2Jacks collected $2.50 from pot
*** SUMMARY ***
Total pot $2.50 | Rake $0 
Seat 1: LuckyShikari (small blind) folded before Flop
Seat 2: GuigaMan (big blind) folded before Flop
Seat 3: rrrro folded before Flop (didn't bet)
Seat 4: nikalas22 folded before Flop (didn't bet)
Seat 5: Spanky2Jacks collected ($2.50)
Seat 6: chenconhaste (button) folded before Flop (didn't bet)



PokerStars Hand #254288619630:  Hold'em No Limit ($0.50/$1.00 USD) - 2025/01/09 0:57:09 WET [2025/01/09 19:57:09 ET]
Table 'Altais II' 6-max Seat #1 is the button
Seat 1: LuckyShikari ($100 in chips) 
Seat 2: GuigaMan ($108.25 in chips) 
Seat 3: rrrro ($142.32 in chips) 
Seat 4: nikalas22 ($100 in chips) 
Seat 5: Spanky2Jacks ($75.33 in chips) 
Seat 6: chenconhaste ($100.50 in chips) 
GuigaMan: posts small blind $0.50
rrrro: posts big blind $1
*** HOLE CARDS ***
nikalas22: folds 
Spanky2Jacks: folds 
chenconhaste: folds 
LuckyShikari: raises $2.50 to $3.50
GuigaMan: folds 
rrrro: folds 
Uncalled bet ($2.50) returned to LuckyShikari
LuckyShikari collected $2.50 from pot
LuckyShikari: doesn't show hand 
*** SUMMARY ***
Total pot $2.50 | Rake $0 
Seat 1: LuckyShikari (button) collected ($2.50)
Seat 2: GuigaMan (small blind) folded before Flop
Seat 3: rrrro (big blind) folded before Flop
Seat 4: nikalas22 folded before Flop (didn't bet)
Seat 5: Spanky2Jacks folded before Flop (didn't bet)
Seat 6: chenconhaste folded before Flop (didn't bet)



PokerStars Hand #254288622633:  Hold'em No Limit ($0.50/$1.00 USD) - 2025/01/09 0:57:28 WET [2025/01/09 19:57:28 ET]
Table 'Altais II' 6-max Seat #2 is the button
Seat 1: LuckyShikari ($101.50 in chips) 
Seat 2: GuigaMan ($107.75 in chips) 
Seat 3: rrrro ($141.32 in chips) 
Seat 4: nikalas22 ($100 in chips) 
Seat 5: Spanky2Jacks ($75.33 in chips) 
Seat 6: chenconhaste ($100.50 in chips) 
rrrro: posts small blind $0.50
nikalas22: posts big blind $1
*** HOLE CARDS ***
Spanky2Jacks: folds 
chenconhaste: folds 
LuckyShikari: folds 
GuigaMan: folds 
rrrro: folds 
Uncalled bet ($0.50) returned to nikalas22
nikalas22 collected $1 from pot
nikalas22: doesn't show hand 
*** SUMMARY ***
Total pot $1 | Rake $0 
Seat 1: LuckyShikari folded before Flop (didn't bet)
Seat 2: GuigaMan (button) folded before Flop (didn't bet)
Seat 3: rrrro (small blind) folded before Flop
Seat 4: nikalas22 (big blind) collected ($1)
Seat 5: Spanky2Jacks folded before Flop (didn't bet)
Seat 6: chenconhaste folded before Flop (didn't bet)



PokerStars Hand #254288626378:  Hold'em No Limit ($0.50/$1.00 USD) - 2025/01/09 0:57:52 WET [2025/01/09 19:57:52 ET]
Table 'Altais II' 6-max Seat #3 is the button
Seat 1: LuckyShikari ($101.50 in chips) 
Seat 2: GuigaMan ($107.75 in chips) 
Seat 3: rrrro ($140.82 in chips) 
Seat 4: nikalas22 ($100.50 in chips) 
Seat 5: Spanky2Jacks ($75.33 in chips) 
Seat 6: chenconhaste ($100.50 in chips) 
nikalas22: posts small blind $0.50
Spanky2Jacks: posts big blind $1
*** HOLE CARDS ***
chenconhaste: folds 
LuckyShikari: raises $1.50 to $2.50
GuigaMan: folds 
rrrro: raises $5 to $7.50
nikalas22: folds 
Spanky2Jacks: folds 
LuckyShikari: raises $5 to $12.50
rrrro: folds 
Uncalled bet ($5) returned to LuckyShikari
LuckyShikari collected $16.50 from pot
LuckyShikari: doesn't show hand 
*** SUMMARY ***
Total pot $16.50 | Rake $0 
Seat 1: LuckyShikari collected ($16.50)
Seat 2: GuigaMan folded before Flop (didn't bet)
Seat 3: rrrro (button) folded before Flop
Seat 4: nikalas22 (small blind) folded before Flop
Seat 5: Spanky2Jacks (big blind) folded before Flop
Seat 6: chenconhaste folded before Flop (didn't bet)



PokerStars Hand #254288680646:  Hold'em No Limit ($0.50/$1.00 USD) - 2025/01/09 1:03:06 WET [2025/01/09 20:03:06 ET]
Table 'Altais II' 6-max Seat #4 is the button
Seat 1: LuckyShikari ($140.94 in chips) 
Seat 2: GuigaMan ($104.75 in chips) 
Seat 3: rrrro ($104.68 in chips) 
Seat 4: nikalas22 ($127 in chips) 
Seat 5: Spanky2Jacks ($74.33 in chips) 
Seat 6: Gaita_toien ($100 in chips) 
Spanky2Jacks: posts small blind $0.50
Gaita_toien: posts big blind $1
*** HOLE CARDS ***
LuckyShikari: raises $1 to $2
GuigaMan: raises $4 to $6
rrrro: folds 
nikalas22: folds 
Spanky2Jacks: folds 
Gaita_toien: folds 
LuckyShikari: folds 
Uncalled bet ($4) returned to GuigaMan
GuigaMan collected $5.50 from pot
GuigaMan: doesn't show hand 
*** SUMMARY ***
Total pot $5.50 | Rake $0 
Seat 1: LuckyShikari folded before Flop
Seat 2: GuigaMan collected ($5.50)
Seat 3: rrrro folded before Flop (didn't bet)
Seat 4: nikalas22 (button) folded before Flop (didn't bet)
Seat 5: Spanky2Jacks (small blind) folded before Flop
Seat 6: Gaita_toien (big blind) folded before Flop



PokerStars Hand #254288686749:  Hold'em No Limit ($0.50/$1.00 USD) - 2025/01/09 1:03:38 WET [2025/01/09 20:03:38 ET]
Table 'Altais II' 6-max Seat #5 is the button
Seat 1: LuckyShikari ($138.94 in chips) 
Seat 2: GuigaMan ($108.25 in chips) 
Seat 3: rrrro ($104.68 in chips) 
Seat 4: nikalas22 ($127 in chips) 
Seat 5: Spanky2Jacks ($73.83 in chips) 
Seat 6: Gaita_toien ($100 in chips) 
Gaita_toien: posts small blind $0.50
LuckyShikari: posts big blind $1
*** HOLE CARDS ***
GuigaMan: folds 
rrrro: folds 
nikalas22: folds 
Spanky2Jacks: folds 
Gaita_toien: folds 
Uncalled bet ($0.50) returned to LuckyShikari
LuckyShikari collected $1 from pot
LuckyShikari: doesn't show hand 
*** SUMMARY ***
Total pot $1 | Rake $0 
Seat 1: LuckyShikari (big blind) collected ($1)
Seat 2: GuigaMan folded before Flop (didn't bet)
Seat 3: rrrro folded before Flop (didn't bet)
Seat 4: nikalas22 folded before Flop (didn't bet)
Seat 5: Spanky2Jacks (button) folded before Flop (didn't bet)
Seat 6: Gaita_toien (small blind) folded before Flop



PokerStars Hand #254288690227:  Hold'em No Limit ($0.50/$1.00 USD) - 2025/01/09 1:03:56 WET [2025/01/09 20:03:56 ET]
Table 'Altais II' 6-max Seat #6 is the button
Seat 1: LuckyShikari ($139.44 in chips) 
Seat 2: GuigaMan ($108.25 in chips) 
Seat 3: rrrro ($104.68 in chips) 
Seat 4: nikalas22 ($127 in chips) 
Seat 5: Spanky2Jacks ($73.83 in chips) 
Seat 6: Gaita_toien ($100 in chips) 
LuckyShikari: posts small blind $0.50
GuigaMan: posts big blind $1
*** HOLE CARDS ***
rrrro: raises $1 to $2
nikalas22: folds 
Spanky2Jacks: folds 
Gaita_toien: folds 
LuckyShikari: folds 
GuigaMan: folds 
Uncalled bet ($1) returned to rrrro
rrrro collected $2.50 from pot
rrrro: doesn't show hand 
*** SUMMARY ***
Total pot $2.50 | Rake $0 
Seat 1: LuckyShikari (small blind) folded before Flop
Seat 2: GuigaMan (big blind) folded before Flop
Seat 3: rrrro collected ($2.50)
Seat 4: nikalas22 folded before Flop (didn't bet)
Seat 5: Spanky2Jacks folded before Flop (didn't bet)
Seat 6: Gaita_toien (button) folded before Flop (didn't bet)



PokerStars Hand #254288696036:  Hold'em No Limit ($0.50/$1.00 USD) - 2025/01/09 1:04:26 WET [2025/01/09 20:04:26 ET]
Table 'Altais II' 6-max Seat #1 is the button
Seat 1: LuckyShikari ($138.94 in chips) 
Seat 2: GuigaMan ($107.25 in chips) 
Seat 3: rrrro ($106.18 in chips) 
Seat 4: nikalas22 ($127 in chips) 
Seat 5: Spanky2Jacks ($73.83 in chips) 
Seat 6: Gaita_toien ($100 in chips) 
GuigaMan: posts small blind $0.50
rrrro: posts big blind $1
*** HOLE CARDS ***
nikalas22: folds 
Spanky2Jacks: folds 
Gaita_toien: folds 
LuckyShikari: folds 
GuigaMan: folds 
Uncalled bet ($0.50) returned to rrrro
rrrro collected $1 from pot
rrrro: doesn't show hand 
*** SUMMARY ***
Total pot $1 | Rake $0 
Seat 1: LuckyShikari (button) folded before Flop (didn't bet)
Seat 2: GuigaMan (small blind) folded before Flop
Seat 3: rrrro (big blind) collected ($1)
Seat 4: nikalas22 folded before Flop (didn't bet)
Seat 5: Spanky2Jacks folded before Flop (didn't bet)
Seat 6: Gaita_toien folded before Flop (didn't bet)



PokerStars Hand #254288699357:  Hold'em No Limit ($0.50/$1.00 USD) - 2025/01/09 1:04:44 WET [2025/01/09 20:04:44 ET]
Table 'Altais II' 6-max Seat #2 is the button
Seat 4: nikalas22 ($127 in chips) is sitting out
Seat 1: LuckyShikari ($138.94 in chips) 
Seat 2: GuigaMan ($106.75 in chips) 
Seat 3: rrrro ($106.68 in chips) 
Seat 5: Spanky2Jacks ($73.83 in chips) 
Seat 6: Gaita_toien ($100 in chips) 
rrrro: posts small blind $0.50
nikalas22: is sitting out 
Spanky2Jacks: posts big blind $1
*** HOLE CARDS ***
Gaita_toien: folds 
LuckyShikari: folds 
GuigaMan: raises $1.10 to $2.10
rrrro: folds 
nikalas22 leaves the table
Spanky2Jacks: calls $1.10
*** FLOP *** [7h 7d 4d]
BumHuntKing joins the table at seat #4 
Spanky2Jacks: bets $2
GuigaMan: folds 
Uncalled bet ($2) returned to Spanky2Jacks
Spanky2Jacks collected $4.46 from pot
*** SUMMARY ***
Total pot $4.70 | Rake $0.24 
Board [7h 7d 4d]
Seat 4: nikalas22
Seat 1: LuckyShikari folded before Flop (didn't bet)
Seat 2: GuigaMan (button) folded on the Flop
Seat 3: rrrro (small blind) folded before Flop
Seat 5: Spanky2Jacks (big blind) collected ($4.46)
Seat 6: Gaita_toien folded before Flop (didn't bet)



PokerStars Hand #254288710016:  Hold'em No Limit ($0.50/$1.00 USD) - 2025/01/09 1:05:39 WET [2025/01/09 20:05:39 ET]
Table 'Altais II' 6-max Seat #3 is the button
Seat 4: BumHuntKing ($100 in chips) is sitting out
Seat 1: LuckyShikari ($138.94 in chips) 
Seat 2: GuigaMan ($104.65 in chips) 
Seat 3: rrrro ($106.18 in chips) 
Seat 5: Spanky2Jacks ($76.19 in chips) 
Seat 6: Gaita_toien ($100 in chips) 
Spanky2Jacks: posts small blind $0.50
Gaita_toien: posts big blind $1
*** HOLE CARDS ***
LuckyShikari: raises $1 to $2
GuigaMan: folds 
rrrro: folds 
Spanky2Jacks: folds 
Gaita_toien: calls $1
*** FLOP *** [Td 6s 7s]
Gaita_toien: checks 
LuckyShikari: checks 
*** TURN *** [Td 6s 7s] [9c]
Gaita_toien: checks 
LuckyShikari: checks 
*** RIVER *** [Td 6s 7s 9c] [Js]
Gaita_toien: checks 
LuckyShikari: checks 
*** SHOW DOWN ***
Gaita_toien: shows [Ac 6c] (a pair of Sixes)
LuckyShikari: shows [5h 7h] (a pair of Sevens)
LuckyShikari collected $4.28 from pot
*** SUMMARY ***
Total pot $4.50 | Rake $0.22 
Board [Td 6s 7s 9c Js]
Seat 4: BumHuntKing
Seat 1: LuckyShikari showed [5h 7h] and won ($4.28) with a pair of Sevens
Seat 2: GuigaMan folded before Flop (didn't bet)
Seat 3: rrrro (button) folded before Flop (didn't bet)
Seat 5: Spanky2Jacks (small blind) folded before Flop
Seat 6: Gaita_toien (big blind) showed [Ac 6c] and lost with a pair of Sixes



PokerStars Hand #254288721018:  Hold'em No Limit ($0.50/$1.00 USD) - 2025/01/09 1:06:37 WET [2025/01/09 20:06:37 ET]
Table 'Altais II' 6-max Seat #5 is the button
Seat 4: BumHuntKing ($100 in chips) is sitting out
Seat 1: LuckyShikari ($141.22 in chips) 
Seat 2: GuigaMan ($104.65 in chips) 
Seat 3: rrrro ($106.18 in chips) 
Seat 5: Spanky2Jacks ($75.69 in chips) 
Seat 6: Gaita_toien ($100 in chips) 
Gaita_toien: posts small blind $0.50
LuckyShikari: posts big blind $1
BumHuntKing: sits out 
*** HOLE CARDS ***
GuigaMan: folds 
rrrro: folds 
Spanky2Jacks: raises $2.50 to $3.50
Gaita_toien: raises $11.50 to $15
LuckyShikari: folds 
Spanky2Jacks: folds 
Uncalled bet ($11.50) returned to Gaita_toien
Gaita_toien collected $8 from pot
Gaita_toien: doesn't show hand 
*** SUMMARY ***
Total pot $8 | Rake $0 
Seat 4: BumHuntKing
Seat 1: LuckyShikari (big blind) folded before Flop
Seat 2: GuigaMan folded before Flop (didn't bet)
Seat 3: rrrro folded before Flop (didn't bet)
Seat 5: Spanky2Jacks (button) folded before Flop
Seat 6: Gaita_toien (small blind) collected ($8)



PokerStars Hand #254288734442:  Hold'em No Limit ($0.50/$1.00 USD) - 2025/01/09 1:07:47 WET [2025/01/09 20:07:47 ET]
Table 'Altais II' 6-max Seat #6 is the button
Seat 4: BumHuntKing ($100 in chips) is sitting out
Seat 1: LuckyShikari ($140.22 in chips) 
Seat 2: GuigaMan ($104.65 in chips) 
Seat 3: rrrro ($106.18 in chips) 
Seat 5: Spanky2Jacks ($72.19 in chips) 
Seat 6: Gaita_toien ($104.50 in chips) 
LuckyShikari: posts small blind $0.50
GuigaMan: posts big blind $1
BumHuntKing: sits out 
*** HOLE CARDS ***
rrrro: folds 
Spanky2Jacks: folds 
Gaita_toien: raises $1.50 to $2.50
LuckyShikari: raises $9.50 to $12
GuigaMan: folds 
Gaita_toien: folds 
Uncalled bet ($9.50) returned to LuckyShikari
LuckyShikari collected $6 from pot
LuckyShikari: doesn't show hand 
*** SUMMARY ***
Total pot $6 | Rake $0 
Seat 4: BumHuntKing
Seat 1: LuckyShikari (small blind) collected ($6)
Seat 2: GuigaMan (big blind) folded before Flop
Seat 3: rrrro folded before Flop (didn't bet)
Seat 5: Spanky2Jacks folded before Flop (didn't bet)
Seat 6: Gaita_toien (button) folded before Flop



PokerStars Hand #254288739734:  Hold'em No Limit ($0.50/$1.00 USD) - 2025/01/09 1:08:14 WET [2025/01/09 20:08:14 ET]
Table 'Altais II' 6-max Seat #1 is the button
Seat 4: BumHuntKing ($100 in chips) is sitting out
Seat 1: LuckyShikari ($143.72 in chips) 
Seat 2: GuigaMan ($103.65 in chips) 
Seat 3: rrrro ($106.18 in chips) 
Seat 5: Spanky2Jacks ($72.19 in chips) 
Seat 6: Gaita_toien ($102 in chips) 
GuigaMan: posts small blind $0.50
rrrro: posts big blind $1
BumHuntKing: sits out 
*** HOLE CARDS ***
Spanky2Jacks: raises $1 to $2
Gaita_toien: folds 
LuckyShikari: folds 
GuigaMan: folds 
rrrro: folds 
Uncalled bet ($1) returned to Spanky2Jacks
Spanky2Jacks collected $2.50 from pot
*** SUMMARY ***
Total pot $2.50 | Rake $0 
Seat 4: BumHuntKing
Seat 1: LuckyShikari (button) folded before Flop (didn't bet)
Seat 2: GuigaMan (small blind) folded before Flop
Seat 3: rrrro (big blind) folded before Flop
Seat 5: Spanky2Jacks collected ($2.50)
Seat 6: Gaita_toien folded before Flop (didn't bet)



PokerStars Hand #254288743996:  Hold'em No Limit ($0.50/$1.00 USD) - 2025/01/09 1:08:37 WET [2025/01/09 20:08:37 ET]
Table 'Altais II' 6-max Seat #2 is the button
Seat 1: LuckyShikari ($143.72 in chips) 
Seat 2: GuigaMan ($103.15 in chips) 
Seat 3: rrrro ($105.18 in chips) 
Seat 4: BumHuntKing ($100 in chips) 
Seat 5: Spanky2Jacks ($73.69 in chips) 
Seat 6: Gaita_toien ($102 in chips) 
rrrro: posts small blind $0.50
BumHuntKing: posts big blind $1
*** HOLE CARDS ***
Spanky2Jacks: folds 
Gaita_toien: folds 
LuckyShikari: folds 
GuigaMan: folds 
rrrro: folds 
Uncalled bet ($0.50) returned to BumHuntKing
BumHuntKing collected $1 from pot
BumHuntKing: doesn't show hand 
*** SUMMARY ***
Total pot $1 | Rake $0 
Seat 1: LuckyShikari folded before Flop (didn't bet)
Seat 2: GuigaMan (button) folded before Flop (didn't bet)
Seat 3: rrrro (small blind) folded before Flop
Seat 4: BumHuntKing (big blind) collected ($1)
Seat 5: Spanky2Jacks folded before Flop (didn't bet)
Seat 6: Gaita_toien folded before Flop (didn't bet)



PokerStars Hand #254288749076:  Hold'em No Limit ($0.50/$1.00 USD) - 2025/01/09 1:09:03 WET [2025/01/09 20:09:03 ET]
Table 'Altais II' 6-max Seat #3 is the button
Seat 1: LuckyShikari ($143.72 in chips) 
Seat 2: GuigaMan ($103.15 in chips) 
Seat 3: rrrro ($104.68 in chips) 
Seat 4: BumHuntKing ($100.50 in chips) 
Seat 5: Spanky2Jacks ($73.69 in chips) 
Seat 6: Gaita_toien ($102 in chips) 
BumHuntKing: posts small blind $0.50
Spanky2Jacks: posts big blind $1
*** HOLE CARDS ***
Gaita_toien: folds 
LuckyShikari: folds 
GuigaMan: folds 
LuckyShikari leaves the table
rrrro: folds 
BumHuntKing: raises $2 to $3
Spanky2Jacks: calls $2
*** FLOP *** [7c 2h 3d]
BumHuntKing: checks 
Spanky2Jacks: bets $5.70
BumHuntKing: folds 
Uncalled bet ($5.70) returned to Spanky2Jacks
Spanky2Jacks collected $5.70 from pot
BeauParleur joins the table at seat #1 
*** SUMMARY ***
Total pot $6 | Rake $0.30 
Board [7c 2h 3d]
Seat 1: LuckyShikari folded before Flop (didn't bet)
Seat 2: GuigaMan folded before Flop (didn't bet)
Seat 3: rrrro (button) folded before Flop (didn't bet)
Seat 4: BumHuntKing (small blind) folded on the Flop
Seat 5: Spanky2Jacks (big blind) collected ($5.70)
Seat 6: Gaita_toien folded before Flop (didn't bet)



PokerStars Hand #254288760901:  Hold'em No Limit ($0.50/$1.00 USD) - 2025/01/09 1:10:06 WET [2025/01/09 20:10:06 ET]
Table 'Altais II' 6-max Seat #4 is the button
Seat 1: BeauParleur ($100 in chips) is sitting out
Seat 2: GuigaMan ($103.15 in chips) 
Seat 3: rrrro ($104.68 in chips) 
Seat 4: BumHuntKing ($100 in chips) 
Seat 5: Spanky2Jacks ($76.39 in chips) 
Seat 6: Gaita_toien ($102 in chips) 
Spanky2Jacks: posts small blind $0.50
Gaita_toien: posts big blind $1
BeauParleur: sits out 
*** HOLE CARDS ***
GuigaMan: folds 
rrrro: raises $1.30 to $2.30
BumHuntKing: folds 
Spanky2Jacks: calls $1.80
Gaita_toien: raises $10.70 to $13
rrrro: folds 
Spanky2Jacks: folds 
Uncalled bet ($10.70) returned to Gaita_toien
Gaita_toien collected $6.90 from pot
Gaita_toien: doesn't show hand 
*** SUMMARY ***
Total pot $6.90 | Rake $0 
Seat 1: BeauParleur
Seat 2: GuigaMan folded before Flop (didn't bet)
Seat 3: rrrro folded before Flop
Seat 4: BumHuntKing (button) folded before Flop (didn't bet)
Seat 5: Spanky2Jacks (small blind) folded before Flop
Seat 6: Gaita_toien (big blind) collected ($6.90)



PokerStars Hand #254288768314:  Hold'em No Limit ($0.50/$1.00 USD) - 2025/01/09 1:10:45 WET [2025/01/09 20:10:45 ET]
Table 'Altais II' 6-max Seat #5 is the button
Seat 1: BeauParleur ($100 in chips) 
Seat 2: GuigaMan ($103.15 in chips) 
Seat 3: rrrro ($102.38 in chips) 
Seat 4: BumHuntKing ($100 in chips) 
Seat 5: Spanky2Jacks ($74.09 in chips) 
Seat 6: Gaita_toien ($106.60 in chips) 
Gaita_toien: posts small blind $0.50
BeauParleur: posts big blind $1
*** HOLE CARDS ***
GuigaMan: folds 
rrrro: folds 
BumHuntKing: folds 
Spanky2Jacks: folds 
Gaita_toien: folds 
Uncalled bet ($0.50) returned to BeauParleur
BeauParleur collected $1 from pot
BeauParleur: doesn't show hand 
*** SUMMARY ***
Total pot $1 | Rake $0 
Seat 1: BeauParleur (big blind) collected ($1)
Seat 2: GuigaMan folded before Flop (didn't bet)
Seat 3: rrrro folded before Flop (didn't bet)
Seat 4: BumHuntKing folded before Flop (didn't bet)
Seat 5: Spanky2Jacks (button) folded before Flop (didn't bet)
Seat 6: Gaita_toien (small blind) folded before Flop



PokerStars Hand #254288772385:  Hold'em No Limit ($0.50/$1.00 USD) - 2025/01/09 1:11:07 WET [2025/01/09 20:11:07 ET]
Table 'Altais II' 6-max Seat #6 is the button
Seat 1: BeauParleur ($100.50 in chips) 
Seat 2: GuigaMan ($103.15 in chips) 
Seat 3: rrrro ($102.38 in chips) 
Seat 4: BumHuntKing ($100 in chips) 
Seat 5: Spanky2Jacks ($74.09 in chips) 
Seat 6: Gaita_toien ($106.10 in chips) 
BeauParleur: posts small blind $0.50
GuigaMan: posts big blind $1
*** HOLE CARDS ***
rrrro: folds 
BumHuntKing: raises $1.20 to $2.20
Spanky2Jacks: folds 
Gaita_toien: folds 
BeauParleur: folds 
GuigaMan: folds 
Uncalled bet ($1.20) returned to BumHuntKing
BumHuntKing collected $2.50 from pot
BumHuntKing: doesn't show hand 
*** SUMMARY ***
Total pot $2.50 | Rake $0 
Seat 1: BeauParleur (small blind) folded before Flop
Seat 2: GuigaMan (big blind) folded before Flop
Seat 3: rrrro folded before Flop (didn't bet)
Seat 4: BumHuntKing collected ($2.50)
Seat 5: Spanky2Jacks folded before Flop (didn't bet)
Seat 6: Gaita_toien (button) folded before Flop (didn't bet)



PokerStars Hand #254288776309:  Hold'em No Limit ($0.50/$1.00 USD) - 2025/01/09 1:11:28 WET [2025/01/09 20:11:28 ET]
Table 'Altais II' 6-max Seat #1 is the button
Seat 1: BeauParleur ($100 in chips) 
Seat 2: GuigaMan ($102.15 in chips) 
Seat 3: rrrro ($102.38 in chips) 
Seat 4: BumHuntKing ($101.50 in chips) 
Seat 5: Spanky2Jacks ($74.09 in chips) 
Seat 6: Gaita_toien ($106.10 in chips) 
GuigaMan: posts small blind $0.50
rrrro: posts big blind $1
*** HOLE CARDS ***
BumHuntKing: folds 
Spanky2Jacks: folds 
Gaita_toien: folds 
BeauParleur: raises $1.50 to $2.50
GuigaMan: folds 
rrrro: folds 
Uncalled bet ($1.50) returned to BeauParleur
BeauParleur collected $2.50 from pot
BeauParleur: doesn't show hand 
*** SUMMARY ***
Total pot $2.50 | Rake $0 
Seat 1: BeauParleur (button) collected ($2.50)
Seat 2: GuigaMan (small blind) folded before Flop
Seat 3: rrrro (big blind) folded before Flop
Seat 4: BumHuntKing folded before Flop (didn't bet)
Seat 5: Spanky2Jacks folded before Flop (didn't bet)
Seat 6: Gaita_toien folded before Flop (didn't bet)



PokerStars Hand #254288780053:  Hold'em No Limit ($0.50/$1.00 USD) - 2025/01/09 1:11:48 WET [2025/01/09 20:11:48 ET]
Table 'Altais II' 6-max Seat #2 is the button
Seat 1: BeauParleur ($101.50 in chips) 
Seat 2: GuigaMan ($101.65 in chips) 
Seat 3: rrrro ($101.38 in chips) 
Seat 4: BumHuntKing ($101.50 in chips) 
Seat 5: Spanky2Jacks ($74.09 in chips) 
Seat 6: Gaita_toien ($106.10 in chips) 
rrrro: posts small blind $0.50
BumHuntKing: posts big blind $1
*** HOLE CARDS ***
Spanky2Jacks: folds 
Gaita_toien: folds 
BeauParleur: raises $1.25 to $2.25
GuigaMan: folds 
rrrro: folds 
BumHuntKing: calls $1.25
*** FLOP *** [6s 7c Qs]
BumHuntKing: checks 
BeauParleur: bets $1.57
BumHuntKing: calls $1.57
*** TURN *** [6s 7c Qs] [As]
BumHuntKing: checks 
BeauParleur: bets $5.80
BumHuntKing: folds 
Uncalled bet ($5.80) returned to BeauParleur
BeauParleur collected $7.73 from pot
BeauParleur: doesn't show hand 
*** SUMMARY ***
Total pot $8.14 | Rake $0.41 
Board [6s 7c Qs As]
Seat 1: BeauParleur collected ($7.73)
Seat 2: GuigaMan (button) folded before Flop (didn't bet)
Seat 3: rrrro (small blind) folded before Flop
Seat 4: BumHuntKing (big blind) folded on the Turn
Seat 5: Spanky2Jacks folded before Flop (didn't bet)
Seat 6: Gaita_toien folded before Flop (didn't bet)



PokerStars Hand #254288789798:  Hold'em No Limit ($0.50/$1.00 USD) - 2025/01/09 1:12:40 WET [2025/01/09 20:12:40 ET]
Table 'Altais II' 6-max Seat #3 is the button
Seat 1: BeauParleur ($105.41 in chips) 
Seat 2: GuigaMan ($101.65 in chips) 
Seat 3: rrrro ($100.88 in chips) 
Seat 4: BumHuntKing ($100 in chips) 
Seat 5: Spanky2Jacks ($74.09 in chips) 
Seat 6: Gaita_toien ($106.10 in chips) 
BumHuntKing: posts small blind $0.50
Spanky2Jacks: posts big blind $1
*** HOLE CARDS ***
Gaita_toien: folds 
BeauParleur: folds 
GuigaMan: raises $1.10 to $2.10
rrrro: folds 
BumHuntKing: folds 
Spanky2Jacks: calls $1.10
*** FLOP *** [5c 3h 9c]
Spanky2Jacks: checks 
GuigaMan: checks 
*** TURN *** [5c 3h 9c] [4c]
Spanky2Jacks: bets $3
GuigaMan: calls $3
*** RIVER *** [5c 3h 9c 4c] [4d]
Spanky2Jacks: bets $10.16
GuigaMan: folds 
Uncalled bet ($10.16) returned to Spanky2Jacks
Spanky2Jacks collected $10.16 from pot
*** SUMMARY ***
Total pot $10.70 | Rake $0.54 
Board [5c 3h 9c 4c 4d]
Seat 1: BeauParleur folded before Flop (didn't bet)
Seat 2: GuigaMan folded on the River
Seat 3: rrrro (button) folded before Flop (didn't bet)
Seat 4: BumHuntKing (small blind) folded before Flop
Seat 5: Spanky2Jacks (big blind) collected ($10.16)
Seat 6: Gaita_toien folded before Flop (didn't bet)



PokerStars Hand #254288805111:  Hold'em No Limit ($0.50/$1.00 USD) - 2025/01/09 1:14:02 WET [2025/01/09 20:14:02 ET]
Table 'Altais II' 6-max Seat #4 is the button
Seat 1: BeauParleur ($105.41 in chips) 
Seat 2: GuigaMan ($100 in chips) 
Seat 3: rrrro ($100.88 in chips) 
Seat 4: BumHuntKing ($100 in chips) 
Seat 5: Spanky2Jacks ($79.15 in chips) 
Seat 6: Gaita_toien ($106.10 in chips) 
Spanky2Jacks: posts small blind $0.50
Gaita_toien: posts big blind $1
*** HOLE CARDS ***
BeauParleur: folds 
GuigaMan: raises $1.10 to $2.10
rrrro: folds 
BumHuntKing: folds 
Spanky2Jacks: folds 
Gaita_toien: folds 
Uncalled bet ($1.10) returned to GuigaMan
GuigaMan collected $2.50 from pot
GuigaMan: doesn't show hand 
*** SUMMARY ***
Total pot $2.50 | Rake $0 
Seat 1: BeauParleur folded before Flop (didn't bet)
Seat 2: GuigaMan collected ($2.50)
Seat 3: rrrro folded before Flop (didn't bet)
Seat 4: BumHuntKing (button) folded before Flop (didn't bet)
Seat 5: Spanky2Jacks (small blind) folded before Flop
Seat 6: Gaita_toien (big blind) folded before Flop



PokerStars Hand #254288809365:  Hold'em No Limit ($0.50/$1.00 USD) - 2025/01/09 1:14:24 WET [2025/01/09 20:14:24 ET]
Table 'Altais II' 6-max Seat #5 is the button
Seat 1: BeauParleur ($105.41 in chips) 
Seat 2: GuigaMan ($101.50 in chips) 
Seat 3: rrrro ($100.88 in chips) 
Seat 4: BumHuntKing ($100 in chips) 
Seat 5: Spanky2Jacks ($78.65 in chips) 
Seat 6: Gaita_toien ($105.10 in chips) 
Gaita_toien: posts small blind $0.50
BeauParleur: posts big blind $1
*** HOLE CARDS ***
GuigaMan: folds 
rrrro: folds 
BumHuntKing: folds 
Spanky2Jacks: folds 
Gaita_toien: raises $2 to $3
BeauParleur: calls $2
*** FLOP *** [7s 5h 9d]
Gaita_toien: checks 
BeauParleur: bets $4.28
Gaita_toien: folds 
Uncalled bet ($4.28) returned to BeauParleur
BeauParleur collected $5.70 from pot
BeauParleur: doesn't show hand 
*** SUMMARY ***
Total pot $6 | Rake $0.30 
Board [7s 5h 9d]
Seat 1: BeauParleur (big blind) collected ($5.70)
Seat 2: GuigaMan folded before Flop (didn't bet)
Seat 3: rrrro folded before Flop (didn't bet)
Seat 4: BumHuntKing folded before Flop (didn't bet)
Seat 5: Spanky2Jacks (button) folded before Flop (didn't bet)
Seat 6: Gaita_toien (small blind) folded on the Flop



PokerStars Hand #254289318419:  Hold'em No Limit ($0.50/$1.00 USD) - 2025/01/09 1:15:12 WET [2025/01/09 20:15:12 ET]
Table 'Altais II' 6-max Seat #6 is the button
Seat 1: BeauParleur ($108.11 in chips) 
Seat 2: GuigaMan ($101.50 in chips) 
Seat 3: rrrro ($100.88 in chips) 
Seat 4: BumHuntKing ($100 in chips) 
Seat 5: Spanky2Jacks ($78.65 in chips) 
Seat 6: Gaita_toien ($102.10 in chips) 
BeauParleur: posts small blind $0.50
GuigaMan: posts big blind $1
*** HOLE CARDS ***
rrrro: folds 
BumHuntKing: folds 
Spanky2Jacks: raises $2.50 to $3.50
Gaita_toien: folds 
BeauParleur: folds 
GuigaMan: folds 
Uncalled bet ($2.50) returned to Spanky2Jacks
Spanky2Jacks collected $2.50 from pot
*** SUMMARY ***
Total pot $2.50 | Rake $0 
Seat 1: BeauParleur (small blind) folded before Flop
Seat 2: GuigaMan (big blind) folded before Flop
Seat 3: rrrro folded before Flop (didn't bet)
Seat 4: BumHuntKing folded before Flop (didn't bet)
Seat 5: Spanky2Jacks collected ($2.50)
Seat 6: Gaita_toien (button) folded before Flop (didn't bet)



PokerStars Hand #254289322669:  Hold'em No Limit ($0.50/$1.00 USD) - 2025/01/09 1:15:35 WET [2025/01/09 20:15:35 ET]
Table 'Altais II' 6-max Seat #1 is the button
Seat 1: BeauParleur ($107.61 in chips) 
Seat 2: GuigaMan ($100.50 in chips) 
Seat 3: rrrro ($100.88 in chips) 
Seat 4: BumHuntKing ($100 in chips) 
Seat 5: Spanky2Jacks ($80.15 in chips) 
Seat 6: Gaita_toien ($102.10 in chips) 
GuigaMan: posts small blind $0.50
rrrro: posts big blind $1
*** HOLE CARDS ***
BumHuntKing: folds 
Spanky2Jacks: folds 
Gaita_toien: folds 
BeauParleur: raises $1.50 to $2.50
GuigaMan: raises $8.50 to $11
rrrro: folds 
BeauParleur: calls $8.50
*** FLOP *** [9c Kd 4d]
GuigaMan: bets $6.56
BeauParleur: calls $6.56
*** TURN *** [9c Kd 4d] [6d]
GuigaMan: bets $10.29
BeauParleur: calls $10.29
*** RIVER *** [9c Kd 4d 6d] [7h]
GuigaMan: checks 
BeauParleur: bets $40.65
GuigaMan: folds 
Uncalled bet ($40.65) returned to BeauParleur
BeauParleur collected $54.20 from pot
BeauParleur: doesn't show hand 
*** SUMMARY ***
Total pot $56.70 | Rake $2.50 
Board [9c Kd 4d 6d 7h]
Seat 1: BeauParleur (button) collected ($54.20)
Seat 2: GuigaMan (small blind) folded on the River
Seat 3: rrrro (big blind) folded before Flop
Seat 4: BumHuntKing folded before Flop (didn't bet)
Seat 5: Spanky2Jacks folded before Flop (didn't bet)
Seat 6: Gaita_toien folded before Flop (didn't bet)



PokerStars Hand #254289337887:  Hold'em No Limit ($0.50/$1.00 USD) - 2025/01/09 1:16:57 WET [2025/01/09 20:16:57 ET]
Table 'Altais II' 6-max Seat #2 is the button
Seat 1: BeauParleur ($133.96 in chips) 
Seat 2: GuigaMan ($100 in chips) 
Seat 3: rrrro ($100 in chips) 
Seat 4: BumHuntKing ($100 in chips) 
Seat 5: Spanky2Jacks ($80.15 in chips) 
Seat 6: Gaita_toien ($102.10 in chips) 
rrrro: posts small blind $0.50
BumHuntKing: posts big blind $1
*** HOLE CARDS ***
Spanky2Jacks: raises $1 to $2
Gaita_toien: folds 
BeauParleur: folds 
GuigaMan: folds 
rrrro: folds 
BumHuntKing: raises $10 to $12
Spanky2Jacks: folds 
Uncalled bet ($10) returned to BumHuntKing
BumHuntKing collected $4.50 from pot
BumHuntKing: doesn't show hand 
*** SUMMARY ***
Total pot $4.50 | Rake $0 
Seat 1: BeauParleur folded before Flop (didn't bet)
Seat 2: GuigaMan (button) folded before Flop (didn't bet)
Seat 3: rrrro (small blind) folded before Flop
Seat 4: BumHuntKing (big blind) collected ($4.50)
Seat 5: Spanky2Jacks folded before Flop
Seat 6: Gaita_toien folded before Flop (didn't bet)



PokerStars Hand #254289345786:  Hold'em No Limit ($0.50/$1.00 USD) - 2025/01/09 1:17:40 WET [2025/01/09 20:17:40 ET]
Table 'Altais II' 6-max Seat #3 is the button
Seat 1: BeauParleur ($133.96 in chips) 
Seat 2: GuigaMan ($100 in chips) 
Seat 3: rrrro ($100 in chips) 
Seat 4: BumHuntKing ($102.50 in chips) 
Seat 5: Spanky2Jacks ($78.15 in chips) 
Seat 6: Gaita_toien ($102.10 in chips) 
BumHuntKing: posts small blind $0.50
Spanky2Jacks: posts big blind $1
*** HOLE CARDS ***
Gaita_toien: folds 
BeauParleur: folds 
GuigaMan: folds 
rrrro: raises $1.50 to $2.50
BumHuntKing: raises $9 to $11.50
Spanky2Jacks: folds 
rrrro: calls $9
*** FLOP *** [9c 8h Qd]
BumHuntKing: bets $7.52
rrrro: calls $7.52
*** TURN *** [9c 8h Qd] [2d]
BumHuntKing: checks 
rrrro: checks 
*** RIVER *** [9c 8h Qd 2d] [Kd]
BumHuntKing: bets $55.64
rrrro: folds 
Uncalled bet ($55.64) returned to BumHuntKing
BumHuntKing collected $37.09 from pot
BumHuntKing: doesn't show hand 
*** SUMMARY ***
Total pot $39.04 | Rake $1.95 
Board [9c 8h Qd 2d Kd]
Seat 1: BeauParleur folded before Flop (didn't bet)
Seat 2: GuigaMan folded before Flop (didn't bet)
Seat 3: rrrro (button) folded on the River
Seat 4: BumHuntKing (small blind) collected ($37.09)
Seat 5: Spanky2Jacks (big blind) folded before Flop
Seat 6: Gaita_toien folded before Flop (didn't bet)



PokerStars Hand #254289370036:  Hold'em No Limit ($0.50/$1.00 USD) - 2025/01/09 1:19:52 WET [2025/01/09 20:19:52 ET]
Table 'Altais II' 6-max Seat #4 is the button
Seat 1: BeauParleur ($133.96 in chips) 
Seat 2: GuigaMan ($100 in chips) 
Seat 3: rrrro ($100 in chips) 
Seat 4: BumHuntKing ($120.57 in chips) 
Seat 5: Spanky2Jacks ($77.15 in chips) 
Seat 6: Gaita_toien ($102.10 in chips) 
Spanky2Jacks: posts small blind $0.50
Gaita_toien: posts big blind $1
*** HOLE CARDS ***
BeauParleur: raises $1 to $2
GuigaMan: folds 
rrrro: folds 
BumHuntKing: folds 
Spanky2Jacks: folds 
Gaita_toien: folds 
Uncalled bet ($1) returned to BeauParleur
BeauParleur collected $2.50 from pot
BeauParleur: doesn't show hand 
*** SUMMARY ***
Total pot $2.50 | Rake $0 
Seat 1: BeauParleur collected ($2.50)
Seat 2: GuigaMan folded before Flop (didn't bet)
Seat 3: rrrro folded before Flop (didn't bet)
Seat 4: BumHuntKing (button) folded before Flop (didn't bet)
Seat 5: Spanky2Jacks (small blind) folded before Flop
Seat 6: Gaita_toien (big blind) folded before Flop



PokerStars Hand #254289374917:  Hold'em No Limit ($0.50/$1.00 USD) - 2025/01/09 1:20:19 WET [2025/01/09 20:20:19 ET]
Table 'Altais II' 6-max Seat #5 is the button
Seat 1: BeauParleur ($135.46 in chips) 
Seat 2: GuigaMan ($100 in chips) 
Seat 3: rrrro ($100 in chips) 
Seat 4: BumHuntKing ($120.57 in chips) 
Seat 5: Spanky2Jacks ($76.65 in chips) 
Seat 6: Gaita_toien ($101.10 in chips) 
Gaita_toien: posts small blind $0.50
BeauParleur: posts big blind $1
*** HOLE CARDS ***
GuigaMan: raises $1.10 to $2.10
rrrro: folds 
BumHuntKing: folds 
Spanky2Jacks: folds 
Gaita_toien: folds 
BeauParleur: folds 
Uncalled bet ($1.10) returned to GuigaMan
GuigaMan collected $2.50 from pot
GuigaMan: doesn't show hand 
*** SUMMARY ***
Total pot $2.50 | Rake $0 
Seat 1: BeauParleur (big blind) folded before Flop
Seat 2: GuigaMan collected ($2.50)
Seat 3: rrrro folded before Flop (didn't bet)
Seat 4: BumHuntKing folded before Flop (didn't bet)
Seat 5: Spanky2Jacks (button) folded before Flop (didn't bet)
Seat 6: Gaita_toien (small blind) folded before Flop



PokerStars Hand #254289380154:  Hold'em No Limit ($0.50/$1.00 USD) - 2025/01/09 1:20:47 WET [2025/01/09 20:20:47 ET]
Table 'Altais II' 6-max Seat #6 is the button
Seat 1: BeauParleur ($134.46 in chips) 
Seat 2: GuigaMan ($101.50 in chips) 
Seat 3: rrrro ($100 in chips) 
Seat 4: BumHuntKing ($120.57 in chips) 
Seat 5: Spanky2Jacks ($76.65 in chips) 
Seat 6: Gaita_toien ($100.60 in chips) 
BeauParleur: posts small blind $0.50
GuigaMan: posts big blind $1
*** HOLE CARDS ***
rrrro: folds 
BumHuntKing: raises $1.20 to $2.20
Spanky2Jacks: folds 
Gaita_toien: folds 
BeauParleur: folds 
GuigaMan: calls $1.20
*** FLOP *** [3c 3h 4h]
GuigaMan: checks 
BumHuntKing: bets $1.54
GuigaMan: folds 
Uncalled bet ($1.54) returned to BumHuntKing
BumHuntKing collected $4.66 from pot
BumHuntKing: doesn't show hand 
*** SUMMARY ***
Total pot $4.90 | Rake $0.24 
Board [3c 3h 4h]
Seat 1: BeauParleur (small blind) folded before Flop
Seat 2: GuigaMan (big blind) folded on the Flop
Seat 3: rrrro folded before Flop (didn't bet)
Seat 4: BumHuntKing collected ($4.66)
Seat 5: Spanky2Jacks folded before Flop (didn't bet)
Seat 6: Gaita_toien (button) folded before Flop (didn't bet)



PokerStars Hand #254289387542:  Hold'em No Limit ($0.50/$1.00 USD) - 2025/01/09 1:21:27 WET [2025/01/09 20:21:27 ET]
Table 'Altais II' 6-max Seat #1 is the button
Seat 1: BeauParleur ($133.96 in chips) 
Seat 2: GuigaMan ($100 in chips) 
Seat 3: rrrro ($100 in chips) 
Seat 4: BumHuntKing ($123.03 in chips) 
Seat 5: Spanky2Jacks ($76.65 in chips) 
Seat 6: Gaita_toien ($100.60 in chips) 
GuigaMan: posts small blind $0.50
rrrro: posts big blind $1
*** HOLE CARDS ***
BumHuntKing: folds 
Spanky2Jacks: folds 
Gaita_toien: folds 
BeauParleur: raises $1.50 to $2.50
GuigaMan: folds 
rrrro: folds 
Uncalled bet ($1.50) returned to BeauParleur
BeauParleur collected $2.50 from pot
BeauParleur: doesn't show hand 
*** SUMMARY ***
Total pot $2.50 | Rake $0 
Seat 1: BeauParleur (button) collected ($2.50)
Seat 2: GuigaMan (small blind) folded before Flop
Seat 3: rrrro (big blind) folded before Flop
Seat 4: BumHuntKing folded before Flop (didn't bet)
Seat 5: Spanky2Jacks folded before Flop (didn't bet)
Seat 6: Gaita_toien folded before Flop (didn't bet)



PokerStars Hand #254289395302:  Hold'em No Limit ($0.50/$1.00 USD) - 2025/01/09 1:22:10 WET [2025/01/09 20:22:10 ET]
Table 'Altais II' 6-max Seat #2 is the button
Seat 1: BeauParleur ($135.46 in chips) 
Seat 2: GuigaMan ($100 in chips) 
Seat 3: rrrro ($100 in chips) 
Seat 4: BumHuntKing ($123.03 in chips) 
Seat 5: Spanky2Jacks ($76.65 in chips) 
Seat 6: Gaita_toien ($100.60 in chips) 
rrrro: posts small blind $0.50
BumHuntKing: posts big blind $1
*** HOLE CARDS ***
Spanky2Jacks: calls $1
Gaita_toien: folds 
BeauParleur: raises $3 to $4
GuigaMan: folds 
rrrro: folds 
BumHuntKing: folds 
Spanky2Jacks: calls $3
*** FLOP *** [Tc 8h 7h]
Spanky2Jacks: bets $4
BeauParleur: raises $8.51 to $12.51
Spanky2Jacks: calls $8.51
*** TURN *** [Tc 8h 7h] [2s]
Spanky2Jacks: bets $6
BeauParleur: raises $22.40 to $28.40
Spanky2Jacks: calls $22.40
*** RIVER *** [Tc 8h 7h 2s] [5s]
Spanky2Jacks: bets $10
BeauParleur: raises $80.55 to $90.55 and is all-in
Spanky2Jacks: calls $21.74 and is all-in
Uncalled bet ($58.81) returned to BeauParleur
*** SHOW DOWN ***
BeauParleur: shows [Ks Kh] (a pair of Kings)
Spanky2Jacks: shows [9d 9c] (a pair of Nines)
BeauParleur collected $152.30 from pot
*** SUMMARY ***
Total pot $154.80 | Rake $2.50 
Board [Tc 8h 7h 2s 5s]
Seat 1: BeauParleur showed [Ks Kh] and won ($152.30) with a pair of Kings
Seat 2: GuigaMan (button) folded before Flop (didn't bet)
Seat 3: rrrro (small blind) folded before Flop
Seat 4: BumHuntKing (big blind) folded before Flop
Seat 5: Spanky2Jacks showed [9d 9c] and lost with a pair of Nines
Seat 6: Gaita_toien folded before Flop (didn't bet)



PokerStars Hand #254289432939:  Hold'em No Limit ($0.50/$1.00 USD) - 2025/01/09 1:25:34 WET [2025/01/09 20:25:34 ET]
Table 'Altais II' 6-max Seat #3 is the button
Seat 5: Spanky2Jacks ($0 in chips) is sitting out
Seat 1: BeauParleur ($211.11 in chips) 
Seat 2: GuigaMan ($100 in chips) 
Seat 3: rrrro ($100 in chips) 
Seat 4: BumHuntKing ($122.03 in chips) 
Seat 6: Gaita_toien ($100.60 in chips) 
BumHuntKing: posts small blind $0.50
Gaita_toien: posts big blind $1
*** HOLE CARDS ***
BeauParleur: folds 
GuigaMan: raises $1.10 to $2.10
rrrro: raises $4.40 to $6.50
BumHuntKing: folds 
Gaita_toien: folds 
GuigaMan: calls $4.40
*** FLOP *** [9c 7h 3d]
GuigaMan: checks 
rrrro: bets $6.89
GuigaMan: calls $6.89
*** TURN *** [9c 7h 3d] [8h]
GuigaMan: bets $9
Spanky2Jacks is disconnected 
rrrro: folds 
Uncalled bet ($9) returned to GuigaMan
GuigaMan collected $26.87 from pot
GuigaMan: doesn't show hand 
*** SUMMARY ***
Total pot $28.28 | Rake $1.41 
Board [9c 7h 3d 8h]
Seat 5: Spanky2Jacks
Seat 1: BeauParleur folded before Flop (didn't bet)
Seat 2: GuigaMan collected ($26.87)
Seat 3: rrrro (button) folded on the Turn
Seat 4: BumHuntKing (small blind) folded before Flop
Seat 6: Gaita_toien (big blind) folded before Flop



PokerStars Hand #254289447848:  Hold'em No Limit ($0.50/$1.00 USD) - 2025/01/09 1:26:54 WET [2025/01/09 20:26:54 ET]
Table 'Altais II' 6-max Seat #4 is the button
Seat 5: Spanky2Jacks ($0 in chips) is sitting out
Seat 1: BeauParleur ($211.11 in chips) 
Seat 2: GuigaMan ($113.48 in chips) 
Seat 3: rrrro ($100 in chips) 
Seat 4: BumHuntKing ($121.53 in chips) 
Seat 6: Gaita_toien ($100 in chips) 
Gaita_toien: posts small blind $0.50
BeauParleur: posts big blind $1
*** HOLE CARDS ***
GuigaMan: folds 
rrrro: folds 
BumHuntKing: raises $1.50 to $2.50
Gaita_toien: folds 
BeauParleur: raises $10.50 to $13
BumHuntKing: folds 
Uncalled bet ($10.50) returned to BeauParleur
BeauParleur collected $5.50 from pot
BeauParleur: doesn't show hand 
*** SUMMARY ***
Total pot $5.50 | Rake $0 
Seat 5: Spanky2Jacks
Seat 1: BeauParleur (big blind) collected ($5.50)
Seat 2: GuigaMan folded before Flop (didn't bet)
Seat 3: rrrro folded before Flop (didn't bet)
Seat 4: BumHuntKing (button) folded before Flop
Seat 6: Gaita_toien (small blind) folded before Flop



PokerStars Hand #254289451815:  Hold'em No Limit ($0.50/$1.00 USD) - 2025/01/09 1:27:15 WET [2025/01/09 20:27:15 ET]
Table 'Altais II' 6-max Seat #6 is the button
Seat 5: Spanky2Jacks ($0 in chips) is sitting out
Seat 1: BeauParleur ($214.11 in chips) 
Seat 2: GuigaMan ($113.48 in chips) 
Seat 3: rrrro ($100 in chips) 
Seat 4: BumHuntKing ($119.03 in chips) 
Seat 6: Gaita_toien ($100 in chips) 
BeauParleur: posts small blind $0.50
GuigaMan: posts big blind $1
*** HOLE CARDS ***
rrrro: raises $1 to $2
BumHuntKing: folds 
Gaita_toien: folds 
BeauParleur: folds 
GuigaMan: folds 
Uncalled bet ($1) returned to rrrro
rrrro collected $2.50 from pot
rrrro: doesn't show hand 
*** SUMMARY ***
Total pot $2.50 | Rake $0 
Seat 5: Spanky2Jacks
Seat 1: BeauParleur (small blind) folded before Flop
Seat 2: GuigaMan (big blind) folded before Flop
Seat 3: rrrro collected ($2.50)
Seat 4: BumHuntKing folded before Flop (didn't bet)
Seat 6: Gaita_toien (button) folded before Flop (didn't bet)



PokerStars Hand #254289456084:  Hold'em No Limit ($0.50/$1.00 USD) - 2025/01/09 1:27:38 WET [2025/01/09 20:27:38 ET]
Table 'Altais II' 6-max Seat #1 is the button
Seat 5: Spanky2Jacks ($0 in chips) is sitting out
Seat 1: BeauParleur ($213.61 in chips) 
Seat 2: GuigaMan ($112.48 in chips) 
Seat 3: rrrro ($101.50 in chips) 
Seat 4: BumHuntKing ($119.03 in chips) 
Seat 6: Gaita_toien ($100 in chips) 
GuigaMan: posts small blind $0.50
rrrro: posts big blind $1
*** HOLE CARDS ***
BumHuntKing: folds 
Gaita_toien: folds 
BeauParleur: raises $1.50 to $2.50
GuigaMan: folds 
rrrro: folds 
Uncalled bet ($1.50) returned to BeauParleur
BeauParleur collected $2.50 from pot
BeauParleur: doesn't show hand 
*** SUMMARY ***
Total pot $2.50 | Rake $0 
Seat 5: Spanky2Jacks
Seat 1: BeauParleur (button) collected ($2.50)
Seat 2: GuigaMan (small blind) folded before Flop
Seat 3: rrrro (big blind) folded before Flop
Seat 4: BumHuntKing folded before Flop (didn't bet)
Seat 6: Gaita_toien folded before Flop (didn't bet)



PokerStars Hand #254289460343:  Hold'em No Limit ($0.50/$1.00 USD) - 2025/01/09 1:28:01 WET [2025/01/09 20:28:01 ET]
Table 'Altais II' 6-max Seat #2 is the button
Seat 5: Spanky2Jacks ($0 in chips) is sitting out
Seat 1: BeauParleur ($215.11 in chips) 
Seat 2: GuigaMan ($111.98 in chips) 
Seat 3: rrrro ($100.50 in chips) 
Seat 4: BumHuntKing ($119.03 in chips) 
Seat 6: Gaita_toien ($100 in chips) 
rrrro: posts small blind $0.50
BumHuntKing: posts big blind $1
*** HOLE CARDS ***
Gaita_toien: raises $1.20 to $2.20
BeauParleur: raises $4.80 to $7
GuigaMan: folds 
rrrro: folds 
BumHuntKing: folds 
Gaita_toien: folds 
Uncalled bet ($4.80) returned to BeauParleur
BeauParleur collected $5.90 from pot
BeauParleur: doesn't show hand 
*** SUMMARY ***
Total pot $5.90 | Rake $0 
Seat 5: Spanky2Jacks
Seat 1: BeauParleur collected ($5.90)
Seat 2: GuigaMan (button) folded before Flop (didn't bet)
Seat 3: rrrro (small blind) folded before Flop
Seat 4: BumHuntKing (big blind) folded before Flop
Seat 6: Gaita_toien folded before Flop



PokerStars Hand #254289464662:  Hold'em No Limit ($0.50/$1.00 USD) - 2025/01/09 1:28:24 WET [2025/01/09 20:28:24 ET]
Table 'Altais II' 6-max Seat #3 is the button
Seat 5: Spanky2Jacks ($0 in chips) is sitting out
Seat 6: Gaita_toien ($100 in chips) is sitting out
Seat 1: BeauParleur ($218.81 in chips) 
Seat 2: GuigaMan ($111.98 in chips) 
Seat 3: rrrro ($100 in chips) 
Seat 4: BumHuntKing ($118.03 in chips) 
BumHuntKing: posts small blind $0.50
Gaita_toien: is sitting out 
BeauParleur: posts big blind $1
*** HOLE CARDS ***
GuigaMan: raises $1.10 to $2.10
rrrro: folds 
BumHuntKing: folds 
BeauParleur: folds 
Uncalled bet ($1.10) returned to GuigaMan
GuigaMan collected $2.50 from pot
GuigaMan: doesn't show hand 
*** SUMMARY ***
Total pot $2.50 | Rake $0 
Seat 5: Spanky2Jacks
Seat 6: Gaita_toien
Seat 1: BeauParleur (big blind) folded before Flop
Seat 2: GuigaMan collected ($2.50)
Seat 3: rrrro (button) folded before Flop (didn't bet)
Seat 4: BumHuntKing (small blind) folded before Flop



