PokerStars Hand #254401295751:  Hold'em No Limit ($0.50/$1.00 USD) - 2025/01/16 18:03:19 WET [2025/01/16 13:03:19 ET]
Table 'Gawain III' 6-max Seat #5 is the button
Seat 1: tukeiron ($206.66 in chips) is sitting out
Seat 2: Parabelum911 ($100 in chips) 
Seat 3: EAroca ($100 in chips) 
Seat 4: I TAKE IT 85 ($101 in chips) 
Seat 5: paramourx ($100 in chips) 
Parabelum911: posts small blind $0.50
EAroca: posts big blind $1
*** HOLE CARDS ***
I TAKE IT 85: folds 
paramourx: folds 
Parabelum911: raises $2 to $3
EAroca: folds 
Uncalled bet ($2) returned to Parabelum911
Parabelum911 collected $2 from pot
Parabelum911: doesn't show hand 
*** SUMMARY ***
Total pot $2 | Rake $0 
Seat 1: tukeiron
Seat 2: Parabelum911 (small blind) collected ($2)
Seat 3: EAroca (big blind) folded before Flop
Seat 4: I TAKE IT 85 folded before Flop (didn't bet)
Seat 5: paramourx (button) folded before Flop (didn't bet)



PokerStars Hand #254401301148:  Hold'em No Limit ($0.50/$1.00 USD) - 2025/01/16 18:03:40 WET [2025/01/16 13:03:40 ET]
Table 'Gawain III' 6-max Seat #2 is the button
Seat 1: tukeiron ($206.66 in chips) is sitting out
Seat 2: Parabelum911 ($101 in chips) 
Seat 3: EAroca ($100 in chips) 
Seat 4: I TAKE IT 85 ($101 in chips) 
Seat 5: paramourx ($100 in chips) 
EAroca: posts small blind $0.50
I TAKE IT 85: posts big blind $1
*** HOLE CARDS ***
paramourx: folds 
Parabelum911: raises $1.10 to $2.10
EAroca: raises $8.40 to $10.50
I TAKE IT 85: folds 
Parabelum911: calls $8.40
*** FLOP *** [Th 5h 7s]
EAroca: checks 
Parabelum911: bets $7.14
EAroca: calls $7.14
*** TURN *** [Th 5h 7s] [6d]
EAroca: checks 
Parabelum911: bets $26.50
EAroca: folds 
Uncalled bet ($26.50) returned to Parabelum911
Parabelum911 collected $35.28 from pot
Parabelum911: doesn't show hand 
*** SUMMARY ***
Total pot $36.28 | Rake $1 
Board [Th 5h 7s 6d]
Seat 1: tukeiron
Seat 2: Parabelum911 (button) collected ($35.28)
Seat 3: EAroca (small blind) folded on the Turn
Seat 4: I TAKE IT 85 (big blind) folded before Flop
Seat 5: paramourx folded before Flop (didn't bet)



PokerStars Hand #254401316912:  Hold'em No Limit ($0.50/$1.00 USD) - 2025/01/16 18:04:40 WET [2025/01/16 13:04:40 ET]
Table 'Gawain III' 6-max Seat #3 is the button
Seat 1: tukeiron ($206.66 in chips) is sitting out
Seat 2: Parabelum911 ($118.64 in chips) 
Seat 3: EAroca ($100 in chips) 
Seat 4: I TAKE IT 85 ($100 in chips) 
Seat 5: paramourx ($100 in chips) 
I TAKE IT 85: posts small blind $0.50
paramourx: posts big blind $1
tukeiron: sits out 
*** HOLE CARDS ***
Parabelum911: folds 
EAroca: folds 
I TAKE IT 85: folds 
Uncalled bet ($0.50) returned to paramourx
paramourx collected $1 from pot
paramourx: doesn't show hand 
*** SUMMARY ***
Total pot $1 | Rake $0 
Seat 1: tukeiron
Seat 2: Parabelum911 folded before Flop (didn't bet)
Seat 3: EAroca (button) folded before Flop (didn't bet)
Seat 4: I TAKE IT 85 (small blind) folded before Flop
Seat 5: paramourx (big blind) collected ($1)



PokerStars Hand #254401319611:  Hold'em No Limit ($0.50/$1.00 USD) - 2025/01/16 18:04:50 WET [2025/01/16 13:04:50 ET]
Table 'Gawain III' 6-max Seat #4 is the button
Seat 1: tukeiron ($206.66 in chips) 
Seat 2: Parabelum911 ($118.64 in chips) 
Seat 3: EAroca ($100 in chips) 
Seat 4: I TAKE IT 85 ($100 in chips) 
Seat 5: paramourx ($100.50 in chips) 
paramourx: posts small blind $0.50
tukeiron: posts big blind $1
*** HOLE CARDS ***
Parabelum911: folds 
EAroca: raises $1.50 to $2.50
I TAKE IT 85: folds 
paramourx: folds 
tukeiron: calls $1.50
*** FLOP *** [3d Jh Ts]
tukeiron: checks 
EAroca: bets $1.31
tukeiron: calls $1.31
*** TURN *** [3d Jh Ts] [7c]
tukeiron: checks 
EAroca: bets $5.78
ImaPeppaPig joins the table at seat #6 
tukeiron: folds 
Uncalled bet ($5.78) returned to EAroca
EAroca collected $7.71 from pot
EAroca: doesn't show hand 
*** SUMMARY ***
Total pot $8.12 | Rake $0.41 
Board [3d Jh Ts 7c]
Seat 1: tukeiron (big blind) folded on the Turn
Seat 2: Parabelum911 folded before Flop (didn't bet)
Seat 3: EAroca collected ($7.71)
Seat 4: I TAKE IT 85 (button) folded before Flop (didn't bet)
Seat 5: paramourx (small blind) folded before Flop



PokerStars Hand #254401333243:  Hold'em No Limit ($0.50/$1.00 USD) - 2025/01/16 18:05:42 WET [2025/01/16 13:05:42 ET]
Table 'Gawain III' 6-max Seat #5 is the button
Seat 6: ImaPeppaPig ($100 in chips) is sitting out
Seat 1: tukeiron ($202.85 in chips) 
Seat 2: Parabelum911 ($118.64 in chips) 
Seat 3: EAroca ($103.90 in chips) 
Seat 4: I TAKE IT 85 ($100 in chips) 
Seat 5: paramourx ($100 in chips) 
tukeiron: posts small blind $0.50
Parabelum911: posts big blind $1
*** HOLE CARDS ***
EAroca: folds 
I TAKE IT 85: folds 
paramourx: folds 
tukeiron: raises $2 to $3
Parabelum911: calls $2
*** FLOP *** [3d 7s 5c]
tukeiron: checks 
Parabelum911: checks 
*** TURN *** [3d 7s 5c] [2h]
tukeiron: checks 
Parabelum911: checks 
*** RIVER *** [3d 7s 5c 2h] [Jd]
tukeiron: bets $3.76
Parabelum911: folds 
Uncalled bet ($3.76) returned to tukeiron
tukeiron collected $5.70 from pot
*** SUMMARY ***
Total pot $6 | Rake $0.30 
Board [3d 7s 5c 2h Jd]
Seat 6: ImaPeppaPig
Seat 1: tukeiron (small blind) collected ($5.70)
Seat 2: Parabelum911 (big blind) folded on the River
Seat 3: EAroca folded before Flop (didn't bet)
Seat 4: I TAKE IT 85 folded before Flop (didn't bet)
Seat 5: paramourx (button) folded before Flop (didn't bet)



PokerStars Hand #254401351937:  Hold'em No Limit ($0.50/$1.00 USD) - 2025/01/16 18:06:51 WET [2025/01/16 13:06:51 ET]
Table 'Gawain III' 6-max Seat #1 is the button
Seat 6: ImaPeppaPig ($100 in chips) is sitting out
Seat 1: tukeiron ($205.55 in chips) 
Seat 2: Parabelum911 ($115.64 in chips) 
Seat 3: EAroca ($103.90 in chips) 
Seat 4: I TAKE IT 85 ($100 in chips) 
Seat 5: paramourx ($100 in chips) 
Parabelum911: posts small blind $0.50
EAroca: posts big blind $1
ImaPeppaPig: sits out 
*** HOLE CARDS ***
I TAKE IT 85: folds 
paramourx: raises $2 to $3
tukeiron: folds 
Parabelum911: folds 
EAroca: folds 
Uncalled bet ($2) returned to paramourx
paramourx collected $2.50 from pot
paramourx: doesn't show hand 
*** SUMMARY ***
Total pot $2.50 | Rake $0 
Seat 6: ImaPeppaPig
Seat 1: tukeiron (button) folded before Flop (didn't bet)
Seat 2: Parabelum911 (small blind) folded before Flop
Seat 3: EAroca (big blind) folded before Flop
Seat 4: I TAKE IT 85 folded before Flop (didn't bet)
Seat 5: paramourx collected ($2.50)



PokerStars Hand #254401358402:  Hold'em No Limit ($0.50/$1.00 USD) - 2025/01/16 18:07:16 WET [2025/01/16 13:07:16 ET]
Table 'Gawain III' 6-max Seat #2 is the button
Seat 6: ImaPeppaPig ($100 in chips) is sitting out
Seat 1: tukeiron ($205.55 in chips) 
Seat 2: Parabelum911 ($115.14 in chips) 
Seat 3: EAroca ($102.90 in chips) 
Seat 4: I TAKE IT 85 ($100 in chips) 
Seat 5: paramourx ($101.50 in chips) 
EAroca: posts small blind $0.50
I TAKE IT 85: posts big blind $1
ImaPeppaPig: sits out 
*** HOLE CARDS ***
paramourx: folds 
tukeiron: folds 
Parabelum911: folds 
EAroca: raises $2 to $3
I TAKE IT 85: raises $7 to $10
EAroca: folds 
Uncalled bet ($7) returned to I TAKE IT 85
I TAKE IT 85 collected $6 from pot
I TAKE IT 85: doesn't show hand 
*** SUMMARY ***
Total pot $6 | Rake $0 
Seat 6: ImaPeppaPig
Seat 1: tukeiron folded before Flop (didn't bet)
Seat 2: Parabelum911 (button) folded before Flop (didn't bet)
Seat 3: EAroca (small blind) folded before Flop
Seat 4: I TAKE IT 85 (big blind) collected ($6)
Seat 5: paramourx folded before Flop (didn't bet)



PokerStars Hand #254401367877:  Hold'em No Limit ($0.50/$1.00 USD) - 2025/01/16 18:07:51 WET [2025/01/16 13:07:51 ET]
Table 'Gawain III' 6-max Seat #3 is the button
Seat 6: ImaPeppaPig ($100 in chips) is sitting out
Seat 1: tukeiron ($205.55 in chips) 
Seat 2: Parabelum911 ($115.14 in chips) 
Seat 3: EAroca ($100 in chips) 
Seat 4: I TAKE IT 85 ($103 in chips) 
Seat 5: paramourx ($101.50 in chips) 
I TAKE IT 85: posts small blind $0.50
paramourx: posts big blind $1
ImaPeppaPig: sits out 
*** HOLE CARDS ***
tukeiron: folds 
Parabelum911: folds 
EAroca: raises $1.50 to $2.50
I TAKE IT 85: raises $7.50 to $10
paramourx: folds 
EAroca: calls $7.50
*** FLOP *** [Qs 6h 2d]
I TAKE IT 85: bets $15.76
EAroca: calls $15.76
*** TURN *** [Qs 6h 2d] [As]
I TAKE IT 85: bets $19.01
EAroca: calls $19.01
*** RIVER *** [Qs 6h 2d As] [5s]
I TAKE IT 85: bets $58.23 and is all-in
EAroca: folds 
Uncalled bet ($58.23) returned to I TAKE IT 85
I TAKE IT 85 collected $88.04 from pot
I TAKE IT 85: doesn't show hand 
*** SUMMARY ***
Total pot $90.54 | Rake $2.50 
Board [Qs 6h 2d As 5s]
Seat 6: ImaPeppaPig
Seat 1: tukeiron folded before Flop (didn't bet)
Seat 2: Parabelum911 folded before Flop (didn't bet)
Seat 3: EAroca (button) folded on the River
Seat 4: I TAKE IT 85 (small blind) collected ($88.04)
Seat 5: paramourx (big blind) folded before Flop



PokerStars Hand #254401390037:  Hold'em No Limit ($0.50/$1.00 USD) - 2025/01/16 18:09:14 WET [2025/01/16 13:09:14 ET]
Table 'Gawain III' 6-max Seat #4 is the button
Seat 1: tukeiron ($205.55 in chips) 
Seat 2: Parabelum911 ($115.14 in chips) 
Seat 3: EAroca ($100 in chips) 
Seat 4: I TAKE IT 85 ($146.27 in chips) 
Seat 5: paramourx ($100.50 in chips) 
Seat 6: ImaPeppaPig ($100 in chips) 
paramourx: posts small blind $0.50
ImaPeppaPig: posts big blind $1
*** HOLE CARDS ***
tukeiron: folds 
Parabelum911: folds 
EAroca: folds 
I TAKE IT 85: folds 
paramourx: raises $2 to $3
ImaPeppaPig: folds 
Uncalled bet ($2) returned to paramourx
paramourx collected $2 from pot
paramourx: doesn't show hand 
*** SUMMARY ***
Total pot $2 | Rake $0 
Seat 1: tukeiron folded before Flop (didn't bet)
Seat 2: Parabelum911 folded before Flop (didn't bet)
Seat 3: EAroca folded before Flop (didn't bet)
Seat 4: I TAKE IT 85 (button) folded before Flop (didn't bet)
Seat 5: paramourx (small blind) collected ($2)
Seat 6: ImaPeppaPig (big blind) folded before Flop



PokerStars Hand #254401393983:  Hold'em No Limit ($0.50/$1.00 USD) - 2025/01/16 18:09:29 WET [2025/01/16 13:09:29 ET]
Table 'Gawain III' 6-max Seat #5 is the button
Seat 1: tukeiron ($205.55 in chips) 
Seat 2: Parabelum911 ($115.14 in chips) 
Seat 3: EAroca ($100 in chips) 
Seat 4: I TAKE IT 85 ($146.27 in chips) 
Seat 5: paramourx ($101.50 in chips) 
Seat 6: ImaPeppaPig ($100 in chips) 
ImaPeppaPig: posts small blind $0.50
tukeiron: posts big blind $1
*** HOLE CARDS ***
Parabelum911: folds 
EAroca: folds 
I TAKE IT 85: raises $1.05 to $2.05
paramourx: folds 
ImaPeppaPig: folds 
tukeiron: folds 
Uncalled bet ($1.05) returned to I TAKE IT 85
I TAKE IT 85 collected $2.50 from pot
I TAKE IT 85: doesn't show hand 
*** SUMMARY ***
Total pot $2.50 | Rake $0 
Seat 1: tukeiron (big blind) folded before Flop
Seat 2: Parabelum911 folded before Flop (didn't bet)
Seat 3: EAroca folded before Flop (didn't bet)
Seat 4: I TAKE IT 85 collected ($2.50)
Seat 5: paramourx (button) folded before Flop (didn't bet)
Seat 6: ImaPeppaPig (small blind) folded before Flop



PokerStars Hand #254401400072:  Hold'em No Limit ($0.50/$1.00 USD) - 2025/01/16 18:09:51 WET [2025/01/16 13:09:51 ET]
Table 'Gawain III' 6-max Seat #6 is the button
Seat 1: tukeiron ($204.55 in chips) 
Seat 2: Parabelum911 ($115.14 in chips) 
Seat 3: EAroca ($100 in chips) 
Seat 4: I TAKE IT 85 ($147.77 in chips) 
Seat 5: paramourx ($101.50 in chips) 
Seat 6: ImaPeppaPig ($100 in chips) 
tukeiron: posts small blind $0.50
Parabelum911: posts big blind $1
*** HOLE CARDS ***
EAroca: folds 
I TAKE IT 85: raises $1.05 to $2.05
paramourx: folds 
ImaPeppaPig: folds 
tukeiron: folds 
Parabelum911: folds 
Uncalled bet ($1.05) returned to I TAKE IT 85
I TAKE IT 85 collected $2.50 from pot
I TAKE IT 85: doesn't show hand 
*** SUMMARY ***
Total pot $2.50 | Rake $0 
Seat 1: tukeiron (small blind) folded before Flop
Seat 2: Parabelum911 (big blind) folded before Flop
Seat 3: EAroca folded before Flop (didn't bet)
Seat 4: I TAKE IT 85 collected ($2.50)
Seat 5: paramourx folded before Flop (didn't bet)
Seat 6: ImaPeppaPig (button) folded before Flop (didn't bet)



PokerStars Hand #254401404485:  Hold'em No Limit ($0.50/$1.00 USD) - 2025/01/16 18:10:08 WET [2025/01/16 13:10:08 ET]
Table 'Gawain III' 6-max Seat #1 is the button
Seat 1: tukeiron ($204.05 in chips) 
Seat 2: Parabelum911 ($114.14 in chips) 
Seat 3: EAroca ($100 in chips) 
Seat 4: I TAKE IT 85 ($149.27 in chips) 
Seat 5: paramourx ($101.50 in chips) 
Seat 6: ImaPeppaPig ($100 in chips) 
Parabelum911: posts small blind $0.50
EAroca: posts big blind $1
*** HOLE CARDS ***
I TAKE IT 85: raises $1.05 to $2.05
paramourx: folds 
ImaPeppaPig: folds 
tukeiron: folds 
Parabelum911: raises $8.95 to $11
EAroca: folds 
I TAKE IT 85: folds 
Uncalled bet ($8.95) returned to Parabelum911
Parabelum911 collected $5.10 from pot
Parabelum911: doesn't show hand 
*** SUMMARY ***
Total pot $5.10 | Rake $0 
Seat 1: tukeiron (button) folded before Flop (didn't bet)
Seat 2: Parabelum911 (small blind) collected ($5.10)
Seat 3: EAroca (big blind) folded before Flop
Seat 4: I TAKE IT 85 folded before Flop
Seat 5: paramourx folded before Flop (didn't bet)
Seat 6: ImaPeppaPig folded before Flop (didn't bet)



PokerStars Hand #254401409271:  Hold'em No Limit ($0.50/$1.00 USD) - 2025/01/16 18:10:26 WET [2025/01/16 13:10:26 ET]
Table 'Gawain III' 6-max Seat #2 is the button
Seat 4: I TAKE IT 85 ($147.22 in chips) is sitting out
Seat 1: tukeiron ($204.05 in chips) 
Seat 2: Parabelum911 ($117.19 in chips) 
Seat 3: EAroca ($100 in chips) 
Seat 5: paramourx ($101.50 in chips) 
Seat 6: ImaPeppaPig ($100 in chips) 
EAroca: posts small blind $0.50
I TAKE IT 85: is sitting out 
paramourx: posts big blind $1
*** HOLE CARDS ***
I TAKE IT 85 leaves the table
ImaPeppaPig: folds 
tukeiron: folds 
Parabelum911: folds 
EAroca: folds 
Uncalled bet ($0.50) returned to paramourx
paramourx collected $1 from pot
paramourx: doesn't show hand 
*** SUMMARY ***
Total pot $1 | Rake $0 
Seat 4: I TAKE IT 85
Seat 1: tukeiron folded before Flop (didn't bet)
Seat 2: Parabelum911 (button) folded before Flop (didn't bet)
Seat 3: EAroca (small blind) folded before Flop
Seat 5: paramourx (big blind) collected ($1)
Seat 6: ImaPeppaPig folded before Flop (didn't bet)



PokerStars Hand #254401414926:  Hold'em No Limit ($0.50/$1.00 USD) - 2025/01/16 18:10:47 WET [2025/01/16 13:10:47 ET]
Table 'Gawain III' 6-max Seat #3 is the button
Seat 1: tukeiron ($204.05 in chips) 
Seat 2: Parabelum911 ($117.19 in chips) 
Seat 3: EAroca ($100 in chips) 
Seat 5: paramourx ($102 in chips) 
Seat 6: ImaPeppaPig ($100 in chips) 
paramourx: posts small blind $0.50
ImaPeppaPig: posts big blind $1
*** HOLE CARDS ***
tukeiron: folds 
Parabelum911: folds 
EAroca: raises $1.50 to $2.50
paramourx: folds 
ImaPeppaPig: folds 
Uncalled bet ($1.50) returned to EAroca
EAroca collected $2.50 from pot
EAroca: doesn't show hand 
*** SUMMARY ***
Total pot $2.50 | Rake $0 
Seat 1: tukeiron folded before Flop (didn't bet)
Seat 2: Parabelum911 folded before Flop (didn't bet)
Seat 3: EAroca (button) collected ($2.50)
Seat 5: paramourx (small blind) folded before Flop
Seat 6: ImaPeppaPig (big blind) folded before Flop



PokerStars Hand #254401516906:  Hold'em No Limit ($0.50/$1.00 USD) - 2025/01/16 18:17:05 WET [2025/01/16 13:17:05 ET]
Table 'Gawain III' 6-max Seat #6 is the button
Seat 1: AlexPinsk1 ($107.22 in chips) 
Seat 2: Parabelum911 ($115.69 in chips) 
Seat 3: EAroca ($101.70 in chips) 
Seat 4: fguil ($45.35 in chips) 
Seat 5: paramourx ($103.10 in chips) 
Seat 6: ImaPeppaPig ($110.15 in chips) 
AlexPinsk1: posts small blind $0.50
Parabelum911: posts big blind $1
*** HOLE CARDS ***
EAroca: folds 
fguil: folds 
paramourx: raises $2 to $3
ImaPeppaPig: folds 
AlexPinsk1: folds 
Parabelum911: folds 
Uncalled bet ($2) returned to paramourx
paramourx collected $2.50 from pot
paramourx: doesn't show hand 
*** SUMMARY ***
Total pot $2.50 | Rake $0 
Seat 1: AlexPinsk1 (small blind) folded before Flop
Seat 2: Parabelum911 (big blind) folded before Flop
Seat 3: EAroca folded before Flop (didn't bet)
Seat 4: fguil folded before Flop (didn't bet)
Seat 5: paramourx collected ($2.50)
Seat 6: ImaPeppaPig (button) folded before Flop (didn't bet)



PokerStars Hand #254401521416:  Hold'em No Limit ($0.50/$1.00 USD) - 2025/01/16 18:17:22 WET [2025/01/16 13:17:22 ET]
Table 'Gawain III' 6-max Seat #1 is the button
Seat 1: AlexPinsk1 ($106.72 in chips) 
Seat 2: Parabelum911 ($114.69 in chips) 
Seat 3: EAroca ($101.70 in chips) 
Seat 4: fguil ($45.35 in chips) 
Seat 5: paramourx ($104.60 in chips) 
Seat 6: ImaPeppaPig ($110.15 in chips) 
Parabelum911: posts small blind $0.50
EAroca: posts big blind $1
*** HOLE CARDS ***
fguil: raises $1 to $2
paramourx: folds 
ImaPeppaPig: folds 
AlexPinsk1: folds 
Parabelum911: folds 
EAroca: folds 
Uncalled bet ($1) returned to fguil
fguil collected $2.50 from pot
fguil: doesn't show hand 
*** SUMMARY ***
Total pot $2.50 | Rake $0 
Seat 1: AlexPinsk1 (button) folded before Flop (didn't bet)
Seat 2: Parabelum911 (small blind) folded before Flop
Seat 3: EAroca (big blind) folded before Flop
Seat 4: fguil collected ($2.50)
Seat 5: paramourx folded before Flop (didn't bet)
Seat 6: ImaPeppaPig folded before Flop (didn't bet)



PokerStars Hand #254401527174:  Hold'em No Limit ($0.50/$1.00 USD) - 2025/01/16 18:17:43 WET [2025/01/16 13:17:43 ET]
Table 'Gawain III' 6-max Seat #2 is the button
Seat 1: AlexPinsk1 ($106.72 in chips) 
Seat 2: Parabelum911 ($114.19 in chips) 
Seat 3: EAroca ($100.70 in chips) 
Seat 4: fguil ($46.85 in chips) 
Seat 5: paramourx ($104.60 in chips) 
Seat 6: ImaPeppaPig ($110.15 in chips) 
EAroca: posts small blind $0.50
fguil: posts big blind $1
*** HOLE CARDS ***
paramourx: folds 
ImaPeppaPig: folds 
AlexPinsk1: raises $1.50 to $2.50
Parabelum911: folds 
EAroca: folds 
fguil: folds 
Uncalled bet ($1.50) returned to AlexPinsk1
AlexPinsk1 collected $2.50 from pot
AlexPinsk1: doesn't show hand 
*** SUMMARY ***
Total pot $2.50 | Rake $0 
Seat 1: AlexPinsk1 collected ($2.50)
Seat 2: Parabelum911 (button) folded before Flop (didn't bet)
Seat 3: EAroca (small blind) folded before Flop
Seat 4: fguil (big blind) folded before Flop
Seat 5: paramourx folded before Flop (didn't bet)
Seat 6: ImaPeppaPig folded before Flop (didn't bet)



PokerStars Hand #254401531472:  Hold'em No Limit ($0.50/$1.00 USD) - 2025/01/16 18:17:59 WET [2025/01/16 13:17:59 ET]
Table 'Gawain III' 6-max Seat #3 is the button
Seat 1: AlexPinsk1 ($108.22 in chips) 
Seat 2: Parabelum911 ($114.19 in chips) 
Seat 3: EAroca ($100.20 in chips) 
Seat 4: fguil ($45.85 in chips) 
Seat 5: paramourx ($104.60 in chips) 
Seat 6: ImaPeppaPig ($110.15 in chips) 
fguil: posts small blind $0.50
paramourx: posts big blind $1
*** HOLE CARDS ***
ImaPeppaPig: raises $1 to $2
AlexPinsk1: folds 
Parabelum911: folds 
EAroca: folds 
fguil: folds 
paramourx: folds 
Uncalled bet ($1) returned to ImaPeppaPig
ImaPeppaPig collected $2.50 from pot
ImaPeppaPig: doesn't show hand 
*** SUMMARY ***
Total pot $2.50 | Rake $0 
Seat 1: AlexPinsk1 folded before Flop (didn't bet)
Seat 2: Parabelum911 folded before Flop (didn't bet)
Seat 3: EAroca (button) folded before Flop (didn't bet)
Seat 4: fguil (small blind) folded before Flop
Seat 5: paramourx (big blind) folded before Flop
Seat 6: ImaPeppaPig collected ($2.50)



PokerStars Hand #254401534439:  Hold'em No Limit ($0.50/$1.00 USD) - 2025/01/16 18:18:10 WET [2025/01/16 13:18:10 ET]
Table 'Gawain III' 6-max Seat #4 is the button
Seat 1: AlexPinsk1 ($108.22 in chips) 
Seat 2: Parabelum911 ($114.19 in chips) 
Seat 3: EAroca ($100.20 in chips) 
Seat 4: fguil ($45.35 in chips) 
Seat 5: paramourx ($103.60 in chips) 
Seat 6: ImaPeppaPig ($111.65 in chips) 
paramourx: posts small blind $0.50
ImaPeppaPig: posts big blind $1
*** HOLE CARDS ***
AlexPinsk1: folds 
Parabelum911: folds 
EAroca: folds 
fguil: calls $1
paramourx: raises $4 to $5
ImaPeppaPig: folds 
fguil: calls $4
*** FLOP *** [2s Kh 9d]
paramourx: bets $3.24
fguil: calls $3.24
*** TURN *** [2s Kh 9d] [Qs]
paramourx: bets $9.50
fguil: calls $9.50
*** RIVER *** [2s Kh 9d Qs] [Tc]
paramourx: checks 
fguil: checks 
*** SHOW DOWN ***
paramourx: shows [Ac Td] (a pair of Tens)
fguil: shows [Ks 8d] (a pair of Kings)
fguil collected $34.66 from pot
*** SUMMARY ***
Total pot $36.48 | Rake $1.82 
Board [2s Kh 9d Qs Tc]
Seat 1: AlexPinsk1 folded before Flop (didn't bet)
Seat 2: Parabelum911 folded before Flop (didn't bet)
Seat 3: EAroca folded before Flop (didn't bet)
Seat 4: fguil (button) showed [Ks 8d] and won ($34.66) with a pair of Kings
Seat 5: paramourx (small blind) showed [Ac Td] and lost with a pair of Tens
Seat 6: ImaPeppaPig (big blind) folded before Flop



PokerStars Hand #254401551262:  Hold'em No Limit ($0.50/$1.00 USD) - 2025/01/16 18:19:13 WET [2025/01/16 13:19:13 ET]
Table 'Gawain III' 6-max Seat #5 is the button
Seat 1: AlexPinsk1 ($108.22 in chips) 
Seat 2: Parabelum911 ($114.19 in chips) 
Seat 3: EAroca ($100.20 in chips) 
Seat 4: fguil ($62.27 in chips) 
Seat 5: paramourx ($100 in chips) 
Seat 6: ImaPeppaPig ($110.65 in chips) 
ImaPeppaPig: posts small blind $0.50
AlexPinsk1: posts big blind $1
*** HOLE CARDS ***
Parabelum911: folds 
EAroca: folds 
fguil: calls $1
paramourx: raises $4 to $5
ImaPeppaPig: folds 
AlexPinsk1: folds 
fguil: calls $4
*** FLOP *** [2c Jd Js]
fguil: checks 
paramourx: bets $3.39
fguil: calls $3.39
*** TURN *** [2c Jd Js] [7c]
fguil: checks 
paramourx: checks 
*** RIVER *** [2c Jd Js 7c] [2h]
fguil: checks 
paramourx: checks 
*** SHOW DOWN ***
fguil: shows [Qc 9h] (two pair, Jacks and Deuces)
paramourx: shows [Qs Th] (two pair, Jacks and Deuces)
fguil collected $8.69 from pot
paramourx collected $8.68 from pot
*** SUMMARY ***
Total pot $18.28 | Rake $0.91 
Board [2c Jd Js 7c 2h]
Seat 1: AlexPinsk1 (big blind) folded before Flop
Seat 2: Parabelum911 folded before Flop (didn't bet)
Seat 3: EAroca folded before Flop (didn't bet)
Seat 4: fguil showed [Qc 9h] and won ($8.69) with two pair, Jacks and Deuces
Seat 5: paramourx (button) showed [Qs Th] and won ($8.68) with two pair, Jacks and Deuces
Seat 6: ImaPeppaPig (small blind) folded before Flop



PokerStars Hand #254401565111:  Hold'em No Limit ($0.50/$1.00 USD) - 2025/01/16 18:20:04 WET [2025/01/16 13:20:04 ET]
Table 'Gawain III' 6-max Seat #6 is the button
Seat 1: AlexPinsk1 ($107.22 in chips) 
Seat 2: Parabelum911 ($114.19 in chips) 
Seat 3: EAroca ($100.20 in chips) 
Seat 4: fguil ($62.57 in chips) 
Seat 5: paramourx ($100.29 in chips) 
Seat 6: ImaPeppaPig ($110.15 in chips) 
AlexPinsk1: posts small blind $0.50
Parabelum911: posts big blind $1
*** HOLE CARDS ***
EAroca: folds 
fguil: folds 
paramourx: folds 
ImaPeppaPig: folds 
AlexPinsk1: raises $2 to $3
Parabelum911: calls $2
*** FLOP *** [5h Jc 8s]
AlexPinsk1: checks 
Parabelum911: bets $1.94
AlexPinsk1: folds 
Uncalled bet ($1.94) returned to Parabelum911
Parabelum911 collected $5.70 from pot
Parabelum911: doesn't show hand 
*** SUMMARY ***
Total pot $6 | Rake $0.30 
Board [5h Jc 8s]
Seat 1: AlexPinsk1 (small blind) folded on the Flop
Seat 2: Parabelum911 (big blind) collected ($5.70)
Seat 3: EAroca folded before Flop (didn't bet)
Seat 4: fguil folded before Flop (didn't bet)
Seat 5: paramourx folded before Flop (didn't bet)
Seat 6: ImaPeppaPig (button) folded before Flop (didn't bet)



PokerStars Hand #254401573595:  Hold'em No Limit ($0.50/$1.00 USD) - 2025/01/16 18:20:36 WET [2025/01/16 13:20:36 ET]
Table 'Gawain III' 6-max Seat #1 is the button
Seat 1: AlexPinsk1 ($104.22 in chips) 
Seat 2: Parabelum911 ($116.89 in chips) 
Seat 3: EAroca ($100.20 in chips) 
Seat 4: fguil ($62.57 in chips) 
Seat 5: paramourx ($100.29 in chips) 
Seat 6: ImaPeppaPig ($110.15 in chips) 
Parabelum911: posts small blind $0.50
EAroca: posts big blind $1
*** HOLE CARDS ***
fguil: folds 
paramourx: folds 
ImaPeppaPig: folds 
AlexPinsk1: folds 
Parabelum911: raises $2 to $3
EAroca: raises $6 to $9
Parabelum911: raises $107.89 to $116.89 and is all-in
EAroca: folds 
Uncalled bet ($107.89) returned to Parabelum911
Parabelum911 collected $18 from pot
Parabelum911: doesn't show hand 
*** SUMMARY ***
Total pot $18 | Rake $0 
Seat 1: AlexPinsk1 (button) folded before Flop (didn't bet)
Seat 2: Parabelum911 (small blind) collected ($18)
Seat 3: EAroca (big blind) folded before Flop
Seat 4: fguil folded before Flop (didn't bet)
Seat 5: paramourx folded before Flop (didn't bet)
Seat 6: ImaPeppaPig folded before Flop (didn't bet)



PokerStars Hand #254401582129:  Hold'em No Limit ($0.50/$1.00 USD) - 2025/01/16 18:21:07 WET [2025/01/16 13:21:07 ET]
Table 'Gawain III' 6-max Seat #2 is the button
Seat 1: AlexPinsk1 ($104.22 in chips) 
Seat 2: Parabelum911 ($125.89 in chips) 
Seat 3: EAroca ($100 in chips) 
Seat 4: fguil ($62.57 in chips) 
Seat 5: paramourx ($100.29 in chips) 
Seat 6: ImaPeppaPig ($110.15 in chips) 
EAroca: posts small blind $0.50
fguil: posts big blind $1
*** HOLE CARDS ***
paramourx: folds 
ImaPeppaPig: folds 
AlexPinsk1: folds 
Parabelum911: raises $1.10 to $2.10
EAroca: raises $8.40 to $10.50
fguil: folds 
Parabelum911: folds 
Uncalled bet ($8.40) returned to EAroca
EAroca collected $5.20 from pot
EAroca: doesn't show hand 
*** SUMMARY ***
Total pot $5.20 | Rake $0 
Seat 1: AlexPinsk1 folded before Flop (didn't bet)
Seat 2: Parabelum911 (button) folded before Flop
Seat 3: EAroca (small blind) collected ($5.20)
Seat 4: fguil (big blind) folded before Flop
Seat 5: paramourx folded before Flop (didn't bet)
Seat 6: ImaPeppaPig folded before Flop (didn't bet)



PokerStars Hand #254401593282:  Hold'em No Limit ($0.50/$1.00 USD) - 2025/01/16 18:21:48 WET [2025/01/16 13:21:48 ET]
Table 'Gawain III' 6-max Seat #3 is the button
Seat 1: AlexPinsk1 ($104.22 in chips) 
Seat 2: Parabelum911 ($123.79 in chips) 
Seat 3: EAroca ($103.10 in chips) 
Seat 4: fguil ($61.57 in chips) 
Seat 5: paramourx ($100.29 in chips) 
Seat 6: ImaPeppaPig ($110.15 in chips) 
fguil: posts small blind $0.50
paramourx: posts big blind $1
*** HOLE CARDS ***
ImaPeppaPig: folds 
AlexPinsk1: folds 
Parabelum911: raises $1.50 to $2.50
EAroca: raises $5.50 to $8
fguil: folds 
paramourx: folds 
Parabelum911: folds 
Uncalled bet ($5.50) returned to EAroca
EAroca collected $6.50 from pot
EAroca: doesn't show hand 
*** SUMMARY ***
Total pot $6.50 | Rake $0 
Seat 1: AlexPinsk1 folded before Flop (didn't bet)
Seat 2: Parabelum911 folded before Flop
Seat 3: EAroca (button) collected ($6.50)
Seat 4: fguil (small blind) folded before Flop
Seat 5: paramourx (big blind) folded before Flop
Seat 6: ImaPeppaPig folded before Flop (didn't bet)



PokerStars Hand #254401603473:  Hold'em No Limit ($0.50/$1.00 USD) - 2025/01/16 18:22:25 WET [2025/01/16 13:22:25 ET]
Table 'Gawain III' 6-max Seat #4 is the button
Seat 1: AlexPinsk1 ($104.22 in chips) 
Seat 2: Parabelum911 ($121.29 in chips) 
Seat 3: EAroca ($107.10 in chips) 
Seat 4: fguil ($61.07 in chips) 
Seat 5: paramourx ($100 in chips) 
Seat 6: ImaPeppaPig ($110.15 in chips) 
paramourx: posts small blind $0.50
ImaPeppaPig: posts big blind $1
*** HOLE CARDS ***
AlexPinsk1: folds 
Parabelum911: folds 
EAroca: folds 
fguil: calls $1
paramourx: folds 
ImaPeppaPig: checks 
*** FLOP *** [3s Kc 2d]
ImaPeppaPig: checks 
fguil: bets $1
ImaPeppaPig: folds 
Uncalled bet ($1) returned to fguil
fguil collected $2.38 from pot
fguil: doesn't show hand 
*** SUMMARY ***
Total pot $2.50 | Rake $0.12 
Board [3s Kc 2d]
Seat 1: AlexPinsk1 folded before Flop (didn't bet)
Seat 2: Parabelum911 folded before Flop (didn't bet)
Seat 3: EAroca folded before Flop (didn't bet)
Seat 4: fguil (button) collected ($2.38)
Seat 5: paramourx (small blind) folded before Flop
Seat 6: ImaPeppaPig (big blind) folded on the Flop



PokerStars Hand #254401612057:  Hold'em No Limit ($0.50/$1.00 USD) - 2025/01/16 18:22:56 WET [2025/01/16 13:22:56 ET]
Table 'Gawain III' 6-max Seat #5 is the button
Seat 1: AlexPinsk1 ($104.22 in chips) 
Seat 2: Parabelum911 ($121.29 in chips) 
Seat 3: EAroca ($107.10 in chips) 
Seat 4: fguil ($62.45 in chips) 
Seat 5: paramourx ($100 in chips) 
Seat 6: ImaPeppaPig ($109.15 in chips) 
ImaPeppaPig: posts small blind $0.50
AlexPinsk1: posts big blind $1
*** HOLE CARDS ***
Parabelum911: raises $1.50 to $2.50
EAroca: folds 
fguil: folds 
paramourx: folds 
ImaPeppaPig: folds 
AlexPinsk1: folds 
Uncalled bet ($1.50) returned to Parabelum911
Parabelum911 collected $2.50 from pot
Parabelum911: doesn't show hand 
*** SUMMARY ***
Total pot $2.50 | Rake $0 
Seat 1: AlexPinsk1 (big blind) folded before Flop
Seat 2: Parabelum911 collected ($2.50)
Seat 3: EAroca folded before Flop (didn't bet)
Seat 4: fguil folded before Flop (didn't bet)
Seat 5: paramourx (button) folded before Flop (didn't bet)
Seat 6: ImaPeppaPig (small blind) folded before Flop



PokerStars Hand #254401614870:  Hold'em No Limit ($0.50/$1.00 USD) - 2025/01/16 18:23:06 WET [2025/01/16 13:23:06 ET]
Table 'Gawain III' 6-max Seat #6 is the button
Seat 1: AlexPinsk1 ($103.22 in chips) 
Seat 2: Parabelum911 ($122.79 in chips) 
Seat 3: EAroca ($107.10 in chips) 
Seat 4: fguil ($62.45 in chips) 
Seat 5: paramourx ($100 in chips) 
Seat 6: ImaPeppaPig ($108.65 in chips) 
AlexPinsk1: posts small blind $0.50
Parabelum911: posts big blind $1
*** HOLE CARDS ***
EAroca: folds 
fguil: calls $1
paramourx: folds 
ImaPeppaPig: folds 
AlexPinsk1: folds 
Parabelum911: checks 
*** FLOP *** [Kd 6c Ts]
Parabelum911: checks 
fguil: bets $1
Parabelum911: calls $1
*** TURN *** [Kd 6c Ts] [9c]
Parabelum911: checks 
fguil: checks 
*** RIVER *** [Kd 6c Ts 9c] [8h]
Parabelum911: bets $1
fguil: calls $1
*** SHOW DOWN ***
Parabelum911: shows [Qh Tc] (a pair of Tens)
fguil: mucks hand 
Parabelum911 collected $6.18 from pot
*** SUMMARY ***
Total pot $6.50 | Rake $0.32 
Board [Kd 6c Ts 9c 8h]
Seat 1: AlexPinsk1 (small blind) folded before Flop
Seat 2: Parabelum911 (big blind) showed [Qh Tc] and won ($6.18) with a pair of Tens
Seat 3: EAroca folded before Flop (didn't bet)
Seat 4: fguil mucked
Seat 5: paramourx folded before Flop (didn't bet)
Seat 6: ImaPeppaPig (button) folded before Flop (didn't bet)



PokerStars Hand #254401625826:  Hold'em No Limit ($0.50/$1.00 USD) - 2025/01/16 18:23:46 WET [2025/01/16 13:23:46 ET]
Table 'Gawain III' 6-max Seat #1 is the button
Seat 1: AlexPinsk1 ($102.72 in chips) 
Seat 2: Parabelum911 ($125.97 in chips) 
Seat 3: EAroca ($107.10 in chips) 
Seat 4: fguil ($59.45 in chips) 
Seat 5: paramourx ($100 in chips) 
Seat 6: ImaPeppaPig ($108.65 in chips) 
Parabelum911: posts small blind $0.50
EAroca: posts big blind $1
*** HOLE CARDS ***
fguil: folds 
paramourx: raises $2 to $3
ImaPeppaPig: folds 
AlexPinsk1: folds 
Parabelum911: folds 
EAroca: folds 
Uncalled bet ($2) returned to paramourx
paramourx collected $2.50 from pot
paramourx: doesn't show hand 
*** SUMMARY ***
Total pot $2.50 | Rake $0 
Seat 1: AlexPinsk1 (button) folded before Flop (didn't bet)
Seat 2: Parabelum911 (small blind) folded before Flop
Seat 3: EAroca (big blind) folded before Flop
Seat 4: fguil folded before Flop (didn't bet)
Seat 5: paramourx collected ($2.50)
Seat 6: ImaPeppaPig folded before Flop (didn't bet)



PokerStars Hand #254401635710:  Hold'em No Limit ($0.50/$1.00 USD) - 2025/01/16 18:24:21 WET [2025/01/16 13:24:21 ET]
Table 'Gawain III' 6-max Seat #2 is the button
Seat 1: AlexPinsk1 ($102.72 in chips) 
Seat 2: Parabelum911 ($125.47 in chips) 
Seat 3: EAroca ($106.10 in chips) 
Seat 4: fguil ($59.45 in chips) 
Seat 5: paramourx ($101.50 in chips) 
Seat 6: ImaPeppaPig ($108.65 in chips) 
EAroca: posts small blind $0.50
fguil: posts big blind $1
*** HOLE CARDS ***
paramourx: folds 
ImaPeppaPig: folds 
AlexPinsk1: folds 
Parabelum911: folds 
EAroca: raises $1.50 to $2.50
fguil: calls $1.50
*** FLOP *** [Qh Jh Th]
EAroca: bets $1.57
fguil: calls $1.57
*** TURN *** [Qh Jh Th] [4s]
EAroca: bets $5.80
fguil: folds 
Uncalled bet ($5.80) returned to EAroca
EAroca collected $7.73 from pot
EAroca: doesn't show hand 
*** SUMMARY ***
Total pot $8.14 | Rake $0.41 
Board [Qh Jh Th 4s]
Seat 1: AlexPinsk1 folded before Flop (didn't bet)
Seat 2: Parabelum911 (button) folded before Flop (didn't bet)
Seat 3: EAroca (small blind) collected ($7.73)
Seat 4: fguil (big blind) folded on the Turn
Seat 5: paramourx folded before Flop (didn't bet)
Seat 6: ImaPeppaPig folded before Flop (didn't bet)



PokerStars Hand #254401651406:  Hold'em No Limit ($0.50/$1.00 USD) - 2025/01/16 18:25:18 WET [2025/01/16 13:25:18 ET]
Table 'Gawain III' 6-max Seat #3 is the button
Seat 1: AlexPinsk1 ($102.72 in chips) 
Seat 2: Parabelum911 ($125.47 in chips) 
Seat 3: EAroca ($109.76 in chips) 
Seat 4: fguil ($55.38 in chips) 
Seat 5: paramourx ($101.50 in chips) 
Seat 6: ImaPeppaPig ($108.65 in chips) 
fguil: posts small blind $0.50
paramourx: posts big blind $1
*** HOLE CARDS ***
ImaPeppaPig: folds 
AlexPinsk1: folds 
Parabelum911: raises $1.50 to $2.50
EAroca: folds 
fguil: calls $2
paramourx: calls $1.50
*** FLOP *** [Qs Ad 8c]
fguil: checks 
paramourx: checks 
Parabelum911: bets $2.42
fguil: folds 
paramourx: folds 
Uncalled bet ($2.42) returned to Parabelum911
Parabelum911 collected $7.12 from pot
Parabelum911: doesn't show hand 
*** SUMMARY ***
Total pot $7.50 | Rake $0.38 
Board [Qs Ad 8c]
Seat 1: AlexPinsk1 folded before Flop (didn't bet)
Seat 2: Parabelum911 collected ($7.12)
Seat 3: EAroca (button) folded before Flop (didn't bet)
Seat 4: fguil (small blind) folded on the Flop
Seat 5: paramourx (big blind) folded on the Flop
Seat 6: ImaPeppaPig folded before Flop (didn't bet)



PokerStars Hand #254401660152:  Hold'em No Limit ($0.50/$1.00 USD) - 2025/01/16 18:25:50 WET [2025/01/16 13:25:50 ET]
Table 'Gawain III' 6-max Seat #4 is the button
Seat 1: AlexPinsk1 ($102.72 in chips) 
Seat 2: Parabelum911 ($130.09 in chips) 
Seat 3: EAroca ($109.76 in chips) 
Seat 4: fguil ($52.88 in chips) 
Seat 5: paramourx ($100 in chips) 
Seat 6: ImaPeppaPig ($108.65 in chips) 
paramourx: posts small blind $0.50
ImaPeppaPig: posts big blind $1
*** HOLE CARDS ***
AlexPinsk1: folds 
Parabelum911: folds 
EAroca: folds 
fguil: calls $1
paramourx: folds 
ImaPeppaPig: raises $5 to $6
fguil: calls $5
*** FLOP *** [8s 6s 6d]
ImaPeppaPig: bets $3.68
fguil: calls $3.68
*** TURN *** [8s 6s 6d] [Kd]
ImaPeppaPig: checks 
fguil: bets $6
ImaPeppaPig: calls $6
*** RIVER *** [8s 6s 6d Kd] [4h]
ImaPeppaPig: checks 
fguil: checks 
*** SHOW DOWN ***
ImaPeppaPig: shows [Ad Qs] (a pair of Sixes)
fguil: shows [Js 4s] (two pair, Sixes and Fours)
fguil collected $30.27 from pot
*** SUMMARY ***
Total pot $31.86 | Rake $1.59 
Board [8s 6s 6d Kd 4h]
Seat 1: AlexPinsk1 folded before Flop (didn't bet)
Seat 2: Parabelum911 folded before Flop (didn't bet)
Seat 3: EAroca folded before Flop (didn't bet)
Seat 4: fguil (button) showed [Js 4s] and won ($30.27) with two pair, Sixes and Fours
Seat 5: paramourx (small blind) folded before Flop
Seat 6: ImaPeppaPig (big blind) showed [Ad Qs] and lost with a pair of Sixes



PokerStars Hand #254401673367:  Hold'em No Limit ($0.50/$1.00 USD) - 2025/01/16 18:26:38 WET [2025/01/16 13:26:38 ET]
Table 'Gawain III' 6-max Seat #5 is the button
Seat 1: AlexPinsk1 ($102.72 in chips) 
Seat 2: Parabelum911 ($130.09 in chips) 
Seat 3: EAroca ($109.76 in chips) 
Seat 4: fguil ($67.47 in chips) 
Seat 5: paramourx ($100 in chips) 
Seat 6: ImaPeppaPig ($100 in chips) 
ImaPeppaPig: posts small blind $0.50
AlexPinsk1: posts big blind $1
*** HOLE CARDS ***
Parabelum911: folds 
EAroca: folds 
fguil: calls $1
paramourx: folds 
ImaPeppaPig: folds 
AlexPinsk1: checks 
*** FLOP *** [6h Qd 8c]
AlexPinsk1: checks 
fguil: checks 
*** TURN *** [6h Qd 8c] [2c]
AlexPinsk1: checks 
fguil: checks 
*** RIVER *** [6h Qd 8c 2c] [4s]
AlexPinsk1: bets $1
fguil: folds 
Uncalled bet ($1) returned to AlexPinsk1
AlexPinsk1 collected $2.38 from pot
AlexPinsk1: doesn't show hand 
*** SUMMARY ***
Total pot $2.50 | Rake $0.12 
Board [6h Qd 8c 2c 4s]
Seat 1: AlexPinsk1 (big blind) collected ($2.38)
Seat 2: Parabelum911 folded before Flop (didn't bet)
Seat 3: EAroca folded before Flop (didn't bet)
Seat 4: fguil folded on the River
Seat 5: paramourx (button) folded before Flop (didn't bet)
Seat 6: ImaPeppaPig (small blind) folded before Flop



PokerStars Hand #254401685120:  Hold'em No Limit ($0.50/$1.00 USD) - 2025/01/16 18:27:20 WET [2025/01/16 13:27:20 ET]
Table 'Gawain III' 6-max Seat #6 is the button
Seat 1: AlexPinsk1 ($104.10 in chips) 
Seat 2: Parabelum911 ($130.09 in chips) 
Seat 3: EAroca ($109.76 in chips) 
Seat 4: fguil ($66.47 in chips) 
Seat 5: paramourx ($100 in chips) 
Seat 6: ImaPeppaPig ($100 in chips) 
AlexPinsk1: posts small blind $0.50
Parabelum911: posts big blind $1
*** HOLE CARDS ***
EAroca: folds 
fguil: folds 
paramourx: folds 
ImaPeppaPig: folds 
AlexPinsk1: folds 
Uncalled bet ($0.50) returned to Parabelum911
Parabelum911 collected $1 from pot
Parabelum911: doesn't show hand 
*** SUMMARY ***
Total pot $1 | Rake $0 
Seat 1: AlexPinsk1 (small blind) folded before Flop
Seat 2: Parabelum911 (big blind) collected ($1)
Seat 3: EAroca folded before Flop (didn't bet)
Seat 4: fguil folded before Flop (didn't bet)
Seat 5: paramourx folded before Flop (didn't bet)
Seat 6: ImaPeppaPig (button) folded before Flop (didn't bet)



PokerStars Hand #254401689573:  Hold'em No Limit ($0.50/$1.00 USD) - 2025/01/16 18:27:36 WET [2025/01/16 13:27:36 ET]
Table 'Gawain III' 6-max Seat #1 is the button
Seat 1: AlexPinsk1 ($103.60 in chips) 
Seat 2: Parabelum911 ($130.59 in chips) 
Seat 3: EAroca ($109.76 in chips) 
Seat 4: fguil ($66.47 in chips) 
Seat 5: paramourx ($100 in chips) 
Seat 6: ImaPeppaPig ($100 in chips) 
Parabelum911: posts small blind $0.50
EAroca: posts big blind $1
*** HOLE CARDS ***
fguil: folds 
paramourx: folds 
ImaPeppaPig: raises $1.50 to $2.50
AlexPinsk1: folds 
Parabelum911: folds 
EAroca: folds 
Uncalled bet ($1.50) returned to ImaPeppaPig
ImaPeppaPig collected $2.50 from pot
ImaPeppaPig: doesn't show hand 
*** SUMMARY ***
Total pot $2.50 | Rake $0 
Seat 1: AlexPinsk1 (button) folded before Flop (didn't bet)
Seat 2: Parabelum911 (small blind) folded before Flop
Seat 3: EAroca (big blind) folded before Flop
Seat 4: fguil folded before Flop (didn't bet)
Seat 5: paramourx folded before Flop (didn't bet)
Seat 6: ImaPeppaPig collected ($2.50)



PokerStars Hand #254401695550:  Hold'em No Limit ($0.50/$1.00 USD) - 2025/01/16 18:27:57 WET [2025/01/16 13:27:57 ET]
Table 'Gawain III' 6-max Seat #2 is the button
Seat 1: AlexPinsk1 ($103.60 in chips) 
Seat 2: Parabelum911 ($130.09 in chips) 
Seat 3: EAroca ($108.76 in chips) 
Seat 4: fguil ($66.47 in chips) 
Seat 5: paramourx ($100 in chips) 
Seat 6: ImaPeppaPig ($101.50 in chips) 
EAroca: posts small blind $0.50
fguil: posts big blind $1
*** HOLE CARDS ***
paramourx: folds 
ImaPeppaPig: folds 
AlexPinsk1: raises $1.50 to $2.50
Parabelum911: folds 
EAroca: folds 
fguil: calls $1.50
*** FLOP *** [Js 9h Jc]
fguil: checks 
AlexPinsk1: bets $1.72
fguil: folds 
Uncalled bet ($1.72) returned to AlexPinsk1
AlexPinsk1 collected $5.22 from pot
AlexPinsk1: doesn't show hand 
*** SUMMARY ***
Total pot $5.50 | Rake $0.28 
Board [Js 9h Jc]
Seat 1: AlexPinsk1 collected ($5.22)
Seat 2: Parabelum911 (button) folded before Flop (didn't bet)
Seat 3: EAroca (small blind) folded before Flop
Seat 4: fguil (big blind) folded on the Flop
Seat 5: paramourx folded before Flop (didn't bet)
Seat 6: ImaPeppaPig folded before Flop (didn't bet)



PokerStars Hand #254401418484:  Hold'em No Limit ($0.50/$1.00 USD) - 2025/01/16 18:11:00 WET [2025/01/16 13:11:00 ET]
Table 'Gawain III' 6-max Seat #5 is the button
Seat 1: tukeiron ($204.05 in chips) 
Seat 2: Parabelum911 ($117.19 in chips) 
Seat 3: EAroca ($101.50 in chips) 
Seat 5: paramourx ($101.50 in chips) 
Seat 6: ImaPeppaPig ($100 in chips) 
ImaPeppaPig: posts small blind $0.50
tukeiron: posts big blind $1
*** HOLE CARDS ***
Parabelum911: raises $1.50 to $2.50
EAroca: folds 
paramourx: folds 
ImaPeppaPig: folds 
tukeiron: folds 
Uncalled bet ($1.50) returned to Parabelum911
Parabelum911 collected $2.50 from pot
Parabelum911: doesn't show hand 
*** SUMMARY ***
Total pot $2.50 | Rake $0 
Seat 1: tukeiron (big blind) folded before Flop
Seat 2: Parabelum911 collected ($2.50)
Seat 3: EAroca folded before Flop (didn't bet)
Seat 5: paramourx (button) folded before Flop (didn't bet)
Seat 6: ImaPeppaPig (small blind) folded before Flop



PokerStars Hand #254401425218:  Hold'em No Limit ($0.50/$1.00 USD) - 2025/01/16 18:11:26 WET [2025/01/16 13:11:26 ET]
Table 'Gawain III' 6-max Seat #6 is the button
Seat 1: tukeiron ($203.05 in chips) 
Seat 2: Parabelum911 ($118.69 in chips) 
Seat 3: EAroca ($101.50 in chips) 
Seat 5: paramourx ($101.50 in chips) 
Seat 6: ImaPeppaPig ($100 in chips) 
tukeiron: posts small blind $0.50
Parabelum911: posts big blind $1
*** HOLE CARDS ***
EAroca: raises $1 to $2
paramourx: folds 
ImaPeppaPig: folds 
tukeiron: folds 
Parabelum911: folds 
Uncalled bet ($1) returned to EAroca
EAroca collected $2.50 from pot
EAroca: doesn't show hand 
*** SUMMARY ***
Total pot $2.50 | Rake $0 
Seat 1: tukeiron (small blind) folded before Flop
Seat 2: Parabelum911 (big blind) folded before Flop
Seat 3: EAroca collected ($2.50)
Seat 5: paramourx folded before Flop (didn't bet)
Seat 6: ImaPeppaPig (button) folded before Flop (didn't bet)



PokerStars Hand #254401432016:  Hold'em No Limit ($0.50/$1.00 USD) - 2025/01/16 18:11:50 WET [2025/01/16 13:11:50 ET]
Table 'Gawain III' 6-max Seat #1 is the button
Seat 1: tukeiron ($202.55 in chips) 
Seat 2: Parabelum911 ($117.69 in chips) 
Seat 3: EAroca ($103 in chips) 
Seat 5: paramourx ($101.50 in chips) 
Seat 6: ImaPeppaPig ($100 in chips) 
Parabelum911: posts small blind $0.50
EAroca: posts big blind $1
*** HOLE CARDS ***
paramourx: raises $2 to $3
ImaPeppaPig: folds 
tukeiron: raises $6 to $9
Parabelum911: folds 
EAroca: folds 
paramourx: folds 
Uncalled bet ($6) returned to tukeiron
tukeiron collected $7.50 from pot
tukeiron: doesn't show hand 
*** SUMMARY ***
Total pot $7.50 | Rake $0 
Seat 1: tukeiron (button) collected ($7.50)
Seat 2: Parabelum911 (small blind) folded before Flop
Seat 3: EAroca (big blind) folded before Flop
Seat 5: paramourx folded before Flop
Seat 6: ImaPeppaPig folded before Flop (didn't bet)



PokerStars Hand #254401436371:  Hold'em No Limit ($0.50/$1.00 USD) - 2025/01/16 18:12:06 WET [2025/01/16 13:12:06 ET]
Table 'Gawain III' 6-max Seat #2 is the button
Seat 5: paramourx ($100 in chips) is sitting out
Seat 1: tukeiron ($207.05 in chips) 
Seat 2: Parabelum911 ($117.19 in chips) 
Seat 3: EAroca ($102 in chips) 
Seat 6: ImaPeppaPig ($100 in chips) 
EAroca: posts small blind $0.50
paramourx: is sitting out 
ImaPeppaPig: posts big blind $1
*** HOLE CARDS ***
tukeiron: folds 
Parabelum911: folds 
tukeiron leaves the table
EAroca: folds 
Uncalled bet ($0.50) returned to ImaPeppaPig
fguil joins the table at seat #4 
ImaPeppaPig collected $1 from pot
ImaPeppaPig: doesn't show hand 
AlexPinsk1 joins the table at seat #1 
*** SUMMARY ***
Total pot $1 | Rake $0 
Seat 5: paramourx
Seat 1: tukeiron folded before Flop (didn't bet)
Seat 2: Parabelum911 (button) folded before Flop (didn't bet)
Seat 3: EAroca (small blind) folded before Flop
Seat 6: ImaPeppaPig (big blind) collected ($1)



PokerStars Hand #254401439316:  Hold'em No Limit ($0.50/$1.00 USD) - 2025/01/16 18:12:17 WET [2025/01/16 13:12:17 ET]
Table 'Gawain III' 6-max Seat #3 is the button
Seat 4: fguil ($64.35 in chips) is sitting out
Seat 5: paramourx ($100 in chips) is sitting out
Seat 1: AlexPinsk1 ($100 in chips) 
Seat 2: Parabelum911 ($117.19 in chips) 
Seat 3: EAroca ($101.50 in chips) 
Seat 6: ImaPeppaPig ($100.50 in chips) 
ImaPeppaPig: posts small blind $0.50
AlexPinsk1: posts big blind $1
*** HOLE CARDS ***
Parabelum911: folds 
EAroca: folds 
ImaPeppaPig: folds 
Uncalled bet ($0.50) returned to AlexPinsk1
AlexPinsk1 collected $1 from pot
AlexPinsk1: doesn't show hand 
*** SUMMARY ***
Total pot $1 | Rake $0 
Seat 4: fguil
Seat 5: paramourx
Seat 1: AlexPinsk1 (big blind) collected ($1)
Seat 2: Parabelum911 folded before Flop (didn't bet)
Seat 3: EAroca (button) folded before Flop (didn't bet)
Seat 6: ImaPeppaPig (small blind) folded before Flop



PokerStars Hand #254401442382:  Hold'em No Limit ($0.50/$1.00 USD) - 2025/01/16 18:12:29 WET [2025/01/16 13:12:29 ET]
Table 'Gawain III' 6-max Seat #6 is the button
Seat 5: paramourx ($100 in chips) is sitting out
Seat 1: AlexPinsk1 ($100.50 in chips) 
Seat 2: Parabelum911 ($117.19 in chips) 
Seat 3: EAroca ($101.50 in chips) 
Seat 4: fguil ($64.35 in chips) 
Seat 6: ImaPeppaPig ($100 in chips) 
AlexPinsk1: posts small blind $0.50
Parabelum911: posts big blind $1
fguil: posts big blind $1
paramourx: sits out 
*** HOLE CARDS ***
EAroca: folds 
fguil: checks 
ImaPeppaPig: folds 
AlexPinsk1: raises $2.50 to $3.50
Parabelum911: folds 
fguil: folds 
Uncalled bet ($2.50) returned to AlexPinsk1
AlexPinsk1 collected $3 from pot
AlexPinsk1: doesn't show hand 
*** SUMMARY ***
Total pot $3 | Rake $0 
Seat 5: paramourx
Seat 1: AlexPinsk1 (small blind) collected ($3)
Seat 2: Parabelum911 (big blind) folded before Flop
Seat 3: EAroca folded before Flop (didn't bet)
Seat 4: fguil folded before Flop (didn't bet)
Seat 6: ImaPeppaPig (button) folded before Flop (didn't bet)



PokerStars Hand #254401446261:  Hold'em No Limit ($0.50/$1.00 USD) - 2025/01/16 18:12:43 WET [2025/01/16 13:12:43 ET]
Table 'Gawain III' 6-max Seat #1 is the button
Seat 5: paramourx ($100 in chips) is sitting out
Seat 1: AlexPinsk1 ($102.50 in chips) 
Seat 2: Parabelum911 ($116.19 in chips) 
Seat 3: EAroca ($101.50 in chips) 
Seat 4: fguil ($63.35 in chips) 
Seat 6: ImaPeppaPig ($100 in chips) 
Parabelum911: posts small blind $0.50
EAroca: posts big blind $1
paramourx: sits out 
*** HOLE CARDS ***
fguil: folds 
ImaPeppaPig: folds 
AlexPinsk1: raises $1.50 to $2.50
Parabelum911: folds 
EAroca: folds 
Uncalled bet ($1.50) returned to AlexPinsk1
AlexPinsk1 collected $2.50 from pot
AlexPinsk1: doesn't show hand 
*** SUMMARY ***
Total pot $2.50 | Rake $0 
Seat 5: paramourx
Seat 1: AlexPinsk1 (button) collected ($2.50)
Seat 2: Parabelum911 (small blind) folded before Flop
Seat 3: EAroca (big blind) folded before Flop
Seat 4: fguil folded before Flop (didn't bet)
Seat 6: ImaPeppaPig folded before Flop (didn't bet)



PokerStars Hand #254401450590:  Hold'em No Limit ($0.50/$1.00 USD) - 2025/01/16 18:12:58 WET [2025/01/16 13:12:58 ET]
Table 'Gawain III' 6-max Seat #2 is the button
Seat 5: paramourx ($100 in chips) is sitting out
Seat 1: AlexPinsk1 ($104 in chips) 
Seat 2: Parabelum911 ($115.69 in chips) 
Seat 3: EAroca ($100.50 in chips) 
Seat 4: fguil ($63.35 in chips) 
Seat 6: ImaPeppaPig ($100 in chips) 
EAroca: posts small blind $0.50
fguil: posts big blind $1
paramourx: sits out 
*** HOLE CARDS ***
ImaPeppaPig: folds 
AlexPinsk1: raises $1.50 to $2.50
Parabelum911: folds 
EAroca: folds 
fguil: calls $1.50
*** FLOP *** [Ks Qc 2s]
fguil: checks 
AlexPinsk1: bets $3.92
fguil: folds 
Uncalled bet ($3.92) returned to AlexPinsk1
AlexPinsk1 collected $5.22 from pot
AlexPinsk1: doesn't show hand 
*** SUMMARY ***
Total pot $5.50 | Rake $0.28 
Board [Ks Qc 2s]
Seat 5: paramourx
Seat 1: AlexPinsk1 collected ($5.22)
Seat 2: Parabelum911 (button) folded before Flop (didn't bet)
Seat 3: EAroca (small blind) folded before Flop
Seat 4: fguil (big blind) folded on the Flop
Seat 6: ImaPeppaPig folded before Flop (didn't bet)



PokerStars Hand #254401460550:  Hold'em No Limit ($0.50/$1.00 USD) - 2025/01/16 18:13:35 WET [2025/01/16 13:13:35 ET]
Table 'Gawain III' 6-max Seat #3 is the button
Seat 1: AlexPinsk1 ($106.72 in chips) 
Seat 2: Parabelum911 ($115.69 in chips) 
Seat 3: EAroca ($100 in chips) 
Seat 4: fguil ($60.85 in chips) 
Seat 5: paramourx ($100 in chips) 
Seat 6: ImaPeppaPig ($100 in chips) 
fguil: posts small blind $0.50
paramourx: posts big blind $1
*** HOLE CARDS ***
ImaPeppaPig: folds 
AlexPinsk1: folds 
Parabelum911: folds 
EAroca: raises $1.50 to $2.50
fguil: calls $2
paramourx: folds 
*** FLOP *** [2h As Jc]
fguil: checks 
EAroca: bets $1.88
fguil: folds 
Uncalled bet ($1.88) returned to EAroca
EAroca collected $5.70 from pot
EAroca: doesn't show hand 
*** SUMMARY ***
Total pot $6 | Rake $0.30 
Board [2h As Jc]
Seat 1: AlexPinsk1 folded before Flop (didn't bet)
Seat 2: Parabelum911 folded before Flop (didn't bet)
Seat 3: EAroca (button) collected ($5.70)
Seat 4: fguil (small blind) folded on the Flop
Seat 5: paramourx (big blind) folded before Flop
Seat 6: ImaPeppaPig folded before Flop (didn't bet)



PokerStars Hand #254401472013:  Hold'em No Limit ($0.50/$1.00 USD) - 2025/01/16 18:14:18 WET [2025/01/16 13:14:18 ET]
Table 'Gawain III' 6-max Seat #4 is the button
Seat 1: AlexPinsk1 ($106.72 in chips) 
Seat 2: Parabelum911 ($115.69 in chips) 
Seat 3: EAroca ($103.20 in chips) 
Seat 4: fguil ($58.35 in chips) 
Seat 5: paramourx ($100 in chips) 
Seat 6: ImaPeppaPig ($100 in chips) 
paramourx: posts small blind $0.50
ImaPeppaPig: posts big blind $1
*** HOLE CARDS ***
AlexPinsk1: folds 
Parabelum911: folds 
EAroca: folds 
fguil: folds 
paramourx: folds 
Uncalled bet ($0.50) returned to ImaPeppaPig
ImaPeppaPig collected $1 from pot
ImaPeppaPig: doesn't show hand 
*** SUMMARY ***
Total pot $1 | Rake $0 
Seat 1: AlexPinsk1 folded before Flop (didn't bet)
Seat 2: Parabelum911 folded before Flop (didn't bet)
Seat 3: EAroca folded before Flop (didn't bet)
Seat 4: fguil (button) folded before Flop (didn't bet)
Seat 5: paramourx (small blind) folded before Flop
Seat 6: ImaPeppaPig (big blind) collected ($1)



PokerStars Hand #254401477303:  Hold'em No Limit ($0.50/$1.00 USD) - 2025/01/16 18:14:37 WET [2025/01/16 13:14:37 ET]
Table 'Gawain III' 6-max Seat #5 is the button
Seat 1: AlexPinsk1 ($106.72 in chips) 
Seat 2: Parabelum911 ($115.69 in chips) 
Seat 3: EAroca ($103.20 in chips) 
Seat 4: fguil ($58.35 in chips) 
Seat 5: paramourx ($100 in chips) 
Seat 6: ImaPeppaPig ($100.50 in chips) 
ImaPeppaPig: posts small blind $0.50
AlexPinsk1: posts big blind $1
*** HOLE CARDS ***
Parabelum911: folds 
EAroca: folds 
fguil: raises $1 to $2
paramourx: folds 
ImaPeppaPig: raises $6 to $8
AlexPinsk1: folds 
fguil: calls $6
*** FLOP *** [Ks 5s Td]
ImaPeppaPig: bets $12.27
fguil: folds 
Uncalled bet ($12.27) returned to ImaPeppaPig
ImaPeppaPig collected $16.15 from pot
ImaPeppaPig: doesn't show hand 
*** SUMMARY ***
Total pot $17 | Rake $0.85 
Board [Ks 5s Td]
Seat 1: AlexPinsk1 (big blind) folded before Flop
Seat 2: Parabelum911 folded before Flop (didn't bet)
Seat 3: EAroca folded before Flop (didn't bet)
Seat 4: fguil folded on the Flop
Seat 5: paramourx (button) folded before Flop (didn't bet)
Seat 6: ImaPeppaPig (small blind) collected ($16.15)



PokerStars Hand #254401484687:  Hold'em No Limit ($0.50/$1.00 USD) - 2025/01/16 18:15:05 WET [2025/01/16 13:15:05 ET]
Table 'Gawain III' 6-max Seat #6 is the button
Seat 1: AlexPinsk1 ($105.72 in chips) 
Seat 2: Parabelum911 ($115.69 in chips) 
Seat 3: EAroca ($103.20 in chips) 
Seat 4: fguil ($50.35 in chips) 
Seat 5: paramourx ($100 in chips) 
Seat 6: ImaPeppaPig ($108.65 in chips) 
AlexPinsk1: posts small blind $0.50
Parabelum911: posts big blind $1
*** HOLE CARDS ***
EAroca: folds 
fguil: folds 
paramourx: folds 
ImaPeppaPig: folds 
AlexPinsk1: folds 
Uncalled bet ($0.50) returned to Parabelum911
Parabelum911 collected $1 from pot
Parabelum911: doesn't show hand 
*** SUMMARY ***
Total pot $1 | Rake $0 
Seat 1: AlexPinsk1 (small blind) folded before Flop
Seat 2: Parabelum911 (big blind) collected ($1)
Seat 3: EAroca folded before Flop (didn't bet)
Seat 4: fguil folded before Flop (didn't bet)
Seat 5: paramourx folded before Flop (didn't bet)
Seat 6: ImaPeppaPig (button) folded before Flop (didn't bet)



PokerStars Hand #254401487604:  Hold'em No Limit ($0.50/$1.00 USD) - 2025/01/16 18:15:16 WET [2025/01/16 13:15:16 ET]
Table 'Gawain III' 6-max Seat #1 is the button
Seat 1: AlexPinsk1 ($105.22 in chips) 
Seat 2: Parabelum911 ($116.19 in chips) 
Seat 3: EAroca ($103.20 in chips) 
Seat 4: fguil ($50.35 in chips) 
Seat 5: paramourx ($100 in chips) 
Seat 6: ImaPeppaPig ($108.65 in chips) 
Parabelum911: posts small blind $0.50
EAroca: posts big blind $1
*** HOLE CARDS ***
fguil: folds 
paramourx: folds 
ImaPeppaPig: raises $1.50 to $2.50
AlexPinsk1: folds 
Parabelum911: folds 
EAroca: folds 
Uncalled bet ($1.50) returned to ImaPeppaPig
ImaPeppaPig collected $2.50 from pot
ImaPeppaPig: doesn't show hand 
*** SUMMARY ***
Total pot $2.50 | Rake $0 
Seat 1: AlexPinsk1 (button) folded before Flop (didn't bet)
Seat 2: Parabelum911 (small blind) folded before Flop
Seat 3: EAroca (big blind) folded before Flop
Seat 4: fguil folded before Flop (didn't bet)
Seat 5: paramourx folded before Flop (didn't bet)
Seat 6: ImaPeppaPig collected ($2.50)



PokerStars Hand #254401494946:  Hold'em No Limit ($0.50/$1.00 USD) - 2025/01/16 18:15:43 WET [2025/01/16 13:15:43 ET]
Table 'Gawain III' 6-max Seat #2 is the button
Seat 1: AlexPinsk1 ($105.22 in chips) 
Seat 2: Parabelum911 ($115.69 in chips) 
Seat 3: EAroca ($102.20 in chips) 
Seat 4: fguil ($50.35 in chips) 
Seat 5: paramourx ($100 in chips) 
Seat 6: ImaPeppaPig ($110.15 in chips) 
EAroca: posts small blind $0.50
fguil: posts big blind $1
*** HOLE CARDS ***
paramourx: folds 
ImaPeppaPig: folds 
AlexPinsk1: raises $1.50 to $2.50
Parabelum911: folds 
EAroca: folds 
fguil: folds 
Uncalled bet ($1.50) returned to AlexPinsk1
AlexPinsk1 collected $2.50 from pot
AlexPinsk1: doesn't show hand 
*** SUMMARY ***
Total pot $2.50 | Rake $0 
Seat 1: AlexPinsk1 collected ($2.50)
Seat 2: Parabelum911 (button) folded before Flop (didn't bet)
Seat 3: EAroca (small blind) folded before Flop
Seat 4: fguil (big blind) folded before Flop
Seat 5: paramourx folded before Flop (didn't bet)
Seat 6: ImaPeppaPig folded before Flop (didn't bet)



PokerStars Hand #254401500597:  Hold'em No Limit ($0.50/$1.00 USD) - 2025/01/16 18:16:04 WET [2025/01/16 13:16:04 ET]
Table 'Gawain III' 6-max Seat #3 is the button
Seat 1: AlexPinsk1 ($106.72 in chips) 
Seat 2: Parabelum911 ($115.69 in chips) 
Seat 3: EAroca ($101.70 in chips) 
Seat 4: fguil ($49.35 in chips) 
Seat 5: paramourx ($100 in chips) 
Seat 6: ImaPeppaPig ($110.15 in chips) 
fguil: posts small blind $0.50
paramourx: posts big blind $1
*** HOLE CARDS ***
ImaPeppaPig: folds 
AlexPinsk1: folds 
Parabelum911: folds 
EAroca: folds 
fguil: calls $0.50
paramourx: checks 
*** FLOP *** [Jh Th 6c]
fguil: bets $1
paramourx: calls $1
*** TURN *** [Jh Th 6c] [8s]
fguil: bets $1
paramourx: calls $1
*** RIVER *** [Jh Th 6c 8s] [5s]
fguil: bets $1
paramourx: calls $1
*** SHOW DOWN ***
fguil: shows [Tc 4c] (a pair of Tens)
paramourx: shows [6h 5d] (two pair, Sixes and Fives)
paramourx collected $7.60 from pot
*** SUMMARY ***
Total pot $8 | Rake $0.40 
Board [Jh Th 6c 8s 5s]
Seat 1: AlexPinsk1 folded before Flop (didn't bet)
Seat 2: Parabelum911 folded before Flop (didn't bet)
Seat 3: EAroca (button) folded before Flop (didn't bet)
Seat 4: fguil (small blind) showed [Tc 4c] and lost with a pair of Tens
Seat 5: paramourx (big blind) showed [6h 5d] and won ($7.60) with two pair, Sixes and Fives
Seat 6: ImaPeppaPig folded before Flop (didn't bet)



PokerStars Hand #254401509436:  Hold'em No Limit ($0.50/$1.00 USD) - 2025/01/16 18:16:37 WET [2025/01/16 13:16:37 ET]
Table 'Gawain III' 6-max Seat #4 is the button
Seat 1: AlexPinsk1 ($106.72 in chips) 
Seat 2: Parabelum911 ($115.69 in chips) 
Seat 3: EAroca ($101.70 in chips) 
Seat 4: fguil ($45.35 in chips) 
Seat 5: paramourx ($103.60 in chips) 
Seat 6: ImaPeppaPig ($110.15 in chips) 
paramourx: posts small blind $0.50
ImaPeppaPig: posts big blind $1
*** HOLE CARDS ***
AlexPinsk1: folds 
Parabelum911: folds 
EAroca: folds 
fguil: folds 
paramourx: folds 
Uncalled bet ($0.50) returned to ImaPeppaPig
ImaPeppaPig collected $1 from pot
ImaPeppaPig: doesn't show hand 
*** SUMMARY ***
Total pot $1 | Rake $0 
Seat 1: AlexPinsk1 folded before Flop (didn't bet)
Seat 2: Parabelum911 folded before Flop (didn't bet)
Seat 3: EAroca folded before Flop (didn't bet)
Seat 4: fguil (button) folded before Flop (didn't bet)
Seat 5: paramourx (small blind) folded before Flop
Seat 6: ImaPeppaPig (big blind) collected ($1)



PokerStars Hand #254401512678:  Hold'em No Limit ($0.50/$1.00 USD) - 2025/01/16 18:16:49 WET [2025/01/16 13:16:49 ET]
Table 'Gawain III' 6-max Seat #5 is the button
Seat 1: AlexPinsk1 ($106.72 in chips) 
Seat 2: Parabelum911 ($115.69 in chips) 
Seat 3: EAroca ($101.70 in chips) 
Seat 4: fguil ($45.35 in chips) 
Seat 5: paramourx ($103.10 in chips) 
Seat 6: ImaPeppaPig ($110.65 in chips) 
ImaPeppaPig: posts small blind $0.50
AlexPinsk1: posts big blind $1
*** HOLE CARDS ***
Parabelum911: folds 
EAroca: folds 
fguil: folds 
paramourx: folds 
ImaPeppaPig: folds 
Uncalled bet ($0.50) returned to AlexPinsk1
AlexPinsk1 collected $1 from pot
AlexPinsk1: doesn't show hand 
*** SUMMARY ***
Total pot $1 | Rake $0 
Seat 1: AlexPinsk1 (big blind) collected ($1)
Seat 2: Parabelum911 folded before Flop (didn't bet)
Seat 3: EAroca folded before Flop (didn't bet)
Seat 4: fguil folded before Flop (didn't bet)
Seat 5: paramourx (button) folded before Flop (didn't bet)
Seat 6: ImaPeppaPig (small blind) folded before Flop



PokerStars Hand #254401758856:  Hold'em No Limit ($0.50/$1.00 USD) - 2025/01/16 18:31:43 WET [2025/01/16 13:31:43 ET]
Table 'Gawain III' 6-max Seat #1 is the button
Seat 1: AlexPinsk1 ($109.17 in chips) 
Seat 2: Parabelum911 ($129.09 in chips) 
Seat 3: EAroca ($106.06 in chips) 
Seat 4: fguil ($62.15 in chips) 
Seat 5: paramourx ($103.90 in chips) 
Seat 6: ImaPeppaPig ($100 in chips) 
Parabelum911: posts small blind $0.50
EAroca: posts big blind $1
*** HOLE CARDS ***
fguil: calls $1
paramourx: folds 
ImaPeppaPig: folds 
AlexPinsk1: raises $2.50 to $3.50
Parabelum911: folds 
EAroca: folds 
fguil: calls $2.50
*** FLOP *** [Jd Kh Qh]
fguil: checks 
AlexPinsk1: bets $4.04
fguil: folds 
Uncalled bet ($4.04) returned to AlexPinsk1
AlexPinsk1 collected $8.08 from pot
AlexPinsk1: doesn't show hand 
*** SUMMARY ***
Total pot $8.50 | Rake $0.42 
Board [Jd Kh Qh]
Seat 1: AlexPinsk1 (button) collected ($8.08)
Seat 2: Parabelum911 (small blind) folded before Flop
Seat 3: EAroca (big blind) folded before Flop
Seat 4: fguil folded on the Flop
Seat 5: paramourx folded before Flop (didn't bet)
Seat 6: ImaPeppaPig folded before Flop (didn't bet)



PokerStars Hand #254401766265:  Hold'em No Limit ($0.50/$1.00 USD) - 2025/01/16 18:32:10 WET [2025/01/16 13:32:10 ET]
Table 'Gawain III' 6-max Seat #2 is the button
Seat 1: AlexPinsk1 ($113.75 in chips) 
Seat 2: Parabelum911 ($128.59 in chips) 
Seat 3: EAroca ($105.06 in chips) 
Seat 4: fguil ($58.65 in chips) 
Seat 5: paramourx ($103.90 in chips) 
Seat 6: ImaPeppaPig ($100 in chips) 
EAroca: posts small blind $0.50
fguil: posts big blind $1
*** HOLE CARDS ***
paramourx: folds 
ImaPeppaPig: folds 
AlexPinsk1: folds 
Parabelum911: folds 
EAroca: folds 
Uncalled bet ($0.50) returned to fguil
fguil collected $1 from pot
fguil: doesn't show hand 
*** SUMMARY ***
Total pot $1 | Rake $0 
Seat 1: AlexPinsk1 folded before Flop (didn't bet)
Seat 2: Parabelum911 (button) folded before Flop (didn't bet)
Seat 3: EAroca (small blind) folded before Flop
Seat 4: fguil (big blind) collected ($1)
Seat 5: paramourx folded before Flop (didn't bet)
Seat 6: ImaPeppaPig folded before Flop (didn't bet)



PokerStars Hand #254401771373:  Hold'em No Limit ($0.50/$1.00 USD) - 2025/01/16 18:32:28 WET [2025/01/16 13:32:28 ET]
Table 'Gawain III' 6-max Seat #3 is the button
Seat 1: AlexPinsk1 ($113.75 in chips) 
Seat 2: Parabelum911 ($128.59 in chips) 
Seat 3: EAroca ($104.56 in chips) 
Seat 4: fguil ($59.15 in chips) 
Seat 5: paramourx ($103.90 in chips) 
Seat 6: ImaPeppaPig ($100 in chips) 
fguil: posts small blind $0.50
paramourx: posts big blind $1
*** HOLE CARDS ***
ImaPeppaPig: folds 
AlexPinsk1: folds 
Parabelum911: folds 
EAroca: raises $1.20 to $2.20
fguil: calls $1.70
paramourx: folds 
*** FLOP *** [9h 8s 4c]
fguil: checks 
EAroca: checks 
*** TURN *** [9h 8s 4c] [6c]
fguil: checks 
EAroca: bets $3.39
fguil: folds 
Uncalled bet ($3.39) returned to EAroca
EAroca collected $5.13 from pot
EAroca: doesn't show hand 
*** SUMMARY ***
Total pot $5.40 | Rake $0.27 
Board [9h 8s 4c 6c]
Seat 1: AlexPinsk1 folded before Flop (didn't bet)
Seat 2: Parabelum911 folded before Flop (didn't bet)
Seat 3: EAroca (button) collected ($5.13)
Seat 4: fguil (small blind) folded on the Turn
Seat 5: paramourx (big blind) folded before Flop
Seat 6: ImaPeppaPig folded before Flop (didn't bet)



PokerStars Hand #254401785125:  Hold'em No Limit ($0.50/$1.00 USD) - 2025/01/16 18:33:17 WET [2025/01/16 13:33:17 ET]
Table 'Gawain III' 6-max Seat #4 is the button
Seat 1: AlexPinsk1 ($113.75 in chips) 
Seat 2: Parabelum911 ($128.59 in chips) 
Seat 3: EAroca ($107.49 in chips) 
Seat 4: fguil ($56.95 in chips) 
Seat 5: paramourx ($102.90 in chips) 
Seat 6: ImaPeppaPig ($100 in chips) 
paramourx: posts small blind $0.50
ImaPeppaPig: posts big blind $1
*** HOLE CARDS ***
AlexPinsk1: folds 
Parabelum911: folds 
EAroca: folds 
fguil: raises $1 to $2
paramourx: folds 
ImaPeppaPig: folds 
Uncalled bet ($1) returned to fguil
fguil collected $2.50 from pot
fguil: doesn't show hand 
*** SUMMARY ***
Total pot $2.50 | Rake $0 
Seat 1: AlexPinsk1 folded before Flop (didn't bet)
Seat 2: Parabelum911 folded before Flop (didn't bet)
Seat 3: EAroca folded before Flop (didn't bet)
Seat 4: fguil (button) collected ($2.50)
Seat 5: paramourx (small blind) folded before Flop
Seat 6: ImaPeppaPig (big blind) folded before Flop



PokerStars Hand #254401789081:  Hold'em No Limit ($0.50/$1.00 USD) - 2025/01/16 18:33:30 WET [2025/01/16 13:33:30 ET]
Table 'Gawain III' 6-max Seat #5 is the button
Seat 1: AlexPinsk1 ($113.75 in chips) 
Seat 2: Parabelum911 ($128.59 in chips) 
Seat 3: EAroca ($107.49 in chips) 
Seat 4: fguil ($58.45 in chips) 
Seat 5: paramourx ($102.40 in chips) 
Seat 6: ImaPeppaPig ($100 in chips) 
ImaPeppaPig: posts small blind $0.50
AlexPinsk1: posts big blind $1
*** HOLE CARDS ***
Parabelum911: folds 
EAroca: raises $1 to $2
fguil: folds 
paramourx: calls $2
ImaPeppaPig: folds 
AlexPinsk1: folds 
*** FLOP *** [6h 4d 3s]
EAroca: checks 
paramourx: bets $1.62
EAroca: folds 
Uncalled bet ($1.62) returned to paramourx
paramourx collected $5.22 from pot
paramourx: doesn't show hand 
*** SUMMARY ***
Total pot $5.50 | Rake $0.28 
Board [6h 4d 3s]
Seat 1: AlexPinsk1 (big blind) folded before Flop
Seat 2: Parabelum911 folded before Flop (didn't bet)
Seat 3: EAroca folded on the Flop
Seat 4: fguil folded before Flop (didn't bet)
Seat 5: paramourx (button) collected ($5.22)
Seat 6: ImaPeppaPig (small blind) folded before Flop



PokerStars Hand #254401809063:  Hold'em No Limit ($0.50/$1.00 USD) - 2025/01/16 18:34:41 WET [2025/01/16 13:34:41 ET]
Table 'Gawain III' 6-max Seat #6 is the button
Seat 1: AlexPinsk1 ($112.75 in chips) 
Seat 2: Parabelum911 ($128.59 in chips) 
Seat 3: EAroca ($105.49 in chips) 
Seat 4: fguil ($58.45 in chips) 
Seat 5: paramourx ($105.62 in chips) 
Seat 6: ImaPeppaPig ($100 in chips) 
AlexPinsk1: posts small blind $0.50
Parabelum911: posts big blind $1
*** HOLE CARDS ***
EAroca: folds 
fguil: calls $1
paramourx: folds 
ImaPeppaPig: folds 
AlexPinsk1: calls $0.50
Parabelum911: checks 
*** FLOP *** [3d Ad Ts]
AlexPinsk1: checks 
Parabelum911: checks 
fguil: bets $1
AlexPinsk1: calls $1
Parabelum911: folds 
*** TURN *** [3d Ad Ts] [4c]
AlexPinsk1: checks 
fguil: bets $1
AlexPinsk1: calls $1
*** RIVER *** [3d Ad Ts 4c] [7c]
AlexPinsk1: checks 
fguil: bets $1
AlexPinsk1: calls $1
*** SHOW DOWN ***
fguil: shows [9s Td] (a pair of Tens)
AlexPinsk1: mucks hand 
fguil collected $8.55 from pot
*** SUMMARY ***
Total pot $9 | Rake $0.45 
Board [3d Ad Ts 4c 7c]
Seat 1: AlexPinsk1 (small blind) mucked
Seat 2: Parabelum911 (big blind) folded on the Flop
Seat 3: EAroca folded before Flop (didn't bet)
Seat 4: fguil showed [9s Td] and won ($8.55) with a pair of Tens
Seat 5: paramourx folded before Flop (didn't bet)
Seat 6: ImaPeppaPig (button) folded before Flop (didn't bet)



PokerStars Hand #254401829021:  Hold'em No Limit ($0.50/$1.00 USD) - 2025/01/16 18:35:51 WET [2025/01/16 13:35:51 ET]
Table 'Gawain III' 6-max Seat #1 is the button
Seat 1: AlexPinsk1 ($108.75 in chips) 
Seat 2: Parabelum911 ($127.59 in chips) 
Seat 3: EAroca ($105.49 in chips) 
Seat 4: fguil ($63 in chips) 
Seat 5: paramourx ($105.62 in chips) 
Seat 6: ImaPeppaPig ($100 in chips) 
Parabelum911: posts small blind $0.50
EAroca: posts big blind $1
*** HOLE CARDS ***
fguil: folds 
paramourx: folds 
ImaPeppaPig: folds 
fguil leaves the table
AlexPinsk1: folds 
michasia joins the table at seat #4 
Parabelum911: folds 
Uncalled bet ($0.50) returned to EAroca
EAroca collected $1 from pot
EAroca: doesn't show hand 
*** SUMMARY ***
Total pot $1 | Rake $0 
Seat 1: AlexPinsk1 (button) folded before Flop (didn't bet)
Seat 2: Parabelum911 (small blind) folded before Flop
Seat 3: EAroca (big blind) collected ($1)
Seat 4: fguil folded before Flop (didn't bet)
Seat 5: paramourx folded before Flop (didn't bet)
Seat 6: ImaPeppaPig folded before Flop (didn't bet)



PokerStars Hand #254401834370:  Hold'em No Limit ($0.50/$1.00 USD) - 2025/01/16 18:36:10 WET [2025/01/16 13:36:10 ET]
Table 'Gawain III' 6-max Seat #2 is the button
Seat 1: AlexPinsk1 ($108.75 in chips) 
Seat 2: Parabelum911 ($127.09 in chips) 
Seat 3: EAroca ($105.99 in chips) 
Seat 4: michasia ($100 in chips) 
Seat 5: paramourx ($105.62 in chips) 
Seat 6: ImaPeppaPig ($100 in chips) 
EAroca: posts small blind $0.50
michasia: posts big blind $1
*** HOLE CARDS ***
paramourx: folds 
ImaPeppaPig: folds 
AlexPinsk1: folds 
Parabelum911: raises $1.10 to $2.10
EAroca: folds 
michasia: raises $8.90 to $11
Parabelum911: folds 
Uncalled bet ($8.90) returned to michasia
michasia collected $4.70 from pot
michasia: doesn't show hand 
*** SUMMARY ***
Total pot $4.70 | Rake $0 
Seat 1: AlexPinsk1 folded before Flop (didn't bet)
Seat 2: Parabelum911 (button) folded before Flop
Seat 3: EAroca (small blind) folded before Flop
Seat 4: michasia (big blind) collected ($4.70)
Seat 5: paramourx folded before Flop (didn't bet)
Seat 6: ImaPeppaPig folded before Flop (didn't bet)



PokerStars Hand #254401841716:  Hold'em No Limit ($0.50/$1.00 USD) - 2025/01/16 18:36:36 WET [2025/01/16 13:36:36 ET]
Table 'Gawain III' 6-max Seat #3 is the button
Seat 1: AlexPinsk1 ($108.75 in chips) 
Seat 2: Parabelum911 ($124.99 in chips) 
Seat 3: EAroca ($105.49 in chips) 
Seat 4: michasia ($102.60 in chips) 
Seat 5: paramourx ($105.62 in chips) 
Seat 6: ImaPeppaPig ($100 in chips) 
michasia: posts small blind $0.50
paramourx: posts big blind $1
*** HOLE CARDS ***
ImaPeppaPig: folds 
AlexPinsk1: folds 
Parabelum911: folds 
EAroca: raises $1.50 to $2.50
michasia: folds 
paramourx: folds 
Uncalled bet ($1.50) returned to EAroca
EAroca collected $2.50 from pot
EAroca: doesn't show hand 
*** SUMMARY ***
Total pot $2.50 | Rake $0 
Seat 1: AlexPinsk1 folded before Flop (didn't bet)
Seat 2: Parabelum911 folded before Flop (didn't bet)
Seat 3: EAroca (button) collected ($2.50)
Seat 4: michasia (small blind) folded before Flop
Seat 5: paramourx (big blind) folded before Flop
Seat 6: ImaPeppaPig folded before Flop (didn't bet)



PokerStars Hand #254401847990:  Hold'em No Limit ($0.50/$1.00 USD) - 2025/01/16 18:36:58 WET [2025/01/16 13:36:58 ET]
Table 'Gawain III' 6-max Seat #4 is the button
Seat 1: AlexPinsk1 ($108.75 in chips) 
Seat 2: Parabelum911 ($124.99 in chips) 
Seat 3: EAroca ($106.99 in chips) 
Seat 4: michasia ($102.10 in chips) 
Seat 5: paramourx ($104.62 in chips) 
Seat 6: ImaPeppaPig ($100 in chips) 
paramourx: posts small blind $0.50
ImaPeppaPig: posts big blind $1
*** HOLE CARDS ***
AlexPinsk1: folds 
Parabelum911: raises $1.50 to $2.50
EAroca: folds 
michasia: folds 
michasia leaves the table
paramourx: folds 
ImaPeppaPig: calls $1.50
*** FLOP *** [6s Kd Qs]
ImaPeppaPig: checks 
Parabelum911: bets $3.92
ImaPeppaPig: folds 
Uncalled bet ($3.92) returned to Parabelum911
Parabelum911 collected $5.22 from pot
Parabelum911: doesn't show hand 
*** SUMMARY ***
Total pot $5.50 | Rake $0.28 
Board [6s Kd Qs]
Seat 1: AlexPinsk1 folded before Flop (didn't bet)
Seat 2: Parabelum911 collected ($5.22)
Seat 3: EAroca folded before Flop (didn't bet)
Seat 4: michasia (button) folded before Flop (didn't bet)
Seat 5: paramourx (small blind) folded before Flop
Seat 6: ImaPeppaPig (big blind) folded on the Flop



PokerStars Hand #254401856557:  Hold'em No Limit ($0.50/$1.00 USD) - 2025/01/16 18:37:29 WET [2025/01/16 13:37:29 ET]
Table 'Gawain III' 6-max Seat #5 is the button
Seat 1: AlexPinsk1 ($108.75 in chips) 
Seat 2: Parabelum911 ($127.71 in chips) 
Seat 3: EAroca ($106.99 in chips) 
Seat 5: paramourx ($104.12 in chips) 
Seat 6: ImaPeppaPig ($100 in chips) 
ImaPeppaPig: posts small blind $0.50
AlexPinsk1: posts big blind $1
*** HOLE CARDS ***
Parabelum911: folds 
EAroca: folds 
paramourx: folds 
ImaPeppaPig: folds 
Uncalled bet ($0.50) returned to AlexPinsk1
AlexPinsk1 collected $1 from pot
AlexPinsk1: doesn't show hand 
*** SUMMARY ***
Total pot $1 | Rake $0 
Seat 1: AlexPinsk1 (big blind) collected ($1)
Seat 2: Parabelum911 folded before Flop (didn't bet)
Seat 3: EAroca folded before Flop (didn't bet)
Seat 5: paramourx (button) folded before Flop (didn't bet)
Seat 6: ImaPeppaPig (small blind) folded before Flop



PokerStars Hand #254401859871:  Hold'em No Limit ($0.50/$1.00 USD) - 2025/01/16 18:37:41 WET [2025/01/16 13:37:41 ET]
Table 'Gawain III' 6-max Seat #6 is the button
Seat 1: AlexPinsk1 ($109.25 in chips) 
Seat 2: Parabelum911 ($127.71 in chips) 
Seat 3: EAroca ($106.99 in chips) 
Seat 5: paramourx ($104.12 in chips) 
Seat 6: ImaPeppaPig ($100 in chips) 
AlexPinsk1: posts small blind $0.50
Parabelum911: posts big blind $1
*** HOLE CARDS ***
EAroca: folds 
paramourx: folds 
ImaPeppaPig: folds 
AlexPinsk1: folds 
Uncalled bet ($0.50) returned to Parabelum911
Parabelum911 collected $1 from pot
Parabelum911: doesn't show hand 
*** SUMMARY ***
Total pot $1 | Rake $0 
Seat 1: AlexPinsk1 (small blind) folded before Flop
Seat 2: Parabelum911 (big blind) collected ($1)
Seat 3: EAroca folded before Flop (didn't bet)
Seat 5: paramourx folded before Flop (didn't bet)
Seat 6: ImaPeppaPig (button) folded before Flop (didn't bet)



PokerStars Hand #254401863877:  Hold'em No Limit ($0.50/$1.00 USD) - 2025/01/16 18:37:55 WET [2025/01/16 13:37:55 ET]
Table 'Gawain III' 6-max Seat #1 is the button
Seat 1: AlexPinsk1 ($108.75 in chips) 
Seat 2: Parabelum911 ($128.21 in chips) 
Seat 3: EAroca ($106.99 in chips) 
Seat 5: paramourx ($104.12 in chips) 
Seat 6: ImaPeppaPig ($100 in chips) 
Parabelum911: posts small blind $0.50
EAroca: posts big blind $1
*** HOLE CARDS ***
paramourx: folds 
ImaPeppaPig: folds 
AlexPinsk1: folds 
Parabelum911: folds 
Uncalled bet ($0.50) returned to EAroca
EAroca collected $1 from pot
EAroca: doesn't show hand 
*** SUMMARY ***
Total pot $1 | Rake $0 
Seat 1: AlexPinsk1 (button) folded before Flop (didn't bet)
Seat 2: Parabelum911 (small blind) folded before Flop
Seat 3: EAroca (big blind) collected ($1)
Seat 5: paramourx folded before Flop (didn't bet)
Seat 6: ImaPeppaPig folded before Flop (didn't bet)



PokerStars Hand #254401867973:  Hold'em No Limit ($0.50/$1.00 USD) - 2025/01/16 18:38:09 WET [2025/01/16 13:38:09 ET]
Table 'Gawain III' 6-max Seat #2 is the button
Seat 1: AlexPinsk1 ($108.75 in chips) 
Seat 2: Parabelum911 ($127.71 in chips) 
Seat 3: EAroca ($107.49 in chips) 
Seat 5: paramourx ($104.12 in chips) 
Seat 6: ImaPeppaPig ($100 in chips) 
EAroca: posts small blind $0.50
paramourx: posts big blind $1
*** HOLE CARDS ***
ImaPeppaPig: folds 
AlexPinsk1: folds 
Parabelum911: raises $1.10 to $2.10
EAroca: folds 
paramourx: folds 
Uncalled bet ($1.10) returned to Parabelum911
Parabelum911 collected $2.50 from pot
Parabelum911: doesn't show hand 
*** SUMMARY ***
Total pot $2.50 | Rake $0 
Seat 1: AlexPinsk1 folded before Flop (didn't bet)
Seat 2: Parabelum911 (button) collected ($2.50)
Seat 3: EAroca (small blind) folded before Flop
Seat 5: paramourx (big blind) folded before Flop
Seat 6: ImaPeppaPig folded before Flop (didn't bet)



PokerStars Hand #254401873940:  Hold'em No Limit ($0.50/$1.00 USD) - 2025/01/16 18:38:30 WET [2025/01/16 13:38:30 ET]
Table 'Gawain III' 6-max Seat #3 is the button
Seat 1: AlexPinsk1 ($108.75 in chips) 
Seat 2: Parabelum911 ($129.21 in chips) 
Seat 3: EAroca ($106.99 in chips) 
Seat 5: paramourx ($103.12 in chips) 
Seat 6: ImaPeppaPig ($100 in chips) 
paramourx: posts small blind $0.50
ImaPeppaPig: posts big blind $1
*** HOLE CARDS ***
AlexPinsk1: folds 
Parabelum911: folds 
EAroca: raises $1.50 to $2.50
paramourx: folds 
ImaPeppaPig: folds 
Uncalled bet ($1.50) returned to EAroca
EAroca collected $2.50 from pot
EAroca: doesn't show hand 
*** SUMMARY ***
Total pot $2.50 | Rake $0 
Seat 1: AlexPinsk1 folded before Flop (didn't bet)
Seat 2: Parabelum911 folded before Flop (didn't bet)
Seat 3: EAroca (button) collected ($2.50)
Seat 5: paramourx (small blind) folded before Flop
Seat 6: ImaPeppaPig (big blind) folded before Flop



PokerStars Hand #254401877113:  Hold'em No Limit ($0.50/$1.00 USD) - 2025/01/16 18:38:41 WET [2025/01/16 13:38:41 ET]
Table 'Gawain III' 6-max Seat #5 is the button
Seat 1: AlexPinsk1 ($108.75 in chips) 
Seat 2: Parabelum911 ($129.21 in chips) 
Seat 3: EAroca ($108.49 in chips) 
Seat 5: paramourx ($102.62 in chips) 
Seat 6: ImaPeppaPig ($100 in chips) 
ImaPeppaPig: posts small blind $0.50
AlexPinsk1: posts big blind $1
*** HOLE CARDS ***
coeeeelho joins the table at seat #4 
Parabelum911: raises $1.50 to $2.50
EAroca: folds 
paramourx: folds 
ImaPeppaPig: folds 
AlexPinsk1: folds 
Uncalled bet ($1.50) returned to Parabelum911
Parabelum911 collected $2.50 from pot
Parabelum911: doesn't show hand 
*** SUMMARY ***
Total pot $2.50 | Rake $0 
Seat 1: AlexPinsk1 (big blind) folded before Flop
Seat 2: Parabelum911 collected ($2.50)
Seat 3: EAroca folded before Flop (didn't bet)
Seat 5: paramourx (button) folded before Flop (didn't bet)
Seat 6: ImaPeppaPig (small blind) folded before Flop



PokerStars Hand #254401880624:  Hold'em No Limit ($0.50/$1.00 USD) - 2025/01/16 18:38:54 WET [2025/01/16 13:38:54 ET]
Table 'Gawain III' 6-max Seat #6 is the button
Seat 4: coeeeelho ($100 in chips) is sitting out
Seat 1: AlexPinsk1 ($107.75 in chips) 
Seat 2: Parabelum911 ($130.71 in chips) 
Seat 3: EAroca ($108.49 in chips) 
Seat 5: paramourx ($102.62 in chips) 
Seat 6: ImaPeppaPig ($100 in chips) 
AlexPinsk1: posts small blind $0.50
Parabelum911: posts big blind $1
coeeeelho: sits out 
*** HOLE CARDS ***
coeeeelho leaves the table
EAroca: folds 
paramourx: folds 
ImaPeppaPig: folds 
AlexPinsk1: raises $2 to $3
Parabelum911: folds 
Uncalled bet ($2) returned to AlexPinsk1
AlexPinsk1 collected $2 from pot
AlexPinsk1: doesn't show hand 
*** SUMMARY ***
Total pot $2 | Rake $0 
Seat 4: coeeeelho
Seat 1: AlexPinsk1 (small blind) collected ($2)
Seat 2: Parabelum911 (big blind) folded before Flop
Seat 3: EAroca folded before Flop (didn't bet)
Seat 5: paramourx folded before Flop (didn't bet)
Seat 6: ImaPeppaPig (button) folded before Flop (didn't bet)



PokerStars Hand #254401885532:  Hold'em No Limit ($0.50/$1.00 USD) - 2025/01/16 18:39:11 WET [2025/01/16 13:39:11 ET]
Table 'Gawain III' 6-max Seat #1 is the button
Seat 3: EAroca ($108.49 in chips) is sitting out
Seat 1: AlexPinsk1 ($108.75 in chips) 
Seat 2: Parabelum911 ($129.71 in chips) 
Seat 5: paramourx ($102.62 in chips) 
Seat 6: ImaPeppaPig ($100 in chips) 
Parabelum911: posts small blind $0.50
EAroca: is sitting out 
paramourx: posts big blind $1
*** HOLE CARDS ***
ImaPeppaPig: folds 
AlexPinsk1: folds 
diegovegeta11 joins the table at seat #4 
Parabelum911: raises $2 to $3
paramourx: folds 
Uncalled bet ($2) returned to Parabelum911
diegovegeta11 is disconnected 
Parabelum911 collected $2 from pot
Parabelum911: doesn't show hand 
*** SUMMARY ***
Total pot $2 | Rake $0 
Seat 3: EAroca
Seat 1: AlexPinsk1 (button) folded before Flop (didn't bet)
Seat 2: Parabelum911 (small blind) collected ($2)
Seat 5: paramourx (big blind) folded before Flop
Seat 6: ImaPeppaPig folded before Flop (didn't bet)



PokerStars Hand #254401888276:  Hold'em No Limit ($0.50/$1.00 USD) - 2025/01/16 18:39:21 WET [2025/01/16 13:39:21 ET]
Table 'Gawain III' 6-max Seat #2 is the button
Seat 3: EAroca ($108.49 in chips) is sitting out
Seat 4: diegovegeta11 ($40 in chips) is sitting out
Seat 1: AlexPinsk1 ($108.75 in chips) 
Seat 2: Parabelum911 ($130.71 in chips) 
Seat 5: paramourx ($101.62 in chips) 
Seat 6: ImaPeppaPig ($100 in chips) 
paramourx: posts small blind $0.50
ImaPeppaPig: posts big blind $1
*** HOLE CARDS ***
AlexPinsk1: raises $1.50 to $2.50
Parabelum911: folds 
paramourx: folds 
ImaPeppaPig: folds 
Uncalled bet ($1.50) returned to AlexPinsk1
AlexPinsk1 collected $2.50 from pot
AlexPinsk1: doesn't show hand 
*** SUMMARY ***
Total pot $2.50 | Rake $0 
Seat 3: EAroca
Seat 4: diegovegeta11
Seat 1: AlexPinsk1 collected ($2.50)
Seat 2: Parabelum911 (button) folded before Flop (didn't bet)
Seat 5: paramourx (small blind) folded before Flop
Seat 6: ImaPeppaPig (big blind) folded before Flop



PokerStars Hand #254401891727:  Hold'em No Limit ($0.50/$1.00 USD) - 2025/01/16 18:39:33 WET [2025/01/16 13:39:33 ET]
Table 'Gawain III' 6-max Seat #5 is the button
Seat 1: AlexPinsk1 ($110.25 in chips) is sitting out
Seat 2: Parabelum911 ($130.71 in chips) is sitting out
Seat 3: EAroca ($108.49 in chips) is sitting out
Seat 4: diegovegeta11 ($40 in chips) 
Seat 5: paramourx ($101.12 in chips) 
Seat 6: ImaPeppaPig ($100 in chips) 
ImaPeppaPig: posts small blind $0.50
AlexPinsk1: is sitting out 
Parabelum911: is sitting out 
diegovegeta11: posts big blind $1
*** HOLE CARDS ***
paramourx: folds 
Parabelum911 leaves the table
ImaPeppaPig: folds 
Uncalled bet ($0.50) returned to diegovegeta11
diegovegeta11 collected $1 from pot
*** SUMMARY ***
Total pot $1 | Rake $0 
Seat 1: AlexPinsk1
Seat 2: Parabelum911
Seat 3: EAroca
Seat 4: diegovegeta11 (big blind) collected ($1)
Seat 5: paramourx (button) folded before Flop (didn't bet)
Seat 6: ImaPeppaPig (small blind) folded before Flop



PokerStars Hand #254401896025:  Hold'em No Limit ($0.50/$1.00 USD) - 2025/01/16 18:39:48 WET [2025/01/16 13:39:48 ET]
Table 'Gawain III' 6-max Seat #6 is the button
Seat 1: AlexPinsk1 ($110.25 in chips) is sitting out
Seat 3: EAroca ($108.49 in chips) is sitting out
Seat 4: diegovegeta11 ($40.50 in chips) 
Seat 5: paramourx ($101.12 in chips) 
Seat 6: ImaPeppaPig ($100 in chips) 
diegovegeta11: posts small blind $0.50
paramourx: posts big blind $1
*** HOLE CARDS ***
z00mba joins the table at seat #2 
ImaPeppaPig: raises $1.50 to $2.50
diegovegeta11: folds 
paramourx: folds 
Uncalled bet ($1.50) returned to ImaPeppaPig
ImaPeppaPig collected $2.50 from pot
ImaPeppaPig: doesn't show hand 
*** SUMMARY ***
Total pot $2.50 | Rake $0 
Seat 1: AlexPinsk1
Seat 3: EAroca
Seat 4: diegovegeta11 (small blind) folded before Flop
Seat 5: paramourx (big blind) folded before Flop
Seat 6: ImaPeppaPig (button) collected ($2.50)



PokerStars Hand #254401899418:  Hold'em No Limit ($0.50/$1.00 USD) - 2025/01/16 18:40:00 WET [2025/01/16 13:40:00 ET]
Table 'Gawain III' 6-max Seat #4 is the button
Seat 1: AlexPinsk1 ($110.25 in chips) is sitting out
Seat 2: z00mba ($100 in chips) is sitting out
Seat 3: EAroca ($108.49 in chips) is sitting out
Seat 4: diegovegeta11 ($40 in chips) 
Seat 5: paramourx ($100.12 in chips) 
Seat 6: ImaPeppaPig ($101.50 in chips) 
paramourx: posts small blind $0.50
ImaPeppaPig: posts big blind $1
EAroca: sits out 
*** HOLE CARDS ***
diegovegeta11: raises $1 to $2
paramourx: folds 
ImaPeppaPig: calls $1
*** FLOP *** [5h 2h Js]
ImaPeppaPig: checks 
diegovegeta11: checks 
*** TURN *** [5h 2h Js] [Ah]
ImaPeppaPig: checks 
diegovegeta11: bets $3.14
ImaPeppaPig: folds 
Uncalled bet ($3.14) returned to diegovegeta11
diegovegeta11 collected $4.28 from pot
*** SUMMARY ***
Total pot $4.50 | Rake $0.22 
Board [5h 2h Js Ah]
Seat 1: AlexPinsk1
Seat 2: z00mba
Seat 3: EAroca
Seat 4: diegovegeta11 (button) collected ($4.28)
Seat 5: paramourx (small blind) folded before Flop
Seat 6: ImaPeppaPig (big blind) folded on the Turn



PokerStars Hand #254401906197:  Hold'em No Limit ($0.50/$1.00 USD) - 2025/01/16 18:40:24 WET [2025/01/16 13:40:24 ET]
Table 'Gawain III' 6-max Seat #5 is the button
Seat 1: AlexPinsk1 ($110.25 in chips) is sitting out
Seat 3: EAroca ($108.49 in chips) is sitting out
Seat 2: z00mba ($100 in chips) 
Seat 4: diegovegeta11 ($42.28 in chips) 
Seat 5: paramourx ($100 in chips) 
Seat 6: ImaPeppaPig ($100 in chips) 
ImaPeppaPig: posts small blind $0.50
z00mba: posts big blind $1
EAroca: sits out 
*** HOLE CARDS ***
diegovegeta11: folds 
paramourx: folds 
ImaPeppaPig: raises $2 to $3
z00mba: calls $2
*** FLOP *** [Tc 5c 3d]
ImaPeppaPig: checks 
z00mba: checks 
*** TURN *** [Tc 5c 3d] [9s]
ImaPeppaPig: bets $2
z00mba: folds 
Uncalled bet ($2) returned to ImaPeppaPig
ImaPeppaPig collected $5.70 from pot
ImaPeppaPig: doesn't show hand 
*** SUMMARY ***
Total pot $6 | Rake $0.30 
Board [Tc 5c 3d 9s]
Seat 1: AlexPinsk1
Seat 3: EAroca
Seat 2: z00mba (big blind) folded on the Turn
Seat 4: diegovegeta11 folded before Flop (didn't bet)
Seat 5: paramourx (button) folded before Flop (didn't bet)
Seat 6: ImaPeppaPig (small blind) collected ($5.70)



PokerStars Hand #254401917104:  Hold'em No Limit ($0.50/$1.00 USD) - 2025/01/16 18:41:03 WET [2025/01/16 13:41:03 ET]
Table 'Gawain III' 6-max Seat #6 is the button
Seat 1: AlexPinsk1 ($110.25 in chips) is sitting out
Seat 2: z00mba ($100 in chips) 
Seat 3: EAroca ($108.49 in chips) 
Seat 4: diegovegeta11 ($42.28 in chips) 
Seat 5: paramourx ($100 in chips) 
Seat 6: ImaPeppaPig ($102.70 in chips) 
z00mba: posts small blind $0.50
EAroca: posts big blind $1
*** HOLE CARDS ***
diegovegeta11: raises $1 to $2
paramourx: folds 
ImaPeppaPig: folds 
z00mba: folds 
EAroca: raises $7 to $9
diegovegeta11: folds 
Uncalled bet ($7) returned to EAroca
EAroca collected $4.50 from pot
EAroca: doesn't show hand 
*** SUMMARY ***
Total pot $4.50 | Rake $0 
Seat 1: AlexPinsk1
Seat 2: z00mba (small blind) folded before Flop
Seat 3: EAroca (big blind) collected ($4.50)
Seat 4: diegovegeta11 folded before Flop
Seat 5: paramourx folded before Flop (didn't bet)
Seat 6: ImaPeppaPig (button) folded before Flop (didn't bet)



PokerStars Hand #254401926240:  Hold'em No Limit ($0.50/$1.00 USD) - 2025/01/16 18:41:35 WET [2025/01/16 13:41:35 ET]
Table 'Gawain III' 6-max Seat #2 is the button
Seat 1: AlexPinsk1 ($110.25 in chips) is sitting out
Seat 2: z00mba ($100 in chips) 
Seat 3: EAroca ($110.99 in chips) 
Seat 4: diegovegeta11 ($40.28 in chips) 
Seat 5: paramourx ($100 in chips) 
Seat 6: ImaPeppaPig ($102.70 in chips) 
EAroca: posts small blind $0.50
diegovegeta11: posts big blind $1
*** HOLE CARDS ***
paramourx: raises $2 to $3
ImaPeppaPig: folds 
z00mba: raises $6 to $9
EAroca: folds 
diegovegeta11: folds 
paramourx: calls $6
*** FLOP *** [9c 4h 6s]
diegovegeta11 leaves the table
paramourx: checks 
z00mba: bets $5.93
paramourx: calls $5.93
*** TURN *** [9c 4h 6s] [3c]
paramourx: checks 
gudrozd joins the table at seat #4 
z00mba: checks 
*** RIVER *** [9c 4h 6s 3c] [Qh]
paramourx: checks 
z00mba: bets $21.75
paramourx: folds 
Uncalled bet ($21.75) returned to z00mba
z00mba collected $29.79 from pot
z00mba: doesn't show hand 
*** SUMMARY ***
Total pot $31.36 | Rake $1.57 
Board [9c 4h 6s 3c Qh]
Seat 1: AlexPinsk1
Seat 2: z00mba (button) collected ($29.79)
Seat 3: EAroca (small blind) folded before Flop
Seat 4: diegovegeta11 (big blind) folded before Flop
Seat 5: paramourx folded on the River
Seat 6: ImaPeppaPig folded before Flop (didn't bet)



PokerStars Hand #254401951543:  Hold'em No Limit ($0.50/$1.00 USD) - 2025/01/16 18:43:05 WET [2025/01/16 13:43:05 ET]
Table 'Gawain III' 6-max Seat #3 is the button
Seat 1: AlexPinsk1 ($110.25 in chips) is sitting out
Seat 4: gudrozd ($100 in chips) is sitting out
Seat 2: z00mba ($114.86 in chips) 
Seat 3: EAroca ($110.49 in chips) 
Seat 5: paramourx ($100 in chips) 
Seat 6: ImaPeppaPig ($102.70 in chips) 
paramourx: posts small blind $0.50
ImaPeppaPig: posts big blind $1
*** HOLE CARDS ***
z00mba: folds 
EAroca: raises $1.50 to $2.50
paramourx: folds 
ImaPeppaPig: folds 
Uncalled bet ($1.50) returned to EAroca
EAroca collected $2.50 from pot
EAroca: doesn't show hand 
*** SUMMARY ***
Total pot $2.50 | Rake $0 
Seat 1: AlexPinsk1
Seat 4: gudrozd
Seat 2: z00mba folded before Flop (didn't bet)
Seat 3: EAroca (button) collected ($2.50)
Seat 5: paramourx (small blind) folded before Flop
Seat 6: ImaPeppaPig (big blind) folded before Flop



PokerStars Hand #254401955600:  Hold'em No Limit ($0.50/$1.00 USD) - 2025/01/16 18:43:19 WET [2025/01/16 13:43:19 ET]
Table 'Gawain III' 6-max Seat #5 is the button
Seat 1: AlexPinsk1 ($110.25 in chips) is sitting out
Seat 2: z00mba ($114.86 in chips) is sitting out
Seat 4: gudrozd ($100 in chips) is sitting out
Seat 3: EAroca ($111.99 in chips) 
Seat 5: paramourx ($100 in chips) 
Seat 6: ImaPeppaPig ($101.70 in chips) 
ImaPeppaPig: posts small blind $0.50
z00mba: is sitting out 
EAroca: posts big blind $1
gudrozd: sits out 
*** HOLE CARDS ***
paramourx: raises $2 to $3
ImaPeppaPig: folds 
AlexPinsk1 leaves the table
EAroca: calls $2
*** FLOP *** [Kh 5c Qs]
EAroca: checks 
paramourx: checks 
*** TURN *** [Kh 5c Qs] [9h]
DL1B joins the table at seat #1 
EAroca: bets $9.27
paramourx: folds 
Uncalled bet ($9.27) returned to EAroca
EAroca collected $6.18 from pot
EAroca: doesn't show hand 
*** SUMMARY ***
Total pot $6.50 | Rake $0.32 
Board [Kh 5c Qs 9h]
Seat 1: AlexPinsk1
Seat 2: z00mba
Seat 4: gudrozd
Seat 3: EAroca (big blind) collected ($6.18)
Seat 5: paramourx (button) folded on the Turn
Seat 6: ImaPeppaPig (small blind) folded before Flop



PokerStars Hand #254401972292:  Hold'em No Limit ($0.50/$1.00 USD) - 2025/01/16 18:44:18 WET [2025/01/16 13:44:18 ET]
Table 'Gawain III' 6-max Seat #6 is the button
Seat 1: DL1B ($100 in chips) is sitting out
Seat 2: z00mba ($114.86 in chips) is sitting out
Seat 3: EAroca ($115.17 in chips) 
Seat 4: gudrozd ($100 in chips) 
Seat 5: paramourx ($100 in chips) 
Seat 6: ImaPeppaPig ($101.20 in chips) 
EAroca: posts small blind $0.50
gudrozd: posts big blind $1
*** HOLE CARDS ***
paramourx: folds 
ImaPeppaPig: folds 
EAroca: raises $2 to $3
gudrozd: raises $6 to $9
EAroca: folds 
Uncalled bet ($6) returned to gudrozd
gudrozd collected $6 from pot
gudrozd: doesn't show hand 
*** SUMMARY ***
Total pot $6 | Rake $0 
Seat 1: DL1B
Seat 2: z00mba
Seat 3: EAroca (small blind) folded before Flop
Seat 4: gudrozd (big blind) collected ($6)
Seat 5: paramourx folded before Flop (didn't bet)
Seat 6: ImaPeppaPig (button) folded before Flop (didn't bet)



PokerStars Hand #254401978249:  Hold'em No Limit ($0.50/$1.00 USD) - 2025/01/16 18:44:39 WET [2025/01/16 13:44:39 ET]
Table 'Gawain III' 6-max Seat #3 is the button
Seat 1: DL1B ($100 in chips) is sitting out
Seat 2: z00mba ($114.86 in chips) is sitting out
Seat 3: EAroca ($112.17 in chips) 
Seat 4: gudrozd ($103 in chips) 
Seat 5: paramourx ($100 in chips) 
Seat 6: ImaPeppaPig ($101.20 in chips) 
gudrozd: posts small blind $0.50
paramourx: posts big blind $1
DL1B: sits out 
z00mba: sits out 
*** HOLE CARDS ***
ImaPeppaPig: folds 
EAroca: folds 
gudrozd: folds 
Uncalled bet ($0.50) returned to paramourx
paramourx collected $1 from pot
paramourx: doesn't show hand 
*** SUMMARY ***
Total pot $1 | Rake $0 
Seat 1: DL1B
Seat 2: z00mba
Seat 3: EAroca (button) folded before Flop (didn't bet)
Seat 4: gudrozd (small blind) folded before Flop
Seat 5: paramourx (big blind) collected ($1)
Seat 6: ImaPeppaPig folded before Flop (didn't bet)



PokerStars Hand #254401980419:  Hold'em No Limit ($0.50/$1.00 USD) - 2025/01/16 18:44:47 WET [2025/01/16 13:44:47 ET]
Table 'Gawain III' 6-max Seat #4 is the button
Seat 1: DL1B ($100 in chips) is sitting out
Seat 2: z00mba ($114.86 in chips) is sitting out
Seat 3: EAroca ($112.17 in chips) 
Seat 4: gudrozd ($102.50 in chips) 
Seat 5: paramourx ($100.50 in chips) 
Seat 6: ImaPeppaPig ($101.20 in chips) 
paramourx: posts small blind $0.50
ImaPeppaPig: posts big blind $1
DL1B: sits out 
z00mba: sits out 
*** HOLE CARDS ***
EAroca: folds 
gudrozd: folds 
paramourx: folds 
Uncalled bet ($0.50) returned to ImaPeppaPig
ImaPeppaPig collected $1 from pot
ImaPeppaPig: doesn't show hand 
*** SUMMARY ***
Total pot $1 | Rake $0 
Seat 1: DL1B
Seat 2: z00mba
Seat 3: EAroca folded before Flop (didn't bet)
Seat 4: gudrozd (button) folded before Flop (didn't bet)
Seat 5: paramourx (small blind) folded before Flop
Seat 6: ImaPeppaPig (big blind) collected ($1)



PokerStars Hand #254401982910:  Hold'em No Limit ($0.50/$1.00 USD) - 2025/01/16 18:44:56 WET [2025/01/16 13:44:56 ET]
Table 'Gawain III' 6-max Seat #5 is the button
Seat 2: z00mba ($114.86 in chips) is sitting out
Seat 1: DL1B ($100 in chips) 
Seat 3: EAroca ($112.17 in chips) 
Seat 4: gudrozd ($102.50 in chips) 
Seat 5: paramourx ($100 in chips) 
Seat 6: ImaPeppaPig ($101.70 in chips) 
ImaPeppaPig: posts small blind $0.50
DL1B: posts big blind $1
z00mba: sits out 
*** HOLE CARDS ***
EAroca: folds 
gudrozd: folds 
paramourx: raises $2 to $3
ImaPeppaPig: folds 
DL1B: raises $9.50 to $12.50
paramourx: folds 
Uncalled bet ($9.50) returned to DL1B
DL1B collected $6.50 from pot
DL1B: doesn't show hand 
*** SUMMARY ***
Total pot $6.50 | Rake $0 
Seat 2: z00mba
Seat 1: DL1B (big blind) collected ($6.50)
Seat 3: EAroca folded before Flop (didn't bet)
Seat 4: gudrozd folded before Flop (didn't bet)
Seat 5: paramourx (button) folded before Flop
Seat 6: ImaPeppaPig (small blind) folded before Flop



PokerStars Hand #254401992475:  Hold'em No Limit ($0.50/$1.00 USD) - 2025/01/16 18:45:29 WET [2025/01/16 13:45:29 ET]
Table 'Gawain III' 6-max Seat #6 is the button
Seat 1: DL1B ($103.50 in chips) 
Seat 2: z00mba ($114.86 in chips) 
Seat 3: EAroca ($112.17 in chips) 
Seat 4: gudrozd ($102.50 in chips) 
Seat 5: paramourx ($100 in chips) 
Seat 6: ImaPeppaPig ($101.20 in chips) 
DL1B: posts small blind $0.50
z00mba: posts big blind $1
*** HOLE CARDS ***
EAroca: folds 
gudrozd: folds 
paramourx: folds 
ImaPeppaPig: raises $1 to $2
DL1B: folds 
z00mba: raises $7.50 to $9.50
ImaPeppaPig: calls $7.50
*** FLOP *** [4h Ts 8h]
z00mba: bets $5.93
ImaPeppaPig: raises $11.07 to $17
z00mba: raises $88.36 to $105.36 and is all-in
ImaPeppaPig: calls $74.70 and is all-in
Uncalled bet ($13.66) returned to z00mba
*** TURN *** [4h Ts 8h] [5d]
*** RIVER *** [4h Ts 8h 5d] [5h]
*** SHOW DOWN ***
z00mba: shows [Kh Ah] (a flush, Ace high)
ImaPeppaPig: shows [Tc Ac] (two pair, Tens and Fives)
z00mba collected $200.40 from pot
*** SUMMARY ***
Total pot $202.90 | Rake $2.50 
Board [4h Ts 8h 5d 5h]
Seat 1: DL1B (small blind) folded before Flop
Seat 2: z00mba (big blind) showed [Kh Ah] and won ($200.40) with a flush, Ace high
Seat 3: EAroca folded before Flop (didn't bet)
Seat 4: gudrozd folded before Flop (didn't bet)
Seat 5: paramourx folded before Flop (didn't bet)
Seat 6: ImaPeppaPig (button) showed [Tc Ac] and lost with two pair, Tens and Fives



PokerStars Hand #254402018364:  Hold'em No Limit ($0.50/$1.00 USD) - 2025/01/16 18:47:01 WET [2025/01/16 13:47:01 ET]
Table 'Gawain III' 6-max Seat #1 is the button
Seat 3: EAroca ($112.17 in chips) is sitting out
Seat 4: gudrozd ($102.50 in chips) is sitting out
Seat 1: DL1B ($103 in chips) 
Seat 2: z00mba ($214.06 in chips) 
Seat 5: paramourx ($100 in chips) 
Seat 6: ImaPeppaPig ($100 in chips) 
z00mba: posts small blind $0.50
EAroca: is sitting out 
gudrozd: is sitting out 
paramourx: posts big blind $1
*** HOLE CARDS ***
ImaPeppaPig: folds 
DL1B: folds 
gudrozd leaves the table
z00mba: folds 
Uncalled bet ($0.50) returned to paramourx
paramourx collected $1 from pot
paramourx: doesn't show hand 
*** SUMMARY ***
Total pot $1 | Rake $0 
Seat 3: EAroca
Seat 4: gudrozd
Seat 1: DL1B (button) folded before Flop (didn't bet)
Seat 2: z00mba (small blind) folded before Flop
Seat 5: paramourx (big blind) collected ($1)
Seat 6: ImaPeppaPig folded before Flop (didn't bet)



PokerStars Hand #254402021382:  Hold'em No Limit ($0.50/$1.00 USD) - 2025/01/16 18:47:11 WET [2025/01/16 13:47:11 ET]
Table 'Gawain III' 6-max Seat #2 is the button
Seat 3: EAroca ($112.17 in chips) is sitting out
Seat 1: DL1B ($103 in chips) 
Seat 2: z00mba ($213.56 in chips) 
Seat 5: paramourx ($100.50 in chips) 
Seat 6: ImaPeppaPig ($100 in chips) 
paramourx: posts small blind $0.50
ImaPeppaPig: posts big blind $1
*** HOLE CARDS ***
Aescul@pius joins the table at seat #4 
DL1B: folds 
z00mba: folds 
paramourx: raises $2 to $3
ImaPeppaPig: folds 
Uncalled bet ($2) returned to paramourx
paramourx collected $2 from pot
paramourx: doesn't show hand 
*** SUMMARY ***
Total pot $2 | Rake $0 
Seat 3: EAroca
Seat 1: DL1B folded before Flop (didn't bet)
Seat 2: z00mba (button) folded before Flop (didn't bet)
Seat 5: paramourx (small blind) collected ($2)
Seat 6: ImaPeppaPig (big blind) folded before Flop



PokerStars Hand #254402025124:  Hold'em No Limit ($0.50/$1.00 USD) - 2025/01/16 18:47:25 WET [2025/01/16 13:47:25 ET]
Table 'Gawain III' 6-max Seat #5 is the button
Seat 1: DL1B ($103 in chips) is sitting out
Seat 2: z00mba ($213.56 in chips) is sitting out
Seat 3: EAroca ($112.17 in chips) is sitting out
Seat 4: Aescul@pius ($100 in chips) 
Seat 5: paramourx ($101.50 in chips) 
Seat 6: ImaPeppaPig ($100 in chips) 
ImaPeppaPig: posts small blind $0.50
DL1B: is sitting out 
z00mba: is sitting out 
Aescul@pius: posts big blind $1
*** HOLE CARDS ***
DL1B leaves the table
paramourx: raises $2 to $3
ImaPeppaPig: folds 
Aescul@pius: folds 
Uncalled bet ($2) returned to paramourx
paramourx collected $2.50 from pot
paramourx: doesn't show hand 
*** SUMMARY ***
Total pot $2.50 | Rake $0 
Seat 1: DL1B
Seat 2: z00mba
Seat 3: EAroca
Seat 4: Aescul@pius (big blind) folded before Flop
Seat 5: paramourx (button) collected ($2.50)
Seat 6: ImaPeppaPig (small blind) folded before Flop



PokerStars Hand #254402028153:  Hold'em No Limit ($0.50/$1.00 USD) - 2025/01/16 18:47:35 WET [2025/01/16 13:47:35 ET]
Table 'Gawain III' 6-max Seat #4 is the button
Seat 2: z00mba ($213.56 in chips) is sitting out
Seat 3: EAroca ($112.17 in chips) is sitting out
Seat 5: paramourx ($103 in chips) is sitting out
Seat 4: Aescul@pius ($100 in chips) 
Seat 6: ImaPeppaPig ($100 in chips) 
Aescul@pius: posts small blind $0.50
paramourx: is sitting out 
ImaPeppaPig: posts big blind $1
*** HOLE CARDS ***
paramourx leaves the table
Aescul@pius: raises $1.50 to $2.50
ImaPeppaPig: calls $1.50
*** FLOP *** [Tc Kh 9c]
ImaPeppaPig: checks 
z00mba leaves the table
Aescul@pius: checks 
*** TURN *** [Tc Kh 9c] [Ac]
ImaPeppaPig: checks 
Aescul@pius: bets $1.57
ImaPeppaPig: raises $10.10 to $11.67
Aescul@pius: folds 
Uncalled bet ($10.10) returned to ImaPeppaPig
ImaPeppaPig collected $7.73 from pot
ImaPeppaPig: doesn't show hand 
*** SUMMARY ***
Total pot $8.14 | Rake $0.41 
Board [Tc Kh 9c Ac]
Seat 2: z00mba
Seat 3: EAroca
Seat 5: paramourx
Seat 4: Aescul@pius (button) (small blind) folded on the Turn
Seat 6: ImaPeppaPig (big blind) collected ($7.73)



PokerStars Hand #254402037267:  Hold'em No Limit ($0.50/$1.00 USD) - 2025/01/16 18:48:08 WET [2025/01/16 13:48:08 ET]
Table 'Gawain III' 6-max Seat #4 is the button
Seat 3: EAroca ($112.17 in chips) 
Seat 4: Aescul@pius ($100 in chips) 
Seat 6: ImaPeppaPig ($103.66 in chips) 
ImaPeppaPig: posts small blind $0.50
EAroca: posts big blind $1
*** HOLE CARDS ***
Aescul@pius: folds 
Aescul@pius leaves the table
ImaPeppaPig: folds 
Uncalled bet ($0.50) returned to EAroca
EAroca collected $1 from pot
EAroca: doesn't show hand 
*** SUMMARY ***
Total pot $1 | Rake $0 
Seat 3: EAroca (big blind) collected ($1)
Seat 4: Aescul@pius (button) folded before Flop (didn't bet)
Seat 6: ImaPeppaPig (small blind) folded before Flop



PokerStars Hand #254402040128:  Hold'em No Limit ($0.50/$1.00 USD) - 2025/01/16 18:48:18 WET [2025/01/16 13:48:18 ET]
Table 'Gawain III' 6-max Seat #3 is the button
Seat 3: EAroca ($112.67 in chips) 
Seat 6: ImaPeppaPig ($103.16 in chips) 
EAroca: posts small blind $0.50
ImaPeppaPig: posts big blind $1
*** HOLE CARDS ***
EAroca: raises $1.30 to $2.30
ImaPeppaPig: calls $1.30
*** FLOP *** [Kd 4c Kh]
ImaPeppaPig: checks 
EAroca: bets $1.75
ImaPeppaPig: calls $1.75
*** TURN *** [Kd 4c Kh] [6d]
ImaPeppaPig: checks 
EAroca: bets $7.70
ImaPeppaPig: calls $7.70
*** RIVER *** [Kd 4c Kh 6d] [8d]
ImaPeppaPig: checks 
EAroca: bets $16.88
ImaPeppaPig: raises $72.01 to $88.89
EAroca: calls $72.01
*** SHOW DOWN ***
ImaPeppaPig: shows [7d Ad] (a flush, Ace high)
EAroca: mucks hand 
ImaPeppaPig collected $200.28 from pot
*** SUMMARY ***
Total pot $201.28 | Rake $1 
Board [Kd 4c Kh 6d 8d]
Seat 3: EAroca (button) (small blind) mucked
Seat 6: ImaPeppaPig (big blind) showed [7d Ad] and won ($200.28) with a flush, Ace high



PokerStars Hand #254402073965:  Hold'em No Limit ($0.50/$1.00 USD) - 2025/01/16 18:50:20 WET [2025/01/16 13:50:20 ET]
Table 'Gawain III' 6-max Seat #6 is the button
Seat 3: EAroca ($100 in chips) 
Seat 6: ImaPeppaPig ($202.80 in chips) 
ImaPeppaPig: posts small blind $0.50
EAroca: posts big blind $1
*** HOLE CARDS ***
ImaPeppaPig: raises $1.50 to $2.50
EAroca: calls $1.50
*** FLOP *** [3s Jh Ad]
EAroca: checks 
ImaPeppaPig: bets $1.47
EAroca: folds 
Uncalled bet ($1.47) returned to ImaPeppaPig
ImaPeppaPig collected $4.75 from pot
ImaPeppaPig: doesn't show hand 
*** SUMMARY ***
Total pot $5 | Rake $0.25 
Board [3s Jh Ad]
Seat 3: EAroca (big blind) folded on the Flop
Seat 6: ImaPeppaPig (button) (small blind) collected ($4.75)



PokerStars Hand #254402085037:  Hold'em No Limit ($0.50/$1.00 USD) - 2025/01/16 18:51:00 WET [2025/01/16 13:51:00 ET]
Table 'Gawain III' 6-max Seat #3 is the button
Seat 3: EAroca ($100 in chips) 
Seat 6: ImaPeppaPig ($205.05 in chips) 
EAroca: posts small blind $0.50
ImaPeppaPig: posts big blind $1
*** HOLE CARDS ***
EAroca: raises $1.30 to $2.30
ImaPeppaPig: folds 
Uncalled bet ($1.30) returned to EAroca
EAroca collected $2 from pot
EAroca: doesn't show hand 
*** SUMMARY ***
Total pot $2 | Rake $0 
Seat 3: EAroca (button) (small blind) collected ($2)
Seat 6: ImaPeppaPig (big blind) folded before Flop



