PokerStars Hand #254396291701:  Hold'em No Limit ($0.50/$1.00 USD) - 2025/01/16 11:13:29 WET [2025/01/16 6:13:29 ET]
Table 'Stereoskopia III' 6-max Seat #3 is the button
Seat 6: Pippa83 ($100 in chips) is sitting out
Seat 1: Pon4uk.ua ($100 in chips) 
Seat 2: jockywils100 ($46.75 in chips) 
Seat 3: leozannigato ($93.50 in chips) 
Seat 4: anakine1974 ($33.26 in chips) 
Seat 5: Burlica2013 ($100 in chips) 
anakine1974: posts small blind $0.50
Burlica2013: posts big blind $1
Pippa83: sits out 
*** HOLE CARDS ***
Pon4uk.ua: folds 
jockywils100: folds 
leozannigato has timed out
leozannigato: folds 
anakine1974: folds 
Uncalled bet ($0.50) returned to Burlica2013
Burlica2013 collected $1 from pot
Burlica2013: doesn't show hand 
*** SUMMARY ***
Total pot $1 | Rake $0 
Seat 6: Pippa83
Seat 1: Pon4uk.ua folded before Flop (didn't bet)
Seat 2: jockywils100 folded before Flop (didn't bet)
Seat 3: leozannigato (button) folded before Flop (didn't bet)
Seat 4: anakine1974 (small blind) folded before Flop
Seat 5: Burlica2013 (big blind) collected ($1)



PokerStars Hand #254396295830:  Hold'em No Limit ($0.50/$1.00 USD) - 2025/01/16 11:14:04 WET [2025/01/16 6:14:04 ET]
Table 'Stereoskopia III' 6-max Seat #4 is the button
Seat 3: leozannigato ($93.50 in chips) is sitting out
Seat 1: Pon4uk.ua ($100 in chips) 
Seat 2: jockywils100 ($46.75 in chips) 
Seat 4: anakine1974 ($32.76 in chips) 
Seat 5: Burlica2013 ($100.50 in chips) 
Seat 6: Pippa83 ($100 in chips) 
Burlica2013: posts small blind $0.50
Pippa83: posts big blind $1
*** HOLE CARDS ***
Pon4uk.ua: folds 
jockywils100: calls $1
anakine1974: folds 
Burlica2013: raises $3 to $4
Pippa83: folds 
jockywils100: calls $3
*** FLOP *** [9c 4s Td]
Burlica2013: checks 
jockywils100: checks 
*** TURN *** [9c 4s Td] [Qd]
Burlica2013: checks 
jockywils100: bets $5.28
Burlica2013: calls $5.28
*** RIVER *** [9c 4s Td Qd] [5h]
Burlica2013: checks 
jockywils100: checks 
*** SHOW DOWN ***
Burlica2013: shows [Th Ac] (a pair of Tens)
jockywils100: mucks hand 
Burlica2013 collected $18.58 from pot
*** SUMMARY ***
Total pot $19.56 | Rake $0.98 
Board [9c 4s Td Qd 5h]
Seat 3: leozannigato
Seat 1: Pon4uk.ua folded before Flop (didn't bet)
Seat 2: jockywils100 mucked
Seat 4: anakine1974 (button) folded before Flop (didn't bet)
Seat 5: Burlica2013 (small blind) showed [Th Ac] and won ($18.58) with a pair of Tens
Seat 6: Pippa83 (big blind) folded before Flop



PokerStars Hand #254396303520:  Hold'em No Limit ($0.50/$1.00 USD) - 2025/01/16 11:15:08 WET [2025/01/16 6:15:08 ET]
Table 'Stereoskopia III' 6-max Seat #5 is the button
Seat 1: Pon4uk.ua ($100 in chips) 
Seat 2: jockywils100 ($37.47 in chips) 
Seat 3: leozannigato ($93.50 in chips) 
Seat 4: anakine1974 ($32.76 in chips) 
Seat 5: Burlica2013 ($109.80 in chips) 
Seat 6: Pippa83 ($100 in chips) 
Pippa83: posts small blind $0.50
Pon4uk.ua: posts big blind $1
*** HOLE CARDS ***
jockywils100: folds 
leozannigato: raises $92.50 to $93.50 and is all-in
anakine1974: folds 
Burlica2013: folds 
Pippa83: folds 
Pon4uk.ua: folds 
Uncalled bet ($92.50) returned to leozannigato
leozannigato collected $2.50 from pot
*** SUMMARY ***
Total pot $2.50 | Rake $0 
Seat 1: Pon4uk.ua (big blind) folded before Flop
Seat 2: jockywils100 folded before Flop (didn't bet)
Seat 3: leozannigato collected ($2.50)
Seat 4: anakine1974 folded before Flop (didn't bet)
Seat 5: Burlica2013 (button) folded before Flop (didn't bet)
Seat 6: Pippa83 (small blind) folded before Flop



PokerStars Hand #254396306021:  Hold'em No Limit ($0.50/$1.00 USD) - 2025/01/16 11:15:29 WET [2025/01/16 6:15:29 ET]
Table 'Stereoskopia III' 6-max Seat #6 is the button
Seat 1: Pon4uk.ua ($100 in chips) 
Seat 2: jockywils100 ($37.47 in chips) 
Seat 3: leozannigato ($95 in chips) 
Seat 4: anakine1974 ($32.76 in chips) 
Seat 5: Burlica2013 ($109.80 in chips) 
Seat 6: Pippa83 ($100 in chips) 
Pon4uk.ua: posts small blind $0.50
jockywils100: posts big blind $1
*** HOLE CARDS ***
leozannigato: raises $9 to $10
anakine1974: folds 
Burlica2013: folds 
Pippa83: folds 
Pon4uk.ua: folds 
jockywils100: raises $27.47 to $37.47 and is all-in
leozannigato: calls $27.47
*** FLOP *** [3h 3d Th]
*** TURN *** [3h 3d Th] [Qc]
*** RIVER *** [3h 3d Th Qc] [4h]
*** SHOW DOWN ***
jockywils100: shows [Qd Qh] (a full house, Queens full of Threes)
leozannigato: shows [Tc Jh] (two pair, Tens and Threes)
jockywils100 collected $72.94 from pot
*** SUMMARY ***
Total pot $75.44 | Rake $2.50 
Board [3h 3d Th Qc 4h]
Seat 1: Pon4uk.ua (small blind) folded before Flop
Seat 2: jockywils100 (big blind) showed [Qd Qh] and won ($72.94) with a full house, Queens full of Threes
Seat 3: leozannigato showed [Tc Jh] and lost with two pair, Tens and Threes
Seat 4: anakine1974 folded before Flop (didn't bet)
Seat 5: Burlica2013 folded before Flop (didn't bet)
Seat 6: Pippa83 (button) folded before Flop (didn't bet)



PokerStars Hand #254396309856:  Hold'em No Limit ($0.50/$1.00 USD) - 2025/01/16 11:16:00 WET [2025/01/16 6:16:00 ET]
Table 'Stereoskopia III' 6-max Seat #1 is the button
Seat 1: Pon4uk.ua ($100 in chips) 
Seat 2: jockywils100 ($72.94 in chips) 
Seat 3: leozannigato ($57.53 in chips) 
Seat 4: anakine1974 ($32.76 in chips) 
Seat 5: Burlica2013 ($109.80 in chips) 
Seat 6: Pippa83 ($100 in chips) 
jockywils100: posts small blind $0.50
leozannigato: posts big blind $1
*** HOLE CARDS ***
anakine1974: folds 
Burlica2013: raises $1.20 to $2.20
Pippa83: calls $2.20
Pon4uk.ua: folds 
jockywils100: folds 
leozannigato: raises $4.20 to $6.40
Burlica2013: calls $4.20
Pippa83: calls $4.20
*** FLOP *** [Js 7d Ah]
leozannigato: checks 
Burlica2013: checks 
Pippa83: checks 
*** TURN *** [Js 7d Ah] [5d]
leozannigato: checks 
Burlica2013: bets $9.36
Pippa83: folds 
leozannigato: calls $9.36
*** RIVER *** [Js 7d Ah 5d] [Qs]
leozannigato: bets $41.77 and is all-in
Burlica2013: folds 
Uncalled bet ($41.77) returned to leozannigato
leozannigato collected $36.50 from pot
*** SUMMARY ***
Total pot $38.42 | Rake $1.92 
Board [Js 7d Ah 5d Qs]
Seat 1: Pon4uk.ua (button) folded before Flop (didn't bet)
Seat 2: jockywils100 (small blind) folded before Flop
Seat 3: leozannigato (big blind) collected ($36.50)
Seat 4: anakine1974 folded before Flop (didn't bet)
Seat 5: Burlica2013 folded on the River
Seat 6: Pippa83 folded on the Turn



PokerStars Hand #254396325567:  Hold'em No Limit ($0.50/$1.00 USD) - 2025/01/16 11:18:08 WET [2025/01/16 6:18:08 ET]
Table 'Stereoskopia III' 6-max Seat #2 is the button
Seat 1: Pon4uk.ua ($100 in chips) 
Seat 2: jockywils100 ($72.44 in chips) 
Seat 3: leozannigato ($78.27 in chips) 
Seat 4: anakine1974 ($32.76 in chips) 
Seat 5: Burlica2013 ($100 in chips) 
Seat 6: Pippa83 ($100 in chips) 
leozannigato: posts small blind $0.50
anakine1974: posts big blind $1
*** HOLE CARDS ***
Burlica2013: folds 
Pippa83: folds 
Pon4uk.ua has timed out
Pon4uk.ua: folds 
jockywils100: folds 
leozannigato: raises $77.27 to $78.27 and is all-in
anakine1974: folds 
Uncalled bet ($77.27) returned to leozannigato
leozannigato collected $2 from pot
*** SUMMARY ***
Total pot $2 | Rake $0 
Seat 1: Pon4uk.ua folded before Flop (didn't bet)
Seat 2: jockywils100 (button) folded before Flop (didn't bet)
Seat 3: leozannigato (small blind) collected ($2)
Seat 4: anakine1974 (big blind) folded before Flop
Seat 5: Burlica2013 folded before Flop (didn't bet)
Seat 6: Pippa83 folded before Flop (didn't bet)



PokerStars Hand #254396328559:  Hold'em No Limit ($0.50/$1.00 USD) - 2025/01/16 11:18:33 WET [2025/01/16 6:18:33 ET]
Table 'Stereoskopia III' 6-max Seat #3 is the button
Seat 1: Pon4uk.ua ($100 in chips) 
Seat 2: jockywils100 ($72.44 in chips) 
Seat 3: leozannigato ($79.27 in chips) 
Seat 4: anakine1974 ($31.76 in chips) 
Seat 5: Burlica2013 ($100 in chips) 
Seat 6: Pippa83 ($100 in chips) 
anakine1974: posts small blind $0.50
Burlica2013: posts big blind $1
*** HOLE CARDS ***
Pippa83: folds 
Pon4uk.ua: raises $1 to $2
jockywils100: folds 
leozannigato: raises $77.27 to $79.27 and is all-in
anakine1974: folds 
Burlica2013: folds 
Pon4uk.ua: folds 
Uncalled bet ($77.27) returned to leozannigato
leozannigato collected $5.50 from pot
*** SUMMARY ***
Total pot $5.50 | Rake $0 
Seat 1: Pon4uk.ua folded before Flop
Seat 2: jockywils100 folded before Flop (didn't bet)
Seat 3: leozannigato (button) collected ($5.50)
Seat 4: anakine1974 (small blind) folded before Flop
Seat 5: Burlica2013 (big blind) folded before Flop
Seat 6: Pippa83 folded before Flop (didn't bet)



PokerStars Hand #254396332010:  Hold'em No Limit ($0.50/$1.00 USD) - 2025/01/16 11:19:01 WET [2025/01/16 6:19:01 ET]
Table 'Stereoskopia III' 6-max Seat #4 is the button
Seat 1: Pon4uk.ua ($100 in chips) 
Seat 2: jockywils100 ($72.44 in chips) 
Seat 3: leozannigato ($82.77 in chips) 
Seat 4: anakine1974 ($31.26 in chips) 
Seat 5: Burlica2013 ($100 in chips) 
Seat 6: Pippa83 ($100 in chips) 
Burlica2013: posts small blind $0.50
Pippa83: posts big blind $1
*** HOLE CARDS ***
Pon4uk.ua has timed out
Pon4uk.ua: folds 
jockywils100: folds 
leozannigato: folds 
leozannigato leaves the table
anakine1974: folds 
Burlica2013: folds 
Uncalled bet ($0.50) returned to Pippa83
Pippa83 collected $1 from pot
Pippa83: doesn't show hand 
*** SUMMARY ***
Total pot $1 | Rake $0 
Seat 1: Pon4uk.ua folded before Flop (didn't bet)
Seat 2: jockywils100 folded before Flop (didn't bet)
Seat 3: leozannigato folded before Flop (didn't bet)
Seat 4: anakine1974 (button) folded before Flop (didn't bet)
Seat 5: Burlica2013 (small blind) folded before Flop
Seat 6: Pippa83 (big blind) collected ($1)



PokerStars Hand #254396334264:  Hold'em No Limit ($0.50/$1.00 USD) - 2025/01/16 11:19:19 WET [2025/01/16 6:19:19 ET]
Table 'Stereoskopia III' 6-max Seat #5 is the button
Seat 1: Pon4uk.ua ($100 in chips) 
Seat 2: jockywils100 ($72.44 in chips) 
Seat 4: anakine1974 ($31.26 in chips) 
Seat 5: Burlica2013 ($100 in chips) 
Seat 6: Pippa83 ($100.50 in chips) 
Pippa83: posts small blind $0.50
Pon4uk.ua: posts big blind $1
*** HOLE CARDS ***
jockywils100: folds 
anakine1974: folds 
Burlica2013: folds 
Pippa83: folds 
Uncalled bet ($0.50) returned to Pon4uk.ua
Pon4uk.ua collected $1 from pot
Pon4uk.ua: doesn't show hand 
*** SUMMARY ***
Total pot $1 | Rake $0 
Seat 1: Pon4uk.ua (big blind) collected ($1)
Seat 2: jockywils100 folded before Flop (didn't bet)
Seat 4: anakine1974 folded before Flop (didn't bet)
Seat 5: Burlica2013 (button) folded before Flop (didn't bet)
Seat 6: Pippa83 (small blind) folded before Flop



PokerStars Hand #254396335392:  Hold'em No Limit ($0.50/$1.00 USD) - 2025/01/16 11:19:28 WET [2025/01/16 6:19:28 ET]
Table 'Stereoskopia III' 6-max Seat #6 is the button
Seat 1: Pon4uk.ua ($100.50 in chips) 
Seat 2: jockywils100 ($72.44 in chips) 
Seat 4: anakine1974 ($31.26 in chips) 
Seat 5: Burlica2013 ($100 in chips) 
Seat 6: Pippa83 ($100 in chips) 
Pon4uk.ua: posts small blind $0.50
jockywils100: posts big blind $1
*** HOLE CARDS ***
anakine1974: folds 
Burlica2013: folds 
Pippa83: raises $1.50 to $2.50
Pon4uk.ua: folds 
jockywils100: raises $5.50 to $8
Pippa83: folds 
Uncalled bet ($5.50) returned to jockywils100
jockywils100 collected $5.50 from pot
*** SUMMARY ***
Total pot $5.50 | Rake $0 
Seat 1: Pon4uk.ua (small blind) folded before Flop
Seat 2: jockywils100 (big blind) collected ($5.50)
Seat 4: anakine1974 folded before Flop (didn't bet)
Seat 5: Burlica2013 folded before Flop (didn't bet)
Seat 6: Pippa83 (button) folded before Flop



PokerStars Hand #254396337979:  Hold'em No Limit ($0.50/$1.00 USD) - 2025/01/16 11:19:49 WET [2025/01/16 6:19:49 ET]
Table 'Stereoskopia III' 6-max Seat #1 is the button
Seat 1: Pon4uk.ua ($100 in chips) 
Seat 2: jockywils100 ($75.44 in chips) 
Seat 4: anakine1974 ($31.26 in chips) 
Seat 5: Burlica2013 ($100 in chips) 
Seat 6: Pippa83 ($100 in chips) 
jockywils100: posts small blind $0.50
anakine1974: posts big blind $1
*** HOLE CARDS ***
Burlica2013: raises $1.20 to $2.20
Pippa83: folds 
Pon4uk.ua: folds 
jockywils100: folds 
anakine1974: folds 
Uncalled bet ($1.20) returned to Burlica2013
Burlica2013 collected $2.50 from pot
Burlica2013: doesn't show hand 
*** SUMMARY ***
Total pot $2.50 | Rake $0 
Seat 1: Pon4uk.ua (button) folded before Flop (didn't bet)
Seat 2: jockywils100 (small blind) folded before Flop
Seat 4: anakine1974 (big blind) folded before Flop
Seat 5: Burlica2013 collected ($2.50)
Seat 6: Pippa83 folded before Flop (didn't bet)



PokerStars Hand #254396339258:  Hold'em No Limit ($0.50/$1.00 USD) - 2025/01/16 11:19:59 WET [2025/01/16 6:19:59 ET]
Table 'Stereoskopia III' 6-max Seat #2 is the button
Seat 1: Pon4uk.ua ($100 in chips) 
Seat 2: jockywils100 ($74.94 in chips) 
Seat 4: anakine1974 ($30.26 in chips) 
Seat 5: Burlica2013 ($101.50 in chips) 
Seat 6: Pippa83 ($100 in chips) 
anakine1974: posts small blind $0.50
Burlica2013: posts big blind $1
*** HOLE CARDS ***
Pippa83: folds 
Pon4uk.ua: folds 
coeeeelho joins the table at seat #3 
jockywils100: calls $1
anakine1974: folds 
Burlica2013: raises $3 to $4
jockywils100: calls $3
*** FLOP *** [Qd Jd 2d]
Burlica2013: bets $2.02
jockywils100: raises $4.02 to $6.04
Burlica2013: calls $4.02
*** TURN *** [Qd Jd 2d] [4h]
Burlica2013: checks 
jockywils100: checks 
*** RIVER *** [Qd Jd 2d 4h] [7h]
Burlica2013: checks 
jockywils100: bets $13.78
Burlica2013: folds 
Uncalled bet ($13.78) returned to jockywils100
jockywils100 collected $19.55 from pot
*** SUMMARY ***
Total pot $20.58 | Rake $1.03 
Board [Qd Jd 2d 4h 7h]
Seat 1: Pon4uk.ua folded before Flop (didn't bet)
Seat 2: jockywils100 (button) collected ($19.55)
Seat 4: anakine1974 (small blind) folded before Flop
Seat 5: Burlica2013 (big blind) folded on the River
Seat 6: Pippa83 folded before Flop (didn't bet)



PokerStars Hand #254396347760:  Hold'em No Limit ($0.50/$1.00 USD) - 2025/01/16 11:21:08 WET [2025/01/16 6:21:08 ET]
Table 'Stereoskopia III' 6-max Seat #4 is the button
Seat 3: coeeeelho ($100 in chips) is sitting out
Seat 1: Pon4uk.ua ($100 in chips) 
Seat 2: jockywils100 ($84.45 in chips) 
Seat 4: anakine1974 ($29.76 in chips) 
Seat 5: Burlica2013 ($100 in chips) 
Seat 6: Pippa83 ($100 in chips) 
Burlica2013: posts small blind $0.50
Pippa83: posts big blind $1
coeeeelho: sits out 
*** HOLE CARDS ***
Pon4uk.ua: raises $1 to $2
jockywils100: folds 
anakine1974: folds 
Burlica2013: folds 
Pippa83: folds 
Uncalled bet ($1) returned to Pon4uk.ua
Pon4uk.ua collected $2.50 from pot
Pon4uk.ua: doesn't show hand 
*** SUMMARY ***
Total pot $2.50 | Rake $0 
Seat 3: coeeeelho
Seat 1: Pon4uk.ua collected ($2.50)
Seat 2: jockywils100 folded before Flop (didn't bet)
Seat 4: anakine1974 (button) folded before Flop (didn't bet)
Seat 5: Burlica2013 (small blind) folded before Flop
Seat 6: Pippa83 (big blind) folded before Flop



PokerStars Hand #254396349958:  Hold'em No Limit ($0.50/$1.00 USD) - 2025/01/16 11:21:26 WET [2025/01/16 6:21:26 ET]
Table 'Stereoskopia III' 6-max Seat #5 is the button
Seat 3: coeeeelho ($100 in chips) is sitting out
Seat 1: Pon4uk.ua ($101.50 in chips) 
Seat 2: jockywils100 ($84.45 in chips) 
Seat 4: anakine1974 ($29.76 in chips) 
Seat 5: Burlica2013 ($100 in chips) 
Seat 6: Pippa83 ($100 in chips) 
Pippa83: posts small blind $0.50
Pon4uk.ua: posts big blind $1
coeeeelho: sits out 
*** HOLE CARDS ***
jockywils100: raises $1 to $2
anakine1974: folds 
Burlica2013: folds 
Pippa83: calls $1.50
Pon4uk.ua: calls $1
*** FLOP *** [Jd 2h 8d]
Pippa83: checks 
Pon4uk.ua: checks 
jockywils100: bets $3
Pippa83: folds 
Pon4uk.ua: calls $3
*** TURN *** [Jd 2h 8d] [Js]
Pon4uk.ua: bets $3.76
jockywils100: calls $3.76
*** RIVER *** [Jd 2h 8d Js] [Kc]
Pon4uk.ua: bets $5.12
jockywils100: raises $5.12 to $10.24
Pon4uk.ua: folds 
Uncalled bet ($5.12) returned to jockywils100
jockywils100 collected $28.27 from pot
*** SUMMARY ***
Total pot $29.76 | Rake $1.49 
Board [Jd 2h 8d Js Kc]
Seat 3: coeeeelho
Seat 1: Pon4uk.ua (big blind) folded on the River
Seat 2: jockywils100 collected ($28.27)
Seat 4: anakine1974 folded before Flop (didn't bet)
Seat 5: Burlica2013 (button) folded before Flop (didn't bet)
Seat 6: Pippa83 (small blind) folded on the Flop



PokerStars Hand #254396359761:  Hold'em No Limit ($0.50/$1.00 USD) - 2025/01/16 11:22:46 WET [2025/01/16 6:22:46 ET]
Table 'Stereoskopia III' 6-max Seat #6 is the button
Seat 3: coeeeelho ($100 in chips) is sitting out
Seat 1: Pon4uk.ua ($100 in chips) 
Seat 2: jockywils100 ($98.84 in chips) 
Seat 4: anakine1974 ($29.76 in chips) 
Seat 5: Burlica2013 ($100 in chips) 
Seat 6: Pippa83 ($100 in chips) 
Pon4uk.ua: posts small blind $0.50
jockywils100: posts big blind $1
coeeeelho: sits out 
*** HOLE CARDS ***
anakine1974: folds 
Burlica2013: folds 
Pippa83: raises $1.50 to $2.50
Pon4uk.ua: folds 
jockywils100: calls $1.50
*** FLOP *** [8d Ad 9c]
jockywils100: bets $2
Pippa83: calls $2
*** TURN *** [8d Ad 9c] [Jh]
jockywils100: checks 
Pippa83: bets $6.77
jockywils100: folds 
Uncalled bet ($6.77) returned to Pippa83
Pippa83 collected $9.02 from pot
Pippa83: doesn't show hand 
*** SUMMARY ***
Total pot $9.50 | Rake $0.48 
Board [8d Ad 9c Jh]
Seat 3: coeeeelho
Seat 1: Pon4uk.ua (small blind) folded before Flop
Seat 2: jockywils100 (big blind) folded on the Turn
Seat 4: anakine1974 folded before Flop (didn't bet)
Seat 5: Burlica2013 folded before Flop (didn't bet)
Seat 6: Pippa83 (button) collected ($9.02)



PokerStars Hand #254396366353:  Hold'em No Limit ($0.50/$1.00 USD) - 2025/01/16 11:23:40 WET [2025/01/16 6:23:40 ET]
Table 'Stereoskopia III' 6-max Seat #1 is the button
Seat 1: Pon4uk.ua ($100 in chips) 
Seat 2: jockywils100 ($94.34 in chips) 
Seat 3: coeeeelho ($100 in chips) 
Seat 4: anakine1974 ($29.76 in chips) 
Seat 5: Burlica2013 ($100 in chips) 
Seat 6: Pippa83 ($104.52 in chips) 
jockywils100: posts small blind $0.50
coeeeelho: posts big blind $1
*** HOLE CARDS ***
anakine1974: folds 
Burlica2013: folds 
Pippa83: raises $1.50 to $2.50
Pon4uk.ua: folds 
jockywils100: calls $2
coeeeelho: folds 
*** FLOP *** [3h 8d Qc]
jockywils100: checks 
Pippa83: bets $1.14
jockywils100: calls $1.14
*** TURN *** [3h 8d Qc] [2c]
jockywils100: checks 
Pippa83: checks 
*** RIVER *** [3h 8d Qc 2c] [7c]
jockywils100: bets $4.94
Burlica2013 leaves the table
Pippa83: folds 
Uncalled bet ($4.94) returned to jockywils100
jockywils100 collected $7.87 from pot
*** SUMMARY ***
Total pot $8.28 | Rake $0.41 
Board [3h 8d Qc 2c 7c]
Seat 1: Pon4uk.ua (button) folded before Flop (didn't bet)
Seat 2: jockywils100 (small blind) collected ($7.87)
Seat 3: coeeeelho (big blind) folded before Flop
Seat 4: anakine1974 folded before Flop (didn't bet)
Seat 5: Burlica2013 folded before Flop (didn't bet)
Seat 6: Pippa83 folded on the River



PokerStars Hand #254396371816:  Hold'em No Limit ($0.50/$1.00 USD) - 2025/01/16 11:24:24 WET [2025/01/16 6:24:24 ET]
Table 'Stereoskopia III' 6-max Seat #2 is the button
Seat 1: Pon4uk.ua ($100 in chips) 
Seat 2: jockywils100 ($98.57 in chips) 
Seat 3: coeeeelho ($100 in chips) 
Seat 4: anakine1974 ($29.76 in chips) 
Seat 6: Pippa83 ($100.88 in chips) 
coeeeelho: posts small blind $0.50
anakine1974: posts big blind $1
*** HOLE CARDS ***
Pippa83: folds 
Pon4uk.ua: folds 
jockywils100: raises $1 to $2
Trojanovich joins the table at seat #5 
coeeeelho: folds 
anakine1974: folds 
Uncalled bet ($1) returned to jockywils100
jockywils100 collected $2.50 from pot
*** SUMMARY ***
Total pot $2.50 | Rake $0 
Seat 1: Pon4uk.ua folded before Flop (didn't bet)
Seat 2: jockywils100 (button) collected ($2.50)
Seat 3: coeeeelho (small blind) folded before Flop
Seat 4: anakine1974 (big blind) folded before Flop
Seat 6: Pippa83 folded before Flop (didn't bet)



PokerStars Hand #254396373560:  Hold'em No Limit ($0.50/$1.00 USD) - 2025/01/16 11:24:38 WET [2025/01/16 6:24:38 ET]
Table 'Stereoskopia III' 6-max Seat #3 is the button
Seat 1: Pon4uk.ua ($100 in chips) 
Seat 2: jockywils100 ($100.07 in chips) 
Seat 3: coeeeelho ($100 in chips) 
Seat 4: anakine1974 ($28.76 in chips) 
Seat 5: Trojanovich ($100 in chips) 
Seat 6: Pippa83 ($100.88 in chips) 
anakine1974: posts small blind $0.50
Trojanovich: posts big blind $1
*** HOLE CARDS ***
Pippa83: raises $1.20 to $2.20
Pon4uk.ua: folds 
jockywils100: folds 
coeeeelho: folds 
anakine1974: folds 
Trojanovich: calls $1.20
*** FLOP *** [Ts 9d 7h]
Trojanovich: checks 
Pippa83: checks 
*** TURN *** [Ts 9d 7h] [Ks]
Trojanovich: checks 
Pippa83: checks 
*** RIVER *** [Ts 9d 7h Ks] [Jd]
Trojanovich: checks 
Pippa83: bets $1.54
Trojanovich: calls $1.54
*** SHOW DOWN ***
Pippa83: shows [Kc Js] (two pair, Kings and Jacks)
Trojanovich: shows [Kh Jc] (two pair, Kings and Jacks)
Trojanovich collected $3.79 from pot
Pippa83 collected $3.79 from pot
*** SUMMARY ***
Total pot $7.98 | Rake $0.40 
Board [Ts 9d 7h Ks Jd]
Seat 1: Pon4uk.ua folded before Flop (didn't bet)
Seat 2: jockywils100 folded before Flop (didn't bet)
Seat 3: coeeeelho (button) folded before Flop (didn't bet)
Seat 4: anakine1974 (small blind) folded before Flop
Seat 5: Trojanovich (big blind) showed [Kh Jc] and won ($3.79) with two pair, Kings and Jacks
Seat 6: Pippa83 showed [Kc Js] and won ($3.79) with two pair, Kings and Jacks



PokerStars Hand #254396380763:  Hold'em No Limit ($0.50/$1.00 USD) - 2025/01/16 11:25:37 WET [2025/01/16 6:25:37 ET]
Table 'Stereoskopia III' 6-max Seat #4 is the button
Seat 1: Pon4uk.ua ($100 in chips) 
Seat 2: jockywils100 ($100.07 in chips) 
Seat 3: coeeeelho ($100 in chips) 
Seat 4: anakine1974 ($28.26 in chips) 
Seat 5: Trojanovich ($100.05 in chips) 
Seat 6: Pippa83 ($100.93 in chips) 
Trojanovich: posts small blind $0.50
Pippa83: posts big blind $1
*** HOLE CARDS ***
Pon4uk.ua: folds 
jockywils100: folds 
coeeeelho: folds 
anakine1974: raises $2 to $3
Trojanovich: folds 
Pippa83: calls $2
*** FLOP *** [8c Qd Js]
Pippa83: checks 
anakine1974: bets $3.09
Pippa83: folds 
Uncalled bet ($3.09) returned to anakine1974
anakine1974 collected $6.18 from pot
*** SUMMARY ***
Total pot $6.50 | Rake $0.32 
Board [8c Qd Js]
Seat 1: Pon4uk.ua folded before Flop (didn't bet)
Seat 2: jockywils100 folded before Flop (didn't bet)
Seat 3: coeeeelho folded before Flop (didn't bet)
Seat 4: anakine1974 (button) collected ($6.18)
Seat 5: Trojanovich (small blind) folded before Flop
Seat 6: Pippa83 (big blind) folded on the Flop



PokerStars Hand #254396384278:  Hold'em No Limit ($0.50/$1.00 USD) - 2025/01/16 11:26:05 WET [2025/01/16 6:26:05 ET]
Table 'Stereoskopia III' 6-max Seat #5 is the button
Seat 1: Pon4uk.ua ($100 in chips) 
Seat 2: jockywils100 ($100.07 in chips) 
Seat 3: coeeeelho ($100 in chips) 
Seat 4: anakine1974 ($31.44 in chips) 
Seat 5: Trojanovich ($100 in chips) 
Seat 6: Pippa83 ($100 in chips) 
Pippa83: posts small blind $0.50
Pon4uk.ua: posts big blind $1
*** HOLE CARDS ***
jockywils100: folds 
coeeeelho: raises $1.20 to $2.20
anakine1974: calls $2.20
Trojanovich: calls $2.20
Pippa83: folds 
Pon4uk.ua: folds 
*** FLOP *** [Td Tc Qh]
coeeeelho: checks 
anakine1974: checks 
Trojanovich: checks 
*** TURN *** [Td Tc Qh] [Jc]
coeeeelho: bets $5.78
anakine1974: folds 
Trojanovich: folds 
Uncalled bet ($5.78) returned to coeeeelho
coeeeelho collected $7.70 from pot
*** SUMMARY ***
Total pot $8.10 | Rake $0.40 
Board [Td Tc Qh Jc]
Seat 1: Pon4uk.ua (big blind) folded before Flop
Seat 2: jockywils100 folded before Flop (didn't bet)
Seat 3: coeeeelho collected ($7.70)
Seat 4: anakine1974 folded on the Turn
Seat 5: Trojanovich (button) folded on the Turn
Seat 6: Pippa83 (small blind) folded before Flop



PokerStars Hand #254396390250:  Hold'em No Limit ($0.50/$1.00 USD) - 2025/01/16 11:26:54 WET [2025/01/16 6:26:54 ET]
Table 'Stereoskopia III' 6-max Seat #6 is the button
Seat 1: Pon4uk.ua ($100 in chips) 
Seat 2: jockywils100 ($100.07 in chips) 
Seat 3: coeeeelho ($105.50 in chips) 
Seat 4: anakine1974 ($29.24 in chips) 
Seat 5: Trojanovich ($100 in chips) 
Seat 6: Pippa83 ($100 in chips) 
Pon4uk.ua: posts small blind $0.50
jockywils100: posts big blind $1
*** HOLE CARDS ***
coeeeelho: raises $1.20 to $2.20
anakine1974: folds 
Trojanovich: folds 
Pippa83: folds 
Pon4uk.ua: folds 
jockywils100: folds 
Uncalled bet ($1.20) returned to coeeeelho
coeeeelho collected $2.50 from pot
*** SUMMARY ***
Total pot $2.50 | Rake $0 
Seat 1: Pon4uk.ua (small blind) folded before Flop
Seat 2: jockywils100 (big blind) folded before Flop
Seat 3: coeeeelho collected ($2.50)
Seat 4: anakine1974 folded before Flop (didn't bet)
Seat 5: Trojanovich folded before Flop (didn't bet)
Seat 6: Pippa83 (button) folded before Flop (didn't bet)



PokerStars Hand #254396393118:  Hold'em No Limit ($0.50/$1.00 USD) - 2025/01/16 11:27:18 WET [2025/01/16 6:27:18 ET]
Table 'Stereoskopia III' 6-max Seat #1 is the button
Seat 1: Pon4uk.ua ($100 in chips) 
Seat 2: jockywils100 ($99.07 in chips) 
Seat 3: coeeeelho ($107 in chips) 
Seat 4: anakine1974 ($29.24 in chips) 
Seat 5: Trojanovich ($100 in chips) 
Seat 6: Pippa83 ($100 in chips) 
jockywils100: posts small blind $0.50
coeeeelho: posts big blind $1
*** HOLE CARDS ***
anakine1974: folds 
Trojanovich: raises $1.50 to $2.50
Pippa83: folds 
Pon4uk.ua: folds 
jockywils100: folds 
coeeeelho: folds 
Uncalled bet ($1.50) returned to Trojanovich
Trojanovich collected $2.50 from pot
Trojanovich: doesn't show hand 
*** SUMMARY ***
Total pot $2.50 | Rake $0 
Seat 1: Pon4uk.ua (button) folded before Flop (didn't bet)
Seat 2: jockywils100 (small blind) folded before Flop
Seat 3: coeeeelho (big blind) folded before Flop
Seat 4: anakine1974 folded before Flop (didn't bet)
Seat 5: Trojanovich collected ($2.50)
Seat 6: Pippa83 folded before Flop (didn't bet)



PokerStars Hand #254396395435:  Hold'em No Limit ($0.50/$1.00 USD) - 2025/01/16 11:27:37 WET [2025/01/16 6:27:37 ET]
Table 'Stereoskopia III' 6-max Seat #2 is the button
Seat 1: Pon4uk.ua ($100 in chips) 
Seat 2: jockywils100 ($98.57 in chips) 
Seat 3: coeeeelho ($106 in chips) 
Seat 4: anakine1974 ($29.24 in chips) 
Seat 5: Trojanovich ($101.50 in chips) 
Seat 6: Pippa83 ($100 in chips) 
coeeeelho: posts small blind $0.50
anakine1974: posts big blind $1
*** HOLE CARDS ***
Trojanovich: folds 
Pippa83: folds 
Pon4uk.ua: folds 
jockywils100: calls $1
coeeeelho: folds 
anakine1974: checks 
*** FLOP *** [Qs 2s Qc]
anakine1974: checks 
jockywils100: checks 
*** TURN *** [Qs 2s Qc] [3d]
anakine1974: bets $2.38
jockywils100: calls $2.38
*** RIVER *** [Qs 2s Qc 3d] [3h]
anakine1974: checks 
jockywils100: checks 
*** SHOW DOWN ***
anakine1974: shows [8s 7c] (two pair, Queens and Threes)
jockywils100: shows [Ts 9s] (two pair, Queens and Threes - Ten kicker)
jockywils100 collected $6.90 from pot
*** SUMMARY ***
Total pot $7.26 | Rake $0.36 
Board [Qs 2s Qc 3d 3h]
Seat 1: Pon4uk.ua folded before Flop (didn't bet)
Seat 2: jockywils100 (button) showed [Ts 9s] and won ($6.90) with two pair, Queens and Threes
Seat 3: coeeeelho (small blind) folded before Flop
Seat 4: anakine1974 (big blind) showed [8s 7c] and lost with two pair, Queens and Threes
Seat 5: Trojanovich folded before Flop (didn't bet)
Seat 6: Pippa83 folded before Flop (didn't bet)



PokerStars Hand #254396399325:  Hold'em No Limit ($0.50/$1.00 USD) - 2025/01/16 11:28:09 WET [2025/01/16 6:28:09 ET]
Table 'Stereoskopia III' 6-max Seat #3 is the button
Seat 1: Pon4uk.ua ($100 in chips) 
Seat 2: jockywils100 ($102.09 in chips) 
Seat 3: coeeeelho ($105.50 in chips) 
Seat 4: anakine1974 ($25.86 in chips) 
Seat 5: Trojanovich ($101.50 in chips) 
Seat 6: Pippa83 ($100 in chips) 
anakine1974: posts small blind $0.50
Trojanovich: posts big blind $1
*** HOLE CARDS ***
Pippa83: folds 
Pon4uk.ua: raises $1 to $2
jockywils100: raises $3 to $5
coeeeelho: folds 
anakine1974: calls $4.50
Trojanovich: folds 
Pon4uk.ua: calls $3
*** FLOP *** [Kc 3h 4c]
anakine1974: checks 
Pon4uk.ua: checks 
jockywils100: checks 
*** TURN *** [Kc 3h 4c] [6h]
anakine1974: bets $7.60
Pon4uk.ua: raises $13.40 to $21
jockywils100: folds 
anakine1974: calls $13.26 and is all-in
Uncalled bet ($0.14) returned to Pon4uk.ua
*** RIVER *** [Kc 3h 4c 6h] [Qs]
*** SHOW DOWN ***
anakine1974: shows [Kd Qd] (two pair, Kings and Queens)
Pon4uk.ua: shows [Jh Ks] (a pair of Kings)
anakine1974 cashed out the hand for $50.43 | Cash Out Fee $1.03
*** SUMMARY ***
Total pot $57.72 | Rake $2.50 
Board [Kc 3h 4c 6h Qs]
Seat 1: Pon4uk.ua showed [Jh Ks] and lost with a pair of Kings
Seat 2: jockywils100 folded on the Turn
Seat 3: coeeeelho (button) folded before Flop (didn't bet)
Seat 4: anakine1974 (small blind) showed [Kd Qd] and won ($55.22) with two pair, Kings and Queens (pot not awarded as player cashed out)
Seat 5: Trojanovich (big blind) folded before Flop
Seat 6: Pippa83 folded before Flop (didn't bet)



PokerStars Hand #254396413236:  Hold'em No Limit ($0.50/$1.00 USD) - 2025/01/16 11:30:01 WET [2025/01/16 6:30:01 ET]
Table 'Stereoskopia III' 6-max Seat #6 is the button
Seat 1: Pon4uk.ua ($150.43 in chips) 
Seat 2: jockywils100 ($96.47 in chips) 
Seat 3: coeeeelho ($105.50 in chips) 
Seat 4: anakine1974 ($17.86 in chips) 
Seat 5: Trojanovich ($100 in chips) 
Seat 6: Pippa83 ($100 in chips) 
Pon4uk.ua: posts small blind $0.50
jockywils100: posts big blind $1
*** HOLE CARDS ***
coeeeelho: folds 
anakine1974: folds 
Trojanovich: folds 
Pippa83: raises $1.50 to $2.50
Pon4uk.ua: folds 
jockywils100: calls $1.50
*** FLOP *** [2s 5h 3c]
jockywils100: checks 
Pippa83: checks 
*** TURN *** [2s 5h 3c] [2c]
jockywils100: checks 
Pippa83: checks 
*** RIVER *** [2s 5h 3c 2c] [8d]
jockywils100: bets $4.61
Pippa83: folds 
Uncalled bet ($4.61) returned to jockywils100
jockywils100 collected $5.22 from pot
*** SUMMARY ***
Total pot $5.50 | Rake $0.28 
Board [2s 5h 3c 2c 8d]
Seat 1: Pon4uk.ua (small blind) folded before Flop
Seat 2: jockywils100 (big blind) collected ($5.22)
Seat 3: coeeeelho folded before Flop (didn't bet)
Seat 4: anakine1974 folded before Flop (didn't bet)
Seat 5: Trojanovich folded before Flop (didn't bet)
Seat 6: Pippa83 (button) folded on the River



PokerStars Hand #254396419527:  Hold'em No Limit ($0.50/$1.00 USD) - 2025/01/16 11:30:52 WET [2025/01/16 6:30:52 ET]
Table 'Stereoskopia III' 6-max Seat #2 is the button
Seat 1: Pon4uk.ua ($149.93 in chips) is sitting out
Seat 2: jockywils100 ($99.19 in chips) 
Seat 3: coeeeelho ($105.50 in chips) 
Seat 4: anakine1974 ($17.86 in chips) 
Seat 5: Trojanovich ($100 in chips) 
Seat 6: Pippa83 ($100 in chips) 
coeeeelho: posts small blind $0.50
anakine1974: posts big blind $1
*** HOLE CARDS ***
Trojanovich: folds 
Pippa83: folds 
jockywils100: folds 
coeeeelho: raises $2 to $3
anakine1974: calls $2
*** FLOP *** [6d 8s Ac]
coeeeelho: bets $1.43
anakine1974: calls $1.43
*** TURN *** [6d 8s Ac] [3s]
coeeeelho: checks 
anakine1974: checks 
*** RIVER *** [6d 8s Ac 3s] [7d]
coeeeelho: bets $2
anakine1974: raises $11.43 to $13.43 and is all-in
coeeeelho: folds 
Uncalled bet ($11.43) returned to anakine1974
anakine1974 collected $12.22 from pot
*** SUMMARY ***
Total pot $12.86 | Rake $0.64 
Board [6d 8s Ac 3s 7d]
Seat 1: Pon4uk.ua
Seat 2: jockywils100 (button) folded before Flop (didn't bet)
Seat 3: coeeeelho (small blind) folded on the River
Seat 4: anakine1974 (big blind) collected ($12.22)
Seat 5: Trojanovich folded before Flop (didn't bet)
Seat 6: Pippa83 folded before Flop (didn't bet)



PokerStars Hand #254396429149:  Hold'em No Limit ($0.50/$1.00 USD) - 2025/01/16 11:32:09 WET [2025/01/16 6:32:09 ET]
Table 'Stereoskopia III' 6-max Seat #3 is the button
Seat 1: Pon4uk.ua ($149.93 in chips) 
Seat 2: jockywils100 ($99.19 in chips) 
Seat 3: coeeeelho ($100 in chips) 
Seat 4: anakine1974 ($23.65 in chips) 
Seat 5: Trojanovich ($100 in chips) 
Seat 6: Pippa83 ($100 in chips) 
anakine1974: posts small blind $0.50
Trojanovich: posts big blind $1
*** HOLE CARDS ***
Pippa83: folds 
Pon4uk.ua: raises $1 to $2
jockywils100: folds 
coeeeelho: folds 
anakine1974: folds 
Trojanovich: raises $9 to $11
Pon4uk.ua: calls $9
*** FLOP *** [9h Ks Th]
Trojanovich: bets $7.06
Pon4uk.ua: calls $7.06
*** TURN *** [9h Ks Th] [6s]
Trojanovich: checks 
Pon4uk.ua: checks 
*** RIVER *** [9h Ks Th 6s] [6h]
Trojanovich: checks 
Pon4uk.ua: checks 
*** SHOW DOWN ***
Trojanovich: shows [Kh Kc] (a full house, Kings full of Sixes)
Pon4uk.ua: mucks hand 
Trojanovich collected $34.79 from pot
*** SUMMARY ***
Total pot $36.62 | Rake $1.83 
Board [9h Ks Th 6s 6h]
Seat 1: Pon4uk.ua mucked
Seat 2: jockywils100 folded before Flop (didn't bet)
Seat 3: coeeeelho (button) folded before Flop (didn't bet)
Seat 4: anakine1974 (small blind) folded before Flop
Seat 5: Trojanovich (big blind) showed [Kh Kc] and won ($34.79) with a full house, Kings full of Sixes
Seat 6: Pippa83 folded before Flop (didn't bet)



PokerStars Hand #254396442710:  Hold'em No Limit ($0.50/$1.00 USD) - 2025/01/16 11:33:56 WET [2025/01/16 6:33:56 ET]
Table 'Stereoskopia III' 6-max Seat #4 is the button
Seat 1: Pon4uk.ua ($131.87 in chips) 
Seat 2: jockywils100 ($99.19 in chips) 
Seat 3: coeeeelho ($100 in chips) 
Seat 4: anakine1974 ($23.15 in chips) 
Seat 5: Trojanovich ($116.73 in chips) 
Seat 6: Pippa83 ($100 in chips) 
Trojanovich: posts small blind $0.50
Pippa83: posts big blind $1
*** HOLE CARDS ***
Pon4uk.ua: folds 
jockywils100: folds 
coeeeelho: folds 
anakine1974: folds 
Trojanovich: raises $2 to $3
Pippa83: raises $6 to $9
Trojanovich: folds 
Uncalled bet ($6) returned to Pippa83
Pippa83 collected $6 from pot
Pippa83: doesn't show hand 
*** SUMMARY ***
Total pot $6 | Rake $0 
Seat 1: Pon4uk.ua folded before Flop (didn't bet)
Seat 2: jockywils100 folded before Flop (didn't bet)
Seat 3: coeeeelho folded before Flop (didn't bet)
Seat 4: anakine1974 (button) folded before Flop (didn't bet)
Seat 5: Trojanovich (small blind) folded before Flop
Seat 6: Pippa83 (big blind) collected ($6)



PokerStars Hand #254396446365:  Hold'em No Limit ($0.50/$1.00 USD) - 2025/01/16 11:34:23 WET [2025/01/16 6:34:23 ET]
Table 'Stereoskopia III' 6-max Seat #5 is the button
Seat 1: Pon4uk.ua ($131.87 in chips) 
Seat 2: jockywils100 ($99.19 in chips) 
Seat 3: coeeeelho ($100 in chips) 
Seat 4: anakine1974 ($23.15 in chips) 
Seat 5: Trojanovich ($113.73 in chips) 
Seat 6: Pippa83 ($103 in chips) 
Pippa83: posts small blind $0.50
Pon4uk.ua: posts big blind $1
*** HOLE CARDS ***
jockywils100: raises $1 to $2
coeeeelho: folds 
anakine1974: folds 
Trojanovich: folds 
Pippa83: folds 
Pon4uk.ua: calls $1
*** FLOP *** [6h 3d 7d]
Pon4uk.ua: checks 
jockywils100: checks 
*** TURN *** [6h 3d 7d] [9c]
Pon4uk.ua: bets $2.14
jockywils100: calls $2.14
*** RIVER *** [6h 3d 7d 9c] [Qc]
Pon4uk.ua: checks 
jockywils100: bets $10.34
Pon4uk.ua: folds 
Uncalled bet ($10.34) returned to jockywils100
jockywils100 collected $8.34 from pot
*** SUMMARY ***
Total pot $8.78 | Rake $0.44 
Board [6h 3d 7d 9c Qc]
Seat 1: Pon4uk.ua (big blind) folded on the River
Seat 2: jockywils100 collected ($8.34)
Seat 3: coeeeelho folded before Flop (didn't bet)
Seat 4: anakine1974 folded before Flop (didn't bet)
Seat 5: Trojanovich (button) folded before Flop (didn't bet)
Seat 6: Pippa83 (small blind) folded before Flop



PokerStars Hand #254396451256:  Hold'em No Limit ($0.50/$1.00 USD) - 2025/01/16 11:35:01 WET [2025/01/16 6:35:01 ET]
Table 'Stereoskopia III' 6-max Seat #6 is the button
Seat 1: Pon4uk.ua ($127.73 in chips) 
Seat 2: jockywils100 ($103.39 in chips) 
Seat 3: coeeeelho ($100 in chips) 
Seat 4: anakine1974 ($23.15 in chips) 
Seat 5: Trojanovich ($113.73 in chips) 
Seat 6: Pippa83 ($102.50 in chips) 
Pon4uk.ua: posts small blind $0.50
jockywils100: posts big blind $1
*** HOLE CARDS ***
coeeeelho: raises $1.20 to $2.20
anakine1974: calls $2.20
Trojanovich: calls $2.20
Pippa83: raises $9.80 to $12
Pon4uk.ua: folds 
jockywils100: folds 
coeeeelho: folds 
anakine1974: folds 
Trojanovich: folds 
Uncalled bet ($9.80) returned to Pippa83
Pippa83 collected $10.30 from pot
Pippa83: doesn't show hand 
*** SUMMARY ***
Total pot $10.30 | Rake $0 
Seat 1: Pon4uk.ua (small blind) folded before Flop
Seat 2: jockywils100 (big blind) folded before Flop
Seat 3: coeeeelho folded before Flop
Seat 4: anakine1974 folded before Flop
Seat 5: Trojanovich folded before Flop
Seat 6: Pippa83 (button) collected ($10.30)



PokerStars Hand #254396455595:  Hold'em No Limit ($0.50/$1.00 USD) - 2025/01/16 11:35:35 WET [2025/01/16 6:35:35 ET]
Table 'Stereoskopia III' 6-max Seat #1 is the button
Seat 1: Pon4uk.ua ($127.23 in chips) 
Seat 2: jockywils100 ($102.39 in chips) 
Seat 3: coeeeelho ($100 in chips) 
Seat 4: anakine1974 ($20.95 in chips) 
Seat 5: Trojanovich ($111.53 in chips) 
Seat 6: Pippa83 ($110.60 in chips) 
jockywils100: posts small blind $0.50
coeeeelho: posts big blind $1
*** HOLE CARDS ***
anakine1974: folds 
Trojanovich: folds 
Pippa83: folds 
Pon4uk.ua: folds 
jockywils100: raises $1 to $2
coeeeelho: folds 
Uncalled bet ($1) returned to jockywils100
jockywils100 collected $2 from pot
*** SUMMARY ***
Total pot $2 | Rake $0 
Seat 1: Pon4uk.ua (button) folded before Flop (didn't bet)
Seat 2: jockywils100 (small blind) collected ($2)
Seat 3: coeeeelho (big blind) folded before Flop
Seat 4: anakine1974 folded before Flop (didn't bet)
Seat 5: Trojanovich folded before Flop (didn't bet)
Seat 6: Pippa83 folded before Flop (didn't bet)



PokerStars Hand #254396457197:  Hold'em No Limit ($0.50/$1.00 USD) - 2025/01/16 11:35:46 WET [2025/01/16 6:35:46 ET]
Table 'Stereoskopia III' 6-max Seat #2 is the button
Seat 1: Pon4uk.ua ($127.23 in chips) 
Seat 2: jockywils100 ($103.39 in chips) 
Seat 3: coeeeelho ($100 in chips) 
Seat 4: anakine1974 ($20.95 in chips) 
Seat 5: Trojanovich ($111.53 in chips) 
Seat 6: Pippa83 ($110.60 in chips) 
coeeeelho: posts small blind $0.50
anakine1974: posts big blind $1
*** HOLE CARDS ***
Trojanovich: folds 
Pippa83: folds 
Pon4uk.ua: folds 
jockywils100: folds 
coeeeelho: folds 
Uncalled bet ($0.50) returned to anakine1974
anakine1974 collected $1 from pot
*** SUMMARY ***
Total pot $1 | Rake $0 
Seat 1: Pon4uk.ua folded before Flop (didn't bet)
Seat 2: jockywils100 (button) folded before Flop (didn't bet)
Seat 3: coeeeelho (small blind) folded before Flop
Seat 4: anakine1974 (big blind) collected ($1)
Seat 5: Trojanovich folded before Flop (didn't bet)
Seat 6: Pippa83 folded before Flop (didn't bet)



PokerStars Hand #254396459222:  Hold'em No Limit ($0.50/$1.00 USD) - 2025/01/16 11:36:02 WET [2025/01/16 6:36:02 ET]
Table 'Stereoskopia III' 6-max Seat #3 is the button
Seat 1: Pon4uk.ua ($127.23 in chips) 
Seat 2: jockywils100 ($103.39 in chips) 
Seat 3: coeeeelho ($100 in chips) 
Seat 4: anakine1974 ($21.45 in chips) 
Seat 5: Trojanovich ($111.53 in chips) 
Seat 6: Pippa83 ($110.60 in chips) 
anakine1974: posts small blind $0.50
Trojanovich: posts big blind $1
*** HOLE CARDS ***
Pippa83: raises $1.20 to $2.20
Pon4uk.ua: folds 
jockywils100: folds 
coeeeelho: folds 
anakine1974: calls $1.70
Trojanovich: folds 
*** FLOP *** [9d 7d 3c]
anakine1974: checks 
Pippa83: bets $1.50
anakine1974: calls $1.50
*** TURN *** [9d 7d 3c] [5s]
anakine1974: checks 
Pippa83: bets $5.99
anakine1974: folds 
Uncalled bet ($5.99) returned to Pippa83
Pippa83 collected $7.98 from pot
Pippa83: doesn't show hand 
*** SUMMARY ***
Total pot $8.40 | Rake $0.42 
Board [9d 7d 3c 5s]
Seat 1: Pon4uk.ua folded before Flop (didn't bet)
Seat 2: jockywils100 folded before Flop (didn't bet)
Seat 3: coeeeelho (button) folded before Flop (didn't bet)
Seat 4: anakine1974 (small blind) folded on the Turn
Seat 5: Trojanovich (big blind) folded before Flop
Seat 6: Pippa83 collected ($7.98)



PokerStars Hand #254396465266:  Hold'em No Limit ($0.50/$1.00 USD) - 2025/01/16 11:36:49 WET [2025/01/16 6:36:49 ET]
Table 'Stereoskopia III' 6-max Seat #4 is the button
Seat 1: Pon4uk.ua ($127.23 in chips) 
Seat 2: jockywils100 ($103.39 in chips) 
Seat 3: coeeeelho ($100 in chips) 
Seat 4: anakine1974 ($17.75 in chips) 
Seat 5: Trojanovich ($110.53 in chips) 
Seat 6: Pippa83 ($114.88 in chips) 
Trojanovich: posts small blind $0.50
Pippa83: posts big blind $1
*** HOLE CARDS ***
Pon4uk.ua: folds 
jockywils100: calls $1
coeeeelho: raises $3 to $4
anakine1974: raises $13.75 to $17.75 and is all-in
Trojanovich: folds 
Pippa83: folds 
jockywils100: folds 
coeeeelho: calls $13.75
*** FLOP *** [5h 5c 2s]
*** TURN *** [5h 5c 2s] [Ad]
*** RIVER *** [5h 5c 2s Ad] [Jc]
*** SHOW DOWN ***
coeeeelho: shows [Jh Jd] (a full house, Jacks full of Fives)
anakine1974: shows [Ac Kd] (two pair, Aces and Fives)
coeeeelho collected $36.10 from pot
*** SUMMARY ***
Total pot $38 | Rake $1.90 
Board [5h 5c 2s Ad Jc]
Seat 1: Pon4uk.ua folded before Flop (didn't bet)
Seat 2: jockywils100 folded before Flop
Seat 3: coeeeelho showed [Jh Jd] and won ($36.10) with a full house, Jacks full of Fives
Seat 4: anakine1974 (button) showed [Ac Kd] and lost with two pair, Aces and Fives
Seat 5: Trojanovich (small blind) folded before Flop
Seat 6: Pippa83 (big blind) folded before Flop



PokerStars Hand #254396469597:  Hold'em No Limit ($0.50/$1.00 USD) - 2025/01/16 11:37:23 WET [2025/01/16 6:37:23 ET]
Table 'Stereoskopia III' 6-max Seat #5 is the button
Seat 4: anakine1974 ($0 in chips) is sitting out
Seat 1: Pon4uk.ua ($127.23 in chips) 
Seat 2: jockywils100 ($102.39 in chips) 
Seat 3: coeeeelho ($118.35 in chips) 
Seat 5: Trojanovich ($110.03 in chips) 
Seat 6: Pippa83 ($113.88 in chips) 
Pippa83: posts small blind $0.50
Pon4uk.ua: posts big blind $1
*** HOLE CARDS ***
jockywils100: raises $2 to $3
anakine1974 leaves the table
coeeeelho: raises $6 to $9
Trojanovich: folds 
Pippa83: folds 
Pon4uk.ua: folds 
jockywils100: calls $6
*** FLOP *** [8h Qh 3s]
jockywils100: bets $9.26
coeeeelho: calls $9.26
*** TURN *** [8h Qh 3s] [5h]
jockywils100: checks 
ka100pka527 joins the table at seat #4 
coeeeelho: bets $18.06
jockywils100: folds 
Uncalled bet ($18.06) returned to coeeeelho
coeeeelho collected $36.12 from pot
*** SUMMARY ***
Total pot $38.02 | Rake $1.90 
Board [8h Qh 3s 5h]
Seat 4: anakine1974
Seat 1: Pon4uk.ua (big blind) folded before Flop
Seat 2: jockywils100 folded on the Turn
Seat 3: coeeeelho collected ($36.12)
Seat 5: Trojanovich (button) folded before Flop (didn't bet)
Seat 6: Pippa83 (small blind) folded before Flop



PokerStars Hand #254396474758:  Hold'em No Limit ($0.50/$1.00 USD) - 2025/01/16 11:38:04 WET [2025/01/16 6:38:04 ET]
Table 'Stereoskopia III' 6-max Seat #6 is the button
Seat 4: ka100pka527 ($100 in chips) is sitting out
Seat 1: Pon4uk.ua ($126.23 in chips) 
Seat 2: jockywils100 ($84.13 in chips) 
Seat 3: coeeeelho ($136.21 in chips) 
Seat 5: Trojanovich ($110.03 in chips) 
Seat 6: Pippa83 ($113.38 in chips) 
Pon4uk.ua: posts small blind $0.50
jockywils100: posts big blind $1
ka100pka527: sits out 
*** HOLE CARDS ***
coeeeelho: folds 
Trojanovich: folds 
Pippa83: raises $1.50 to $2.50
Pon4uk.ua: raises $8.50 to $11
jockywils100: folds 
Pippa83: calls $8.50
*** FLOP *** [7c 3c 4d]
Pon4uk.ua: bets $7.21
coeeeelho is disconnected 
Pippa83: folds 
Uncalled bet ($7.21) returned to Pon4uk.ua
Pon4uk.ua collected $21.85 from pot
Pon4uk.ua: doesn't show hand 
*** SUMMARY ***
Total pot $23 | Rake $1.15 
Board [7c 3c 4d]
Seat 4: ka100pka527
Seat 1: Pon4uk.ua (small blind) collected ($21.85)
Seat 2: jockywils100 (big blind) folded before Flop
Seat 3: coeeeelho folded before Flop (didn't bet)
Seat 5: Trojanovich folded before Flop (didn't bet)
Seat 6: Pippa83 (button) folded on the Flop



PokerStars Hand #254396480819:  Hold'em No Limit ($0.50/$1.00 USD) - 2025/01/16 11:38:52 WET [2025/01/16 6:38:52 ET]
Table 'Stereoskopia III' 6-max Seat #1 is the button
Seat 3: coeeeelho ($136.21 in chips) is sitting out
Seat 1: Pon4uk.ua ($137.08 in chips) 
Seat 2: jockywils100 ($83.13 in chips) 
Seat 4: ka100pka527 ($100 in chips) 
Seat 5: Trojanovich ($110.03 in chips) 
Seat 6: Pippa83 ($102.38 in chips) 
jockywils100: posts small blind $0.50
coeeeelho has timed out while disconnected
coeeeelho: is sitting out 
ka100pka527: posts big blind $1
*** HOLE CARDS ***
Trojanovich: folds 
Trojanovich leaves the table
Pippa83: raises $1.50 to $2.50
Pon4uk.ua: folds 
jockywils100: calls $2
ptolejmus joins the table at seat #5 
ka100pka527: folds 
*** FLOP *** [7c Ad 7s]
jockywils100: bets $2.85
Pippa83: folds 
Uncalled bet ($2.85) returned to jockywils100
jockywils100 collected $5.70 from pot
*** SUMMARY ***
Total pot $6 | Rake $0.30 
Board [7c Ad 7s]
Seat 3: coeeeelho
Seat 1: Pon4uk.ua (button) folded before Flop (didn't bet)
Seat 2: jockywils100 (small blind) collected ($5.70)
Seat 4: ka100pka527 (big blind) folded before Flop
Seat 5: Trojanovich folded before Flop (didn't bet)
Seat 6: Pippa83 folded on the Flop



PokerStars Hand #254396487249:  Hold'em No Limit ($0.50/$1.00 USD) - 2025/01/16 11:39:42 WET [2025/01/16 6:39:42 ET]
Table 'Stereoskopia III' 6-max Seat #2 is the button
Seat 3: coeeeelho ($136.21 in chips) is sitting out
Seat 1: Pon4uk.ua ($137.08 in chips) 
Seat 2: jockywils100 ($86.33 in chips) 
Seat 4: ka100pka527 ($100 in chips) 
Seat 5: ptolejmus ($10 in chips) 
Seat 6: Pippa83 ($100 in chips) 
ka100pka527: posts small blind $0.50
ptolejmus: posts big blind $1
*** HOLE CARDS ***
Pippa83: folds 
Pon4uk.ua: raises $1.50 to $2.50
jockywils100: folds 
ka100pka527: folds 
ptolejmus: folds 
Uncalled bet ($1.50) returned to Pon4uk.ua
Pon4uk.ua collected $2.50 from pot
Pon4uk.ua: doesn't show hand 
*** SUMMARY ***
Total pot $2.50 | Rake $0 
Seat 3: coeeeelho
Seat 1: Pon4uk.ua collected ($2.50)
Seat 2: jockywils100 (button) folded before Flop (didn't bet)
Seat 4: ka100pka527 (small blind) folded before Flop
Seat 5: ptolejmus (big blind) folded before Flop
Seat 6: Pippa83 folded before Flop (didn't bet)



PokerStars Hand #254396488584:  Hold'em No Limit ($0.50/$1.00 USD) - 2025/01/16 11:39:53 WET [2025/01/16 6:39:53 ET]
Table 'Stereoskopia III' 6-max Seat #4 is the button
Seat 3: coeeeelho ($136.21 in chips) is sitting out
Seat 1: Pon4uk.ua ($138.58 in chips) 
Seat 2: jockywils100 ($86.33 in chips) 
Seat 4: ka100pka527 ($100 in chips) 
Seat 5: ptolejmus ($10 in chips) 
Seat 6: Pippa83 ($100 in chips) 
ptolejmus: posts small blind $0.50
Pippa83: posts big blind $1
coeeeelho: sits out 
*** HOLE CARDS ***
Pon4uk.ua: raises $1 to $2
jockywils100: folds 
ka100pka527: folds 
ptolejmus: folds 
Pippa83: folds 
Uncalled bet ($1) returned to Pon4uk.ua
Pon4uk.ua collected $2.50 from pot
Pon4uk.ua: doesn't show hand 
*** SUMMARY ***
Total pot $2.50 | Rake $0 
Seat 3: coeeeelho
Seat 1: Pon4uk.ua collected ($2.50)
Seat 2: jockywils100 folded before Flop (didn't bet)
Seat 4: ka100pka527 (button) folded before Flop (didn't bet)
Seat 5: ptolejmus (small blind) folded before Flop
Seat 6: Pippa83 (big blind) folded before Flop



PokerStars Hand #254396490655:  Hold'em No Limit ($0.50/$1.00 USD) - 2025/01/16 11:40:08 WET [2025/01/16 6:40:08 ET]
Table 'Stereoskopia III' 6-max Seat #5 is the button
Seat 3: coeeeelho ($136.21 in chips) is sitting out
Seat 1: Pon4uk.ua ($140.08 in chips) 
Seat 2: jockywils100 ($86.33 in chips) 
Seat 4: ka100pka527 ($100 in chips) 
Seat 5: ptolejmus ($10 in chips) 
Seat 6: Pippa83 ($100 in chips) 
Pippa83: posts small blind $0.50
Pon4uk.ua: posts big blind $1
coeeeelho: sits out 
*** HOLE CARDS ***
jockywils100: folds 
ka100pka527: raises $1.50 to $2.50
ptolejmus: raises $7.50 to $10 and is all-in
Pippa83: folds 
Pon4uk.ua: raises $10 to $20
ka100pka527: raises $80 to $100 and is all-in
Pon4uk.ua: calls $80
*** FIRST FLOP *** [4c 2c Ks]
*** FIRST TURN *** [4c 2c Ks] [8s]
*** FIRST RIVER *** [4c 2c Ks 8s] [7d]
*** SECOND FLOP *** [5s 5d Js]
*** SECOND TURN *** [5s 5d Js] [9h]
*** SECOND RIVER *** [5s 5d Js 9h] [2h]
*** FIRST SHOW DOWN ***
Pon4uk.ua: shows [Kd Kh] (three of a kind, Kings)
ka100pka527: shows [Qc Qh] (a pair of Queens)
Pon4uk.ua collected $89.51 from side pot
ptolejmus: shows [Jc Ah] (high card Ace)
Pon4uk.ua collected $14.49 from main pot
*** SECOND SHOW DOWN ***
Pon4uk.ua: shows [Kd Kh] (two pair, Kings and Fives)
ka100pka527: shows [Qc Qh] (two pair, Queens and Fives)
Pon4uk.ua collected $89.51 from side pot
ptolejmus: shows [Jc Ah] (two pair, Jacks and Fives)
Pon4uk.ua collected $14.49 from main pot
*** SUMMARY ***
Total pot $210.50 Main pot $28.98. Side pot $179.02. | Rake $2.50 
Hand was run twice
FIRST Board [4c 2c Ks 8s 7d]
SECOND Board [5s 5d Js 9h 2h]
Seat 3: coeeeelho
Seat 1: Pon4uk.ua (big blind) showed [Kd Kh] and won ($104) with three of a kind, Kings, and won ($104) with two pair, Kings and Fives
Seat 2: jockywils100 folded before Flop (didn't bet)
Seat 4: ka100pka527 showed [Qc Qh] and lost with a pair of Queens, and lost with two pair, Queens and Fives
Seat 5: ptolejmus (button) showed [Jc Ah] and lost with high card Ace, and lost with two pair, Jacks and Fives
Seat 6: Pippa83 (small blind) folded before Flop



PokerStars Hand #254396498942:  Hold'em No Limit ($0.50/$1.00 USD) - 2025/01/16 11:41:10 WET [2025/01/16 6:41:10 ET]
Table 'Stereoskopia III' 6-max Seat #6 is the button
Seat 3: coeeeelho ($136.21 in chips) is sitting out
Seat 1: Pon4uk.ua ($248.08 in chips) 
Seat 2: jockywils100 ($86.33 in chips) 
Seat 4: ka100pka527 ($100 in chips) 
Seat 5: ptolejmus ($10 in chips) 
Seat 6: Pippa83 ($100 in chips) 
Pon4uk.ua: posts small blind $0.50
jockywils100: posts big blind $1
coeeeelho: sits out 
*** HOLE CARDS ***
ka100pka527: raises $2 to $3
ptolejmus: raises $7 to $10 and is all-in
Pippa83: folds 
Pon4uk.ua: folds 
jockywils100: folds 
ka100pka527: folds 
Uncalled bet ($7) returned to ptolejmus
ptolejmus collected $7.50 from pot
*** SUMMARY ***
Total pot $7.50 | Rake $0 
Seat 3: coeeeelho
Seat 1: Pon4uk.ua (small blind) folded before Flop
Seat 2: jockywils100 (big blind) folded before Flop
Seat 4: ka100pka527 folded before Flop
Seat 5: ptolejmus collected ($7.50)
Seat 6: Pippa83 (button) folded before Flop (didn't bet)



PokerStars Hand #254396502189:  Hold'em No Limit ($0.50/$1.00 USD) - 2025/01/16 11:41:35 WET [2025/01/16 6:41:35 ET]
Table 'Stereoskopia III' 6-max Seat #1 is the button
Seat 1: Pon4uk.ua ($247.58 in chips) 
Seat 2: jockywils100 ($85.33 in chips) 
Seat 3: coeeeelho ($136.21 in chips) 
Seat 4: ka100pka527 ($100 in chips) 
Seat 5: ptolejmus ($14.50 in chips) 
Seat 6: Pippa83 ($100 in chips) 
jockywils100: posts small blind $0.50
coeeeelho: posts big blind $1
*** HOLE CARDS ***
ka100pka527: folds 
ptolejmus: raises $1 to $2
Pippa83: folds 
Pon4uk.ua: folds 
jockywils100: folds 
coeeeelho: folds 
Uncalled bet ($1) returned to ptolejmus
ptolejmus collected $2.50 from pot
*** SUMMARY ***
Total pot $2.50 | Rake $0 
Seat 1: Pon4uk.ua (button) folded before Flop (didn't bet)
Seat 2: jockywils100 (small blind) folded before Flop
Seat 3: coeeeelho (big blind) folded before Flop
Seat 4: ka100pka527 folded before Flop (didn't bet)
Seat 5: ptolejmus collected ($2.50)
Seat 6: Pippa83 folded before Flop (didn't bet)



PokerStars Hand #254396504784:  Hold'em No Limit ($0.50/$1.00 USD) - 2025/01/16 11:41:55 WET [2025/01/16 6:41:55 ET]
Table 'Stereoskopia III' 6-max Seat #2 is the button
Seat 1: Pon4uk.ua ($247.58 in chips) 
Seat 2: jockywils100 ($84.83 in chips) 
Seat 3: coeeeelho ($135.21 in chips) 
Seat 4: ka100pka527 ($100 in chips) 
Seat 5: ptolejmus ($16 in chips) 
Seat 6: Pippa83 ($100 in chips) 
coeeeelho: posts small blind $0.50
ka100pka527: posts big blind $1
*** HOLE CARDS ***
ptolejmus: folds 
Pippa83: folds 
Pon4uk.ua: folds 
jockywils100: raises $1 to $2
coeeeelho: raises $8 to $10
ka100pka527: folds 
jockywils100: folds 
Uncalled bet ($8) returned to coeeeelho
coeeeelho collected $5 from pot
*** SUMMARY ***
Total pot $5 | Rake $0 
Seat 1: Pon4uk.ua folded before Flop (didn't bet)
Seat 2: jockywils100 (button) folded before Flop
Seat 3: coeeeelho (small blind) collected ($5)
Seat 4: ka100pka527 (big blind) folded before Flop
Seat 5: ptolejmus folded before Flop (didn't bet)
Seat 6: Pippa83 folded before Flop (didn't bet)



PokerStars Hand #254396506859:  Hold'em No Limit ($0.50/$1.00 USD) - 2025/01/16 11:42:11 WET [2025/01/16 6:42:11 ET]
Table 'Stereoskopia III' 6-max Seat #3 is the button
Seat 1: Pon4uk.ua ($247.58 in chips) 
Seat 2: jockywils100 ($82.83 in chips) 
Seat 3: coeeeelho ($138.21 in chips) 
Seat 4: ka100pka527 ($100 in chips) 
Seat 5: ptolejmus ($16 in chips) 
Seat 6: Pippa83 ($100 in chips) 
ka100pka527: posts small blind $0.50
ptolejmus: posts big blind $1
*** HOLE CARDS ***
Pippa83: folds 
Pon4uk.ua: folds 
jockywils100: raises $1 to $2
coeeeelho: folds 
ka100pka527: folds 
ptolejmus: folds 
Uncalled bet ($1) returned to jockywils100
jockywils100 collected $2.50 from pot
*** SUMMARY ***
Total pot $2.50 | Rake $0 
Seat 1: Pon4uk.ua folded before Flop (didn't bet)
Seat 2: jockywils100 collected ($2.50)
Seat 3: coeeeelho (button) folded before Flop (didn't bet)
Seat 4: ka100pka527 (small blind) folded before Flop
Seat 5: ptolejmus (big blind) folded before Flop
Seat 6: Pippa83 folded before Flop (didn't bet)



PokerStars Hand #254396508603:  Hold'em No Limit ($0.50/$1.00 USD) - 2025/01/16 11:42:24 WET [2025/01/16 6:42:24 ET]
Table 'Stereoskopia III' 6-max Seat #4 is the button
Seat 1: Pon4uk.ua ($247.58 in chips) 
Seat 2: jockywils100 ($84.33 in chips) 
Seat 3: coeeeelho ($138.21 in chips) 
Seat 4: ka100pka527 ($100 in chips) 
Seat 5: ptolejmus ($15 in chips) 
Seat 6: Pippa83 ($100 in chips) 
ptolejmus: posts small blind $0.50
Pippa83: posts big blind $1
*** HOLE CARDS ***
Pon4uk.ua: folds 
jockywils100: folds 
coeeeelho: folds 
ka100pka527: raises $1.50 to $2.50
ptolejmus: folds 
Pippa83: folds 
Uncalled bet ($1.50) returned to ka100pka527
ka100pka527 collected $2.50 from pot
ka100pka527: doesn't show hand 
*** SUMMARY ***
Total pot $2.50 | Rake $0 
Seat 1: Pon4uk.ua folded before Flop (didn't bet)
Seat 2: jockywils100 folded before Flop (didn't bet)
Seat 3: coeeeelho folded before Flop (didn't bet)
Seat 4: ka100pka527 (button) collected ($2.50)
Seat 5: ptolejmus (small blind) folded before Flop
Seat 6: Pippa83 (big blind) folded before Flop



PokerStars Hand #254396511151:  Hold'em No Limit ($0.50/$1.00 USD) - 2025/01/16 11:42:44 WET [2025/01/16 6:42:44 ET]
Table 'Stereoskopia III' 6-max Seat #5 is the button
Seat 1: Pon4uk.ua ($247.58 in chips) 
Seat 2: jockywils100 ($84.33 in chips) 
Seat 3: coeeeelho ($138.21 in chips) 
Seat 4: ka100pka527 ($101.50 in chips) 
Seat 5: ptolejmus ($14.50 in chips) 
Seat 6: Pippa83 ($100 in chips) 
Pippa83: posts small blind $0.50
Pon4uk.ua: posts big blind $1
*** HOLE CARDS ***
jockywils100: raises $1 to $2
coeeeelho: folds 
ka100pka527: folds 
ptolejmus: folds 
Pippa83: folds 
Pon4uk.ua: calls $1
*** FLOP *** [Ad Kd 5c]
Pon4uk.ua: checks 
jockywils100: checks 
*** TURN *** [Ad Kd 5c] [5d]
Pon4uk.ua: checks 
jockywils100: checks 
*** RIVER *** [Ad Kd 5c 5d] [Qh]
Pon4uk.ua: checks 
jockywils100: bets $3.14
Pon4uk.ua: folds 
Uncalled bet ($3.14) returned to jockywils100
jockywils100 collected $4.28 from pot
*** SUMMARY ***
Total pot $4.50 | Rake $0.22 
Board [Ad Kd 5c 5d Qh]
Seat 1: Pon4uk.ua (big blind) folded on the River
Seat 2: jockywils100 collected ($4.28)
Seat 3: coeeeelho folded before Flop (didn't bet)
Seat 4: ka100pka527 folded before Flop (didn't bet)
Seat 5: ptolejmus (button) folded before Flop (didn't bet)
Seat 6: Pippa83 (small blind) folded before Flop



PokerStars Hand #254396520034:  Hold'em No Limit ($0.50/$1.00 USD) - 2025/01/16 11:43:52 WET [2025/01/16 6:43:52 ET]
Table 'Stereoskopia III' 6-max Seat #6 is the button
Seat 1: Pon4uk.ua ($245.58 in chips) 
Seat 2: jockywils100 ($86.61 in chips) 
Seat 3: coeeeelho ($138.21 in chips) 
Seat 4: ka100pka527 ($101.50 in chips) 
Seat 5: ptolejmus ($14.50 in chips) 
Seat 6: Pippa83 ($100 in chips) 
Pon4uk.ua: posts small blind $0.50
jockywils100: posts big blind $1
*** HOLE CARDS ***
coeeeelho: folds 
ka100pka527: folds 
ptolejmus: folds 
Pippa83: raises $1.50 to $2.50
Pon4uk.ua: folds 
jockywils100: calls $1.50
*** FLOP *** [Jh 6s 7d]
jockywils100: checks 
Pippa83: checks 
*** TURN *** [Jh 6s 7d] [3d]
jockywils100: bets $2.61
Pippa83: folds 
Uncalled bet ($2.61) returned to jockywils100
jockywils100 collected $5.22 from pot
*** SUMMARY ***
Total pot $5.50 | Rake $0.28 
Board [Jh 6s 7d 3d]
Seat 1: Pon4uk.ua (small blind) folded before Flop
Seat 2: jockywils100 (big blind) collected ($5.22)
Seat 3: coeeeelho folded before Flop (didn't bet)
Seat 4: ka100pka527 folded before Flop (didn't bet)
Seat 5: ptolejmus folded before Flop (didn't bet)
Seat 6: Pippa83 (button) folded on the Turn



PokerStars Hand #254396526606:  Hold'em No Limit ($0.50/$1.00 USD) - 2025/01/16 11:44:42 WET [2025/01/16 6:44:42 ET]
Table 'Stereoskopia III' 6-max Seat #1 is the button
Seat 1: Pon4uk.ua ($245.08 in chips) 
Seat 2: jockywils100 ($89.33 in chips) 
Seat 3: coeeeelho ($138.21 in chips) 
Seat 4: ka100pka527 ($101.50 in chips) 
Seat 5: ptolejmus ($14.50 in chips) 
Seat 6: Pippa83 ($100 in chips) 
jockywils100: posts small blind $0.50
coeeeelho: posts big blind $1
*** HOLE CARDS ***
ka100pka527: folds 
ptolejmus: folds 
Pippa83: folds 
Pon4uk.ua: folds 
jockywils100: calls $0.50
coeeeelho: checks 
*** FLOP *** [7d 9d Qs]
jockywils100: checks 
coeeeelho: checks 
*** TURN *** [7d 9d Qs] [8c]
jockywils100: checks 
coeeeelho: bets $1.43
jockywils100: calls $1.43
*** RIVER *** [7d 9d Qs 8c] [2d]
jockywils100: bets $2.31
coeeeelho: folds 
Uncalled bet ($2.31) returned to jockywils100
jockywils100 collected $4.62 from pot
*** SUMMARY ***
Total pot $4.86 | Rake $0.24 
Board [7d 9d Qs 8c 2d]
Seat 1: Pon4uk.ua (button) folded before Flop (didn't bet)
Seat 2: jockywils100 (small blind) collected ($4.62)
Seat 3: coeeeelho (big blind) folded on the River
Seat 4: ka100pka527 folded before Flop (didn't bet)
Seat 5: ptolejmus folded before Flop (didn't bet)
Seat 6: Pippa83 folded before Flop (didn't bet)



PokerStars Hand #254396532997:  Hold'em No Limit ($0.50/$1.00 USD) - 2025/01/16 11:45:31 WET [2025/01/16 6:45:31 ET]
Table 'Stereoskopia III' 6-max Seat #2 is the button
Seat 1: Pon4uk.ua ($245.08 in chips) 
Seat 2: jockywils100 ($91.52 in chips) 
Seat 3: coeeeelho ($135.78 in chips) 
Seat 4: ka100pka527 ($101.50 in chips) 
Seat 5: ptolejmus ($14.50 in chips) 
Seat 6: Pippa83 ($100 in chips) 
coeeeelho: posts small blind $0.50
ka100pka527: posts big blind $1
*** HOLE CARDS ***
ptolejmus: folds 
Pippa83: raises $1.20 to $2.20
Pon4uk.ua: folds 
jockywils100: calls $2.20
coeeeelho: folds 
ka100pka527: folds 
*** FLOP *** [As 9s 3c]
Pippa83: bets $1.12
jockywils100: calls $1.12
*** TURN *** [As 9s 3c] [5c]
Pippa83: checks 
jockywils100: checks 
*** RIVER *** [As 9s 3c 5c] [9h]
Pippa83: checks 
jockywils100: bets $2.87
Pippa83: folds 
Uncalled bet ($2.87) returned to jockywils100
jockywils100 collected $7.73 from pot
*** SUMMARY ***
Total pot $8.14 | Rake $0.41 
Board [As 9s 3c 5c 9h]
Seat 1: Pon4uk.ua folded before Flop (didn't bet)
Seat 2: jockywils100 (button) collected ($7.73)
Seat 3: coeeeelho (small blind) folded before Flop
Seat 4: ka100pka527 (big blind) folded before Flop
Seat 5: ptolejmus folded before Flop (didn't bet)
Seat 6: Pippa83 folded on the River



PokerStars Hand #254396540653:  Hold'em No Limit ($0.50/$1.00 USD) - 2025/01/16 11:46:28 WET [2025/01/16 6:46:28 ET]
Table 'Stereoskopia III' 6-max Seat #3 is the button
Seat 1: Pon4uk.ua ($245.08 in chips) 
Seat 2: jockywils100 ($95.93 in chips) 
Seat 3: coeeeelho ($135.28 in chips) 
Seat 4: ka100pka527 ($100.50 in chips) 
Seat 5: ptolejmus ($14.50 in chips) 
Seat 6: Pippa83 ($100 in chips) 
ka100pka527: posts small blind $0.50
ptolejmus: posts big blind $1
*** HOLE CARDS ***
Pippa83: folds 
Pon4uk.ua: folds 
jockywils100: calls $1
coeeeelho: folds 
ka100pka527: folds 
ptolejmus: checks 
*** FLOP *** [Kc 2s Qc]
ptolejmus: checks 
jockywils100: checks 
*** TURN *** [Kc 2s Qc] [2d]
ptolejmus: checks 
jockywils100: bets $2.19
ptolejmus: folds 
Uncalled bet ($2.19) returned to jockywils100
jockywils100 collected $2.38 from pot
*** SUMMARY ***
Total pot $2.50 | Rake $0.12 
Board [Kc 2s Qc 2d]
Seat 1: Pon4uk.ua folded before Flop (didn't bet)
Seat 2: jockywils100 collected ($2.38)
Seat 3: coeeeelho (button) folded before Flop (didn't bet)
Seat 4: ka100pka527 (small blind) folded before Flop
Seat 5: ptolejmus (big blind) folded on the Turn
Seat 6: Pippa83 folded before Flop (didn't bet)



PokerStars Hand #254396545670:  Hold'em No Limit ($0.50/$1.00 USD) - 2025/01/16 11:47:06 WET [2025/01/16 6:47:06 ET]
Table 'Stereoskopia III' 6-max Seat #4 is the button
Seat 1: Pon4uk.ua ($245.08 in chips) 
Seat 2: jockywils100 ($97.31 in chips) 
Seat 3: coeeeelho ($135.28 in chips) 
Seat 4: ka100pka527 ($100 in chips) 
Seat 5: ptolejmus ($13.50 in chips) 
Seat 6: Pippa83 ($100 in chips) 
ptolejmus: posts small blind $0.50
Pippa83: posts big blind $1
*** HOLE CARDS ***
Pon4uk.ua: folds 
jockywils100: folds 
coeeeelho: raises $1.20 to $2.20
ka100pka527: folds 
ptolejmus: raises $11.30 to $13.50 and is all-in
Pippa83: folds 
coeeeelho: calls $11.30
*** FLOP *** [8h 5h Qc]
*** TURN *** [8h 5h Qc] [4d]
*** RIVER *** [8h 5h Qc 4d] [5c]
*** SHOW DOWN ***
ptolejmus: shows [Ac Td] (a pair of Fives)
coeeeelho: shows [Js Ah] (a pair of Fives - Ace+Queen+Jack kicker)
coeeeelho collected $26.60 from pot
*** SUMMARY ***
Total pot $28 | Rake $1.40 
Board [8h 5h Qc 4d 5c]
Seat 1: Pon4uk.ua folded before Flop (didn't bet)
Seat 2: jockywils100 folded before Flop (didn't bet)
Seat 3: coeeeelho showed [Js Ah] and won ($26.60) with a pair of Fives
Seat 4: ka100pka527 (button) folded before Flop (didn't bet)
Seat 5: ptolejmus (small blind) showed [Ac Td] and lost with a pair of Fives
Seat 6: Pippa83 (big blind) folded before Flop



PokerStars Hand #254396549825:  Hold'em No Limit ($0.50/$1.00 USD) - 2025/01/16 11:47:39 WET [2025/01/16 6:47:39 ET]
Table 'Stereoskopia III' 6-max Seat #5 is the button
Seat 1: Pon4uk.ua ($245.08 in chips) 
Seat 2: jockywils100 ($97.31 in chips) 
Seat 3: coeeeelho ($148.38 in chips) 
Seat 4: ka100pka527 ($100 in chips) 
Seat 5: ptolejmus ($10 in chips) 
Seat 6: Pippa83 ($100 in chips) 
Pippa83: posts small blind $0.50
Pon4uk.ua: posts big blind $1
*** HOLE CARDS ***
jockywils100: folds 
coeeeelho: folds 
ka100pka527: folds 
ptolejmus: folds 
Pippa83: raises $2 to $3
Pon4uk.ua: folds 
Uncalled bet ($2) returned to Pippa83
Pippa83 collected $2 from pot
Pippa83: doesn't show hand 
*** SUMMARY ***
Total pot $2 | Rake $0 
Seat 1: Pon4uk.ua (big blind) folded before Flop
Seat 2: jockywils100 folded before Flop (didn't bet)
Seat 3: coeeeelho folded before Flop (didn't bet)
Seat 4: ka100pka527 folded before Flop (didn't bet)
Seat 5: ptolejmus (button) folded before Flop (didn't bet)
Seat 6: Pippa83 (small blind) collected ($2)



PokerStars Hand #254396554190:  Hold'em No Limit ($0.50/$1.00 USD) - 2025/01/16 11:48:12 WET [2025/01/16 6:48:12 ET]
Table 'Stereoskopia III' 6-max Seat #6 is the button
Seat 1: Pon4uk.ua ($244.08 in chips) 
Seat 2: jockywils100 ($97.31 in chips) 
Seat 3: coeeeelho ($148.38 in chips) 
Seat 4: ka100pka527 ($100 in chips) 
Seat 5: ptolejmus ($10 in chips) 
Seat 6: Pippa83 ($101 in chips) 
Pon4uk.ua: posts small blind $0.50
jockywils100: posts big blind $1
*** HOLE CARDS ***
coeeeelho: folds 
ka100pka527: folds 
ptolejmus: folds 
Pippa83: folds 
Pon4uk.ua: calls $0.50
jockywils100: checks 
*** FLOP *** [2c Qd 4s]
Pon4uk.ua: bets $1
jockywils100: calls $1
*** TURN *** [2c Qd 4s] [Td]
Pon4uk.ua: checks 
jockywils100: bets $2.90
Pon4uk.ua: folds 
Uncalled bet ($2.90) returned to jockywils100
jockywils100 collected $3.80 from pot
*** SUMMARY ***
Total pot $4 | Rake $0.20 
Board [2c Qd 4s Td]
Seat 1: Pon4uk.ua (small blind) folded on the Turn
Seat 2: jockywils100 (big blind) collected ($3.80)
Seat 3: coeeeelho folded before Flop (didn't bet)
Seat 4: ka100pka527 folded before Flop (didn't bet)
Seat 5: ptolejmus folded before Flop (didn't bet)
Seat 6: Pippa83 (button) folded before Flop (didn't bet)



PokerStars Hand #254396561244:  Hold'em No Limit ($0.50/$1.00 USD) - 2025/01/16 11:49:06 WET [2025/01/16 6:49:06 ET]
Table 'Stereoskopia III' 6-max Seat #1 is the button
Seat 1: Pon4uk.ua ($242.08 in chips) 
Seat 2: jockywils100 ($99.11 in chips) 
Seat 3: coeeeelho ($148.38 in chips) 
Seat 4: ka100pka527 ($100 in chips) 
Seat 5: ptolejmus ($10 in chips) 
Seat 6: Pippa83 ($101 in chips) 
jockywils100: posts small blind $0.50
coeeeelho: posts big blind $1
*** HOLE CARDS ***
ka100pka527: raises $2 to $3
ptolejmus: folds 
Pippa83: folds 
Pon4uk.ua: folds 
jockywils100: folds 
coeeeelho: folds 
Uncalled bet ($2) returned to ka100pka527
ka100pka527 collected $2.50 from pot
ka100pka527: doesn't show hand 
*** SUMMARY ***
Total pot $2.50 | Rake $0 
Seat 1: Pon4uk.ua (button) folded before Flop (didn't bet)
Seat 2: jockywils100 (small blind) folded before Flop
Seat 3: coeeeelho (big blind) folded before Flop
Seat 4: ka100pka527 collected ($2.50)
Seat 5: ptolejmus folded before Flop (didn't bet)
Seat 6: Pippa83 folded before Flop (didn't bet)



PokerStars Hand #254396562671:  Hold'em No Limit ($0.50/$1.00 USD) - 2025/01/16 11:49:17 WET [2025/01/16 6:49:17 ET]
Table 'Stereoskopia III' 6-max Seat #2 is the button
Seat 1: Pon4uk.ua ($242.08 in chips) 
Seat 2: jockywils100 ($98.61 in chips) 
Seat 3: coeeeelho ($147.38 in chips) 
Seat 4: ka100pka527 ($101.50 in chips) 
Seat 5: ptolejmus ($10 in chips) 
Seat 6: Pippa83 ($101 in chips) 
coeeeelho: posts small blind $0.50
ka100pka527: posts big blind $1
*** HOLE CARDS ***
ptolejmus: folds 
Pippa83: folds 
Pon4uk.ua has timed out
Pon4uk.ua: folds 
jockywils100: folds 
coeeeelho: raises $2 to $3
ka100pka527: calls $2
*** FLOP *** [2h Js 8c]
coeeeelho: bets $1.88
ka100pka527: raises $5.11 to $6.99
coeeeelho: calls $5.11
*** TURN *** [2h Js 8c] [Tc]
Pippa83 leaves the table
coeeeelho: checks 
Evelexy1 joins the table at seat #6 
ka100pka527: bets $14.42
coeeeelho: calls $14.42
*** RIVER *** [2h Js 8c Tc] [5h]
coeeeelho: checks 
ka100pka527: checks 
*** SHOW DOWN ***
coeeeelho: shows [9d Qc] (a straight, Eight to Queen)
ka100pka527: mucks hand 
coeeeelho collected $46.38 from pot
*** SUMMARY ***
Total pot $48.82 | Rake $2.44 
Board [2h Js 8c Tc 5h]
Seat 1: Pon4uk.ua folded before Flop (didn't bet)
Seat 2: jockywils100 (button) folded before Flop (didn't bet)
Seat 3: coeeeelho (small blind) showed [9d Qc] and won ($46.38) with a straight, Eight to Queen
Seat 4: ka100pka527 (big blind) mucked
Seat 5: ptolejmus folded before Flop (didn't bet)
Seat 6: Pippa83 folded before Flop (didn't bet)



PokerStars Hand #254396575960:  Hold'em No Limit ($0.50/$1.00 USD) - 2025/01/16 11:50:57 WET [2025/01/16 6:50:57 ET]
Table 'Stereoskopia III' 6-max Seat #3 is the button
Seat 6: Evelexy1 ($100 in chips) is sitting out
Seat 1: Pon4uk.ua ($242.08 in chips) 
Seat 2: jockywils100 ($98.61 in chips) 
Seat 3: coeeeelho ($169.35 in chips) 
Seat 4: ka100pka527 ($100 in chips) 
Seat 5: ptolejmus ($10 in chips) 
ka100pka527: posts small blind $0.50
ptolejmus: posts big blind $1
Evelexy1: sits out 
*** HOLE CARDS ***
Pon4uk.ua: folds 
jockywils100: folds 
coeeeelho: folds 
ka100pka527: folds 
Uncalled bet ($0.50) returned to ptolejmus
ptolejmus collected $1 from pot
*** SUMMARY ***
Total pot $1 | Rake $0 
Seat 6: Evelexy1
Seat 1: Pon4uk.ua folded before Flop (didn't bet)
Seat 2: jockywils100 folded before Flop (didn't bet)
Seat 3: coeeeelho (button) folded before Flop (didn't bet)
Seat 4: ka100pka527 (small blind) folded before Flop
Seat 5: ptolejmus (big blind) collected ($1)



PokerStars Hand #254396578215:  Hold'em No Limit ($0.50/$1.00 USD) - 2025/01/16 11:51:14 WET [2025/01/16 6:51:14 ET]
Table 'Stereoskopia III' 6-max Seat #4 is the button
Seat 1: Pon4uk.ua ($242.08 in chips) 
Seat 2: jockywils100 ($98.61 in chips) 
Seat 3: coeeeelho ($169.35 in chips) 
Seat 4: ka100pka527 ($100 in chips) 
Seat 5: ptolejmus ($10.50 in chips) 
Seat 6: Evelexy1 ($100 in chips) 
ptolejmus: posts small blind $0.50
Evelexy1: posts big blind $1
*** HOLE CARDS ***
Pon4uk.ua: raises $1 to $2
jockywils100: folds 
coeeeelho: folds 
ka100pka527: folds 
ptolejmus: folds 
Evelexy1: folds 
Uncalled bet ($1) returned to Pon4uk.ua
Pon4uk.ua collected $2.50 from pot
Pon4uk.ua: doesn't show hand 
*** SUMMARY ***
Total pot $2.50 | Rake $0 
Seat 1: Pon4uk.ua collected ($2.50)
Seat 2: jockywils100 folded before Flop (didn't bet)
Seat 3: coeeeelho folded before Flop (didn't bet)
Seat 4: ka100pka527 (button) folded before Flop (didn't bet)
Seat 5: ptolejmus (small blind) folded before Flop
Seat 6: Evelexy1 (big blind) folded before Flop



PokerStars Hand #254396580123:  Hold'em No Limit ($0.50/$1.00 USD) - 2025/01/16 11:51:29 WET [2025/01/16 6:51:29 ET]
Table 'Stereoskopia III' 6-max Seat #5 is the button
Seat 1: Pon4uk.ua ($243.58 in chips) 
Seat 2: jockywils100 ($98.61 in chips) 
Seat 3: coeeeelho ($169.35 in chips) 
Seat 4: ka100pka527 ($100 in chips) 
Seat 5: ptolejmus ($10 in chips) 
Seat 6: Evelexy1 ($100 in chips) 
Evelexy1: posts small blind $0.50
Pon4uk.ua: posts big blind $1
*** HOLE CARDS ***
jockywils100: folds 
coeeeelho: folds 
ka100pka527: folds 
ptolejmus: raises $1 to $2
Evelexy1: raises $7.76 to $9.76
Pon4uk.ua: folds 
ptolejmus: raises $0.24 to $10 and is all-in
Evelexy1: calls $0.24
*** FLOP *** [7c 8d 6c]
*** TURN *** [7c 8d 6c] [2d]
*** RIVER *** [7c 8d 6c 2d] [Th]
*** SHOW DOWN ***
Evelexy1: shows [8s As] (a pair of Eights)
ptolejmus: shows [9d 9h] (a straight, Six to Ten)
ptolejmus cashed out the hand for $13.15 | Cash Out Fee $0.27
*** SUMMARY ***
Total pot $21 | Rake $1.05 
Board [7c 8d 6c 2d Th]
Seat 1: Pon4uk.ua (big blind) folded before Flop
Seat 2: jockywils100 folded before Flop (didn't bet)
Seat 3: coeeeelho folded before Flop (didn't bet)
Seat 4: ka100pka527 folded before Flop (didn't bet)
Seat 5: ptolejmus (button) showed [9d 9h] and won ($19.95) with a straight, Six to Ten (pot not awarded as player cashed out)
Seat 6: Evelexy1 (small blind) showed [8s As] and lost with a pair of Eights



PokerStars Hand #254396586997:  Hold'em No Limit ($0.50/$1.00 USD) - 2025/01/16 11:52:20 WET [2025/01/16 6:52:20 ET]
Table 'Stereoskopia III' 6-max Seat #1 is the button
Seat 1: Pon4uk.ua ($242.58 in chips) 
Seat 2: jockywils100 ($98.61 in chips) 
Seat 3: coeeeelho ($169.35 in chips) 
Seat 4: ka100pka527 ($100 in chips) 
Seat 5: ptolejmus ($13.15 in chips) 
jockywils100: posts small blind $0.50
coeeeelho: posts big blind $1
*** HOLE CARDS ***
ka100pka527: folds 
ptolejmus: folds 
Pon4uk.ua: raises $1.50 to $2.50
jockywils100: calls $2
coeeeelho: folds 
*** FLOP *** [As Td 7h]
jockywils100: checks 
Pon4uk.ua: checks 
*** TURN *** [As Td 7h] [9c]
jockywils100: bets $2.85
Pon4uk.ua: calls $2.85
*** RIVER *** [As Td 7h 9c] [Th]
janarr5 joins the table at seat #6 
jockywils100: bets $7.56
Pon4uk.ua: folds 
Uncalled bet ($7.56) returned to jockywils100
jockywils100 collected $11.12 from pot
*** SUMMARY ***
Total pot $11.70 | Rake $0.58 
Board [As Td 7h 9c Th]
Seat 1: Pon4uk.ua (button) folded on the River
Seat 2: jockywils100 (small blind) collected ($11.12)
Seat 3: coeeeelho (big blind) folded before Flop
Seat 4: ka100pka527 folded before Flop (didn't bet)
Seat 5: ptolejmus folded before Flop (didn't bet)



PokerStars Hand #254396596816:  Hold'em No Limit ($0.50/$1.00 USD) - 2025/01/16 11:53:35 WET [2025/01/16 6:53:35 ET]
Table 'Stereoskopia III' 6-max Seat #2 is the button
Seat 6: janarr5 ($100 in chips) is sitting out
Seat 1: Pon4uk.ua ($237.23 in chips) 
Seat 2: jockywils100 ($104.38 in chips) 
Seat 3: coeeeelho ($168.35 in chips) 
Seat 4: ka100pka527 ($100 in chips) 
Seat 5: ptolejmus ($13.15 in chips) 
coeeeelho: posts small blind $0.50
ka100pka527: posts big blind $1
janarr5: sits out 
*** HOLE CARDS ***
ptolejmus: folds 
Pon4uk.ua: raises $1.50 to $2.50
jockywils100: folds 
coeeeelho: folds 
ka100pka527: folds 
Uncalled bet ($1.50) returned to Pon4uk.ua
Pon4uk.ua collected $2.50 from pot
Pon4uk.ua: doesn't show hand 
*** SUMMARY ***
Total pot $2.50 | Rake $0 
Seat 6: janarr5
Seat 1: Pon4uk.ua collected ($2.50)
Seat 2: jockywils100 (button) folded before Flop (didn't bet)
Seat 3: coeeeelho (small blind) folded before Flop
Seat 4: ka100pka527 (big blind) folded before Flop
Seat 5: ptolejmus folded before Flop (didn't bet)



PokerStars Hand #254396599380:  Hold'em No Limit ($0.50/$1.00 USD) - 2025/01/16 11:53:54 WET [2025/01/16 6:53:54 ET]
Table 'Stereoskopia III' 6-max Seat #3 is the button
Seat 6: janarr5 ($100 in chips) is sitting out
Seat 1: Pon4uk.ua ($238.73 in chips) 
Seat 2: jockywils100 ($104.38 in chips) 
Seat 3: coeeeelho ($167.85 in chips) 
Seat 4: ka100pka527 ($100 in chips) 
Seat 5: ptolejmus ($13.15 in chips) 
ka100pka527: posts small blind $0.50
ptolejmus: posts big blind $1
janarr5: sits out 
*** HOLE CARDS ***
Pon4uk.ua: folds 
jockywils100: folds 
coeeeelho: folds 
ka100pka527: raises $13 to $14
ptolejmus: folds 
Uncalled bet ($13) returned to ka100pka527
ka100pka527 collected $2 from pot
ka100pka527: doesn't show hand 
*** SUMMARY ***
Total pot $2 | Rake $0 
Seat 6: janarr5
Seat 1: Pon4uk.ua folded before Flop (didn't bet)
Seat 2: jockywils100 folded before Flop (didn't bet)
Seat 3: coeeeelho (button) folded before Flop (didn't bet)
Seat 4: ka100pka527 (small blind) collected ($2)
Seat 5: ptolejmus (big blind) folded before Flop



PokerStars Hand #254396602181:  Hold'em No Limit ($0.50/$1.00 USD) - 2025/01/16 11:54:16 WET [2025/01/16 6:54:16 ET]
Table 'Stereoskopia III' 6-max Seat #4 is the button
Seat 1: Pon4uk.ua ($238.73 in chips) 
Seat 2: jockywils100 ($104.38 in chips) 
Seat 3: coeeeelho ($167.85 in chips) 
Seat 4: ka100pka527 ($101 in chips) 
Seat 5: ptolejmus ($12.15 in chips) 
Seat 6: janarr5 ($100 in chips) 
ptolejmus: posts small blind $0.50
janarr5: posts big blind $1
*** HOLE CARDS ***
Pon4uk.ua: folds 
jockywils100: folds 
coeeeelho: folds 
ka100pka527: raises $1.50 to $2.50
ptolejmus: folds 
janarr5: folds 
Uncalled bet ($1.50) returned to ka100pka527
ka100pka527 collected $2.50 from pot
ka100pka527: doesn't show hand 
*** SUMMARY ***
Total pot $2.50 | Rake $0 
Seat 1: Pon4uk.ua folded before Flop (didn't bet)
Seat 2: jockywils100 folded before Flop (didn't bet)
Seat 3: coeeeelho folded before Flop (didn't bet)
Seat 4: ka100pka527 (button) collected ($2.50)
Seat 5: ptolejmus (small blind) folded before Flop
Seat 6: janarr5 (big blind) folded before Flop



PokerStars Hand #254396606425:  Hold'em No Limit ($0.50/$1.00 USD) - 2025/01/16 11:54:48 WET [2025/01/16 6:54:48 ET]
Table 'Stereoskopia III' 6-max Seat #5 is the button
Seat 1: Pon4uk.ua ($238.73 in chips) 
Seat 2: jockywils100 ($104.38 in chips) 
Seat 3: coeeeelho ($167.85 in chips) 
Seat 4: ka100pka527 ($102.50 in chips) 
Seat 5: ptolejmus ($11.65 in chips) 
Seat 6: janarr5 ($100 in chips) 
janarr5: posts small blind $0.50
Pon4uk.ua: posts big blind $1
*** HOLE CARDS ***
jockywils100: folds 
coeeeelho: folds 
ka100pka527: folds 
ptolejmus: folds 
janarr5: raises $2 to $3
Pon4uk.ua: calls $2
*** FLOP *** [3c 8d 3d]
janarr5: bets $1.88
Pon4uk.ua: calls $1.88
*** TURN *** [3c 8d 3d] [6d]
janarr5: checks 
Pon4uk.ua: checks 
*** RIVER *** [3c 8d 3d 6d] [9c]
janarr5: bets $3.06
Pon4uk.ua: folds 
Uncalled bet ($3.06) returned to janarr5
janarr5 collected $9.27 from pot
janarr5: doesn't show hand 
*** SUMMARY ***
Total pot $9.76 | Rake $0.49 
Board [3c 8d 3d 6d 9c]
Seat 1: Pon4uk.ua (big blind) folded on the River
Seat 2: jockywils100 folded before Flop (didn't bet)
Seat 3: coeeeelho folded before Flop (didn't bet)
Seat 4: ka100pka527 folded before Flop (didn't bet)
Seat 5: ptolejmus (button) folded before Flop (didn't bet)
Seat 6: janarr5 (small blind) collected ($9.27)



PokerStars Hand #254396612740:  Hold'em No Limit ($0.50/$1.00 USD) - 2025/01/16 11:55:41 WET [2025/01/16 6:55:41 ET]
Table 'Stereoskopia III' 6-max Seat #6 is the button
Seat 1: Pon4uk.ua ($233.85 in chips) 
Seat 2: jockywils100 ($104.38 in chips) 
Seat 3: coeeeelho ($167.85 in chips) 
Seat 4: ka100pka527 ($102.50 in chips) 
Seat 5: ptolejmus ($11.65 in chips) 
Seat 6: janarr5 ($104.39 in chips) 
Pon4uk.ua: posts small blind $0.50
jockywils100: posts big blind $1
*** HOLE CARDS ***
coeeeelho: raises $1.20 to $2.20
ka100pka527: folds 
ptolejmus: folds 
janarr5: folds 
janarr5 leaves the table
Pon4uk.ua: folds 
jockywils100: calls $1.20
*** FLOP *** [7d 4d 5h]
jockywils100: checks 
Nicedaymybro joins the table at seat #6 
coeeeelho: bets $1.17
jockywils100: calls $1.17
*** TURN *** [7d 4d 5h] [2c]
jockywils100: checks 
coeeeelho: checks 
*** RIVER *** [7d 4d 5h 2c] [Ah]
jockywils100: bets $5.44
coeeeelho: calls $5.44
*** SHOW DOWN ***
jockywils100: shows [Qs Td] (high card Ace)
coeeeelho: shows [Ad Ks] (a pair of Aces)
coeeeelho collected $17.21 from pot
*** SUMMARY ***
Total pot $18.12 | Rake $0.91 
Board [7d 4d 5h 2c Ah]
Seat 1: Pon4uk.ua (small blind) folded before Flop
Seat 2: jockywils100 (big blind) showed [Qs Td] and lost with high card Ace
Seat 3: coeeeelho showed [Ad Ks] and won ($17.21) with a pair of Aces
Seat 4: ka100pka527 folded before Flop (didn't bet)
Seat 5: ptolejmus folded before Flop (didn't bet)
Seat 6: janarr5 (button) folded before Flop (didn't bet)



PokerStars Hand #254396618088:  Hold'em No Limit ($0.50/$1.00 USD) - 2025/01/16 11:56:31 WET [2025/01/16 6:56:31 ET]
Table 'Stereoskopia III' 6-max Seat #1 is the button
Seat 6: Nicedaymybro ($100 in chips) is sitting out
Seat 1: Pon4uk.ua ($233.35 in chips) 
Seat 2: jockywils100 ($95.57 in chips) 
Seat 3: coeeeelho ($176.25 in chips) 
Seat 4: ka100pka527 ($102.50 in chips) 
Seat 5: ptolejmus ($11.65 in chips) 
jockywils100: posts small blind $0.50
coeeeelho: posts big blind $1
Nicedaymybro: sits out 
*** HOLE CARDS ***
ka100pka527: folds 
ptolejmus: folds 
Pon4uk.ua: folds 
jockywils100: raises $2 to $3
coeeeelho: folds 
Uncalled bet ($2) returned to jockywils100
jockywils100 collected $2 from pot
*** SUMMARY ***
Total pot $2 | Rake $0 
Seat 6: Nicedaymybro
Seat 1: Pon4uk.ua (button) folded before Flop (didn't bet)
Seat 2: jockywils100 (small blind) collected ($2)
Seat 3: coeeeelho (big blind) folded before Flop
Seat 4: ka100pka527 folded before Flop (didn't bet)
Seat 5: ptolejmus folded before Flop (didn't bet)



PokerStars Hand #254396621457:  Hold'em No Limit ($0.50/$1.00 USD) - 2025/01/16 11:57:02 WET [2025/01/16 6:57:02 ET]
Table 'Stereoskopia III' 6-max Seat #2 is the button
Seat 6: Nicedaymybro ($100 in chips) is sitting out
Seat 1: Pon4uk.ua ($233.35 in chips) 
Seat 2: jockywils100 ($96.57 in chips) 
Seat 3: coeeeelho ($175.25 in chips) 
Seat 4: ka100pka527 ($102.50 in chips) 
Seat 5: ptolejmus ($11.65 in chips) 
coeeeelho: posts small blind $0.50
ka100pka527: posts big blind $1
Nicedaymybro: sits out 
*** HOLE CARDS ***
ptolejmus: folds 
Pon4uk.ua: folds 
jockywils100: raises $2 to $3
coeeeelho: folds 
ka100pka527: folds 
Uncalled bet ($2) returned to jockywils100
jockywils100 collected $2.50 from pot
*** SUMMARY ***
Total pot $2.50 | Rake $0 
Seat 6: Nicedaymybro
Seat 1: Pon4uk.ua folded before Flop (didn't bet)
Seat 2: jockywils100 (button) collected ($2.50)
Seat 3: coeeeelho (small blind) folded before Flop
Seat 4: ka100pka527 (big blind) folded before Flop
Seat 5: ptolejmus folded before Flop (didn't bet)



PokerStars Hand #254396623850:  Hold'em No Limit ($0.50/$1.00 USD) - 2025/01/16 11:57:24 WET [2025/01/16 6:57:24 ET]
Table 'Stereoskopia III' 6-max Seat #3 is the button
Seat 6: Nicedaymybro ($100 in chips) is sitting out
Seat 1: Pon4uk.ua ($233.35 in chips) 
Seat 2: jockywils100 ($98.07 in chips) 
Seat 3: coeeeelho ($174.75 in chips) 
Seat 4: ka100pka527 ($101.50 in chips) 
Seat 5: ptolejmus ($11.65 in chips) 
ka100pka527: posts small blind $0.50
ptolejmus: posts big blind $1
Nicedaymybro: sits out 
*** HOLE CARDS ***
Pon4uk.ua: folds 
jockywils100: folds 
coeeeelho: raises $1.50 to $2.50
ka100pka527: folds 
ptolejmus: folds 
Uncalled bet ($1.50) returned to coeeeelho
coeeeelho collected $2.50 from pot
*** SUMMARY ***
Total pot $2.50 | Rake $0 
Seat 6: Nicedaymybro
Seat 1: Pon4uk.ua folded before Flop (didn't bet)
Seat 2: jockywils100 folded before Flop (didn't bet)
Seat 3: coeeeelho (button) collected ($2.50)
Seat 4: ka100pka527 (small blind) folded before Flop
Seat 5: ptolejmus (big blind) folded before Flop



PokerStars Hand #254396626388:  Hold'em No Limit ($0.50/$1.00 USD) - 2025/01/16 11:57:47 WET [2025/01/16 6:57:47 ET]
Table 'Stereoskopia III' 6-max Seat #4 is the button
Seat 1: Pon4uk.ua ($233.35 in chips) 
Seat 2: jockywils100 ($98.07 in chips) 
Seat 3: coeeeelho ($176.25 in chips) 
Seat 4: ka100pka527 ($101 in chips) 
Seat 5: ptolejmus ($10.65 in chips) 
Seat 6: Nicedaymybro ($100 in chips) 
ptolejmus: posts small blind $0.50
Nicedaymybro: posts big blind $1
*** HOLE CARDS ***
Pon4uk.ua: folds 
jockywils100: folds 
coeeeelho: folds 
ka100pka527: raises $1.50 to $2.50
ptolejmus: folds 
Nicedaymybro: calls $1.50
*** FLOP *** [7h 6c Td]
Nicedaymybro: checks 
Pon4uk.ua leaves the table
ka100pka527: checks 
*** TURN *** [7h 6c Td] [2c]
Nicedaymybro: bets $2.61
ka100pka527: calls $2.61
*** RIVER *** [7h 6c Td 2c] [3s]
Nicedaymybro: bets $10.18
ka100pka527: folds 
Uncalled bet ($10.18) returned to Nicedaymybro
Nicedaymybro collected $10.18 from pot
Nicedaymybro: doesn't show hand 
*** SUMMARY ***
Total pot $10.72 | Rake $0.54 
Board [7h 6c Td 2c 3s]
Seat 1: Pon4uk.ua folded before Flop (didn't bet)
Seat 2: jockywils100 folded before Flop (didn't bet)
Seat 3: coeeeelho folded before Flop (didn't bet)
Seat 4: ka100pka527 (button) folded on the River
Seat 5: ptolejmus (small blind) folded before Flop
Seat 6: Nicedaymybro (big blind) collected ($10.18)



PokerStars Hand #254396636601:  Hold'em No Limit ($0.50/$1.00 USD) - 2025/01/16 11:59:23 WET [2025/01/16 6:59:23 ET]
Table 'Stereoskopia III' 6-max Seat #5 is the button
Seat 2: jockywils100 ($98.07 in chips) 
Seat 3: coeeeelho ($176.25 in chips) 
Seat 4: ka100pka527 ($100 in chips) 
Seat 5: ptolejmus ($10.15 in chips) 
Seat 6: Nicedaymybro ($105.07 in chips) 
Nicedaymybro: posts small blind $0.50
jockywils100: posts big blind $1
*** HOLE CARDS ***
coeeeelho: folds 
ka100pka527: folds 
ptolejmus: raises $9.15 to $10.15 and is all-in
Nicedaymybro: calls $9.65
jockywils100: folds 
*** FIRST FLOP *** [7d 6h Qs]
*** FIRST TURN *** [7d 6h Qs] [6d]
*** FIRST RIVER *** [7d 6h Qs 6d] [7s]
*** SECOND FLOP *** [2c Jc Qd]
*** SECOND TURN *** [2c Jc Qd] [Jh]
*** SECOND RIVER *** [2c Jc Qd Jh] [5s]
*** FIRST SHOW DOWN ***
Nicedaymybro: shows [Ah Qh] (two pair, Queens and Sevens)
ptolejmus: shows [Qc Tc] (two pair, Queens and Sevens - lower kicker)
Nicedaymybro collected $10.12 from pot
*** SECOND SHOW DOWN ***
Nicedaymybro: shows [Ah Qh] (two pair, Queens and Jacks)
ptolejmus: shows [Qc Tc] (two pair, Queens and Jacks - lower kicker)
Nicedaymybro collected $10.12 from pot
*** SUMMARY ***
Total pot $21.30 | Rake $1.06 
Hand was run twice
FIRST Board [7d 6h Qs 6d 7s]
SECOND Board [2c Jc Qd Jh 5s]
Seat 2: jockywils100 (big blind) folded before Flop
Seat 3: coeeeelho folded before Flop (didn't bet)
Seat 4: ka100pka527 folded before Flop (didn't bet)
Seat 5: ptolejmus (button) showed [Qc Tc] and lost with two pair, Queens and Sevens, and lost with two pair, Queens and Jacks
Seat 6: Nicedaymybro (small blind) showed [Ah Qh] and won ($10.12) with two pair, Queens and Sevens, and won ($10.12) with two pair, Queens and Jacks



PokerStars Hand #254396639836:  Hold'em No Limit ($0.50/$1.00 USD) - 2025/01/16 11:59:52 WET [2025/01/16 6:59:52 ET]
Table 'Stereoskopia III' 6-max Seat #6 is the button
Seat 2: jockywils100 ($97.07 in chips) 
Seat 3: coeeeelho ($176.25 in chips) 
Seat 4: ka100pka527 ($100 in chips) 
Seat 5: ptolejmus ($10 in chips) 
Seat 6: Nicedaymybro ($115.16 in chips) 
jockywils100: posts small blind $0.50
coeeeelho: posts big blind $1
*** HOLE CARDS ***
ka100pka527: folds 
ptolejmus: folds 
Nicedaymybro: raises $1.50 to $2.50
jockywils100: folds 
coeeeelho: folds 
Uncalled bet ($1.50) returned to Nicedaymybro
Nicedaymybro collected $2.50 from pot
Nicedaymybro: doesn't show hand 
kvcsszblcs joins the table at seat #1 
*** SUMMARY ***
Total pot $2.50 | Rake $0 
Seat 2: jockywils100 (small blind) folded before Flop
Seat 3: coeeeelho (big blind) folded before Flop
Seat 4: ka100pka527 folded before Flop (didn't bet)
Seat 5: ptolejmus folded before Flop (didn't bet)
Seat 6: Nicedaymybro (button) collected ($2.50)



PokerStars Hand #254396641623:  Hold'em No Limit ($0.50/$1.00 USD) - 2025/01/16 12:00:09 WET [2025/01/16 7:00:09 ET]
Table 'Stereoskopia III' 6-max Seat #2 is the button
Seat 1: kvcsszblcs ($100 in chips) is sitting out
Seat 2: jockywils100 ($96.57 in chips) 
Seat 3: coeeeelho ($175.25 in chips) 
Seat 4: ka100pka527 ($100 in chips) 
Seat 5: ptolejmus ($10 in chips) 
Seat 6: Nicedaymybro ($116.66 in chips) 
coeeeelho: posts small blind $0.50
ka100pka527: posts big blind $1
kvcsszblcs: sits out 
*** HOLE CARDS ***
ptolejmus: folds 
Nicedaymybro: folds 
jockywils100: folds 
coeeeelho: folds 
Uncalled bet ($0.50) returned to ka100pka527
ka100pka527 collected $1 from pot
ka100pka527: doesn't show hand 
*** SUMMARY ***
Total pot $1 | Rake $0 
Seat 1: kvcsszblcs
Seat 2: jockywils100 (button) folded before Flop (didn't bet)
Seat 3: coeeeelho (small blind) folded before Flop
Seat 4: ka100pka527 (big blind) collected ($1)
Seat 5: ptolejmus folded before Flop (didn't bet)
Seat 6: Nicedaymybro folded before Flop (didn't bet)



PokerStars Hand #254396642747:  Hold'em No Limit ($0.50/$1.00 USD) - 2025/01/16 12:00:19 WET [2025/01/16 7:00:19 ET]
Table 'Stereoskopia III' 6-max Seat #3 is the button
Seat 1: kvcsszblcs ($100 in chips) is sitting out
Seat 2: jockywils100 ($96.57 in chips) 
Seat 3: coeeeelho ($174.75 in chips) 
Seat 4: ka100pka527 ($100.50 in chips) 
Seat 5: ptolejmus ($10 in chips) 
Seat 6: Nicedaymybro ($116.66 in chips) 
ka100pka527: posts small blind $0.50
ptolejmus: posts big blind $1
kvcsszblcs: sits out 
*** HOLE CARDS ***
Nicedaymybro: folds 
jockywils100: folds 
coeeeelho: folds 
ka100pka527: folds 
Uncalled bet ($0.50) returned to ptolejmus
ptolejmus collected $1 from pot
*** SUMMARY ***
Total pot $1 | Rake $0 
Seat 1: kvcsszblcs
Seat 2: jockywils100 folded before Flop (didn't bet)
Seat 3: coeeeelho (button) folded before Flop (didn't bet)
Seat 4: ka100pka527 (small blind) folded before Flop
Seat 5: ptolejmus (big blind) collected ($1)
Seat 6: Nicedaymybro folded before Flop (didn't bet)



PokerStars Hand #254396644654:  Hold'em No Limit ($0.50/$1.00 USD) - 2025/01/16 12:00:36 WET [2025/01/16 7:00:36 ET]
Table 'Stereoskopia III' 6-max Seat #4 is the button
Seat 1: kvcsszblcs ($100 in chips) is sitting out
Seat 2: jockywils100 ($96.57 in chips) 
Seat 3: coeeeelho ($174.75 in chips) 
Seat 4: ka100pka527 ($100 in chips) 
Seat 5: ptolejmus ($10.50 in chips) 
Seat 6: Nicedaymybro ($116.66 in chips) 
ptolejmus: posts small blind $0.50
Nicedaymybro: posts big blind $1
kvcsszblcs: sits out 
*** HOLE CARDS ***
jockywils100: raises $1 to $2
coeeeelho: folds 
ka100pka527: folds 
ptolejmus: folds 
Nicedaymybro: folds 
Uncalled bet ($1) returned to jockywils100
jockywils100 collected $2.50 from pot
*** SUMMARY ***
Total pot $2.50 | Rake $0 
Seat 1: kvcsszblcs
Seat 2: jockywils100 collected ($2.50)
Seat 3: coeeeelho folded before Flop (didn't bet)
Seat 4: ka100pka527 (button) folded before Flop (didn't bet)
Seat 5: ptolejmus (small blind) folded before Flop
Seat 6: Nicedaymybro (big blind) folded before Flop



PokerStars Hand #254396647128:  Hold'em No Limit ($0.50/$1.00 USD) - 2025/01/16 12:00:55 WET [2025/01/16 7:00:55 ET]
Table 'Stereoskopia III' 6-max Seat #5 is the button
Seat 1: kvcsszblcs ($100 in chips) 
Seat 2: jockywils100 ($98.07 in chips) 
Seat 3: coeeeelho ($174.75 in chips) 
Seat 4: ka100pka527 ($100 in chips) 
Seat 5: ptolejmus ($10 in chips) 
Seat 6: Nicedaymybro ($115.66 in chips) 
Nicedaymybro: posts small blind $0.50
kvcsszblcs: posts big blind $1
*** HOLE CARDS ***
jockywils100: folds 
coeeeelho: folds 
ka100pka527: raises $1 to $2
ptolejmus: folds 
Nicedaymybro: folds 
kvcsszblcs: folds 
Uncalled bet ($1) returned to ka100pka527
ka100pka527 collected $2.50 from pot
ka100pka527: doesn't show hand 
*** SUMMARY ***
Total pot $2.50 | Rake $0 
Seat 1: kvcsszblcs (big blind) folded before Flop
Seat 2: jockywils100 folded before Flop (didn't bet)
Seat 3: coeeeelho folded before Flop (didn't bet)
Seat 4: ka100pka527 collected ($2.50)
Seat 5: ptolejmus (button) folded before Flop (didn't bet)
Seat 6: Nicedaymybro (small blind) folded before Flop



PokerStars Hand #254396649528:  Hold'em No Limit ($0.50/$1.00 USD) - 2025/01/16 12:01:14 WET [2025/01/16 7:01:14 ET]
Table 'Stereoskopia III' 6-max Seat #6 is the button
Seat 1: kvcsszblcs ($100 in chips) 
Seat 2: jockywils100 ($98.07 in chips) 
Seat 3: coeeeelho ($174.75 in chips) 
Seat 4: ka100pka527 ($101.50 in chips) 
Seat 5: ptolejmus ($10 in chips) 
Seat 6: Nicedaymybro ($115.16 in chips) 
kvcsszblcs: posts small blind $0.50
jockywils100: posts big blind $1
*** HOLE CARDS ***
coeeeelho: folds 
ka100pka527: folds 
ptolejmus: folds 
Nicedaymybro: folds 
kvcsszblcs: folds 
Uncalled bet ($0.50) returned to jockywils100
jockywils100 collected $1 from pot
*** SUMMARY ***
Total pot $1 | Rake $0 
Seat 1: kvcsszblcs (small blind) folded before Flop
Seat 2: jockywils100 (big blind) collected ($1)
Seat 3: coeeeelho folded before Flop (didn't bet)
Seat 4: ka100pka527 folded before Flop (didn't bet)
Seat 5: ptolejmus folded before Flop (didn't bet)
Seat 6: Nicedaymybro (button) folded before Flop (didn't bet)



PokerStars Hand #254396651861:  Hold'em No Limit ($0.50/$1.00 USD) - 2025/01/16 12:01:32 WET [2025/01/16 7:01:32 ET]
Table 'Stereoskopia III' 6-max Seat #1 is the button
Seat 1: kvcsszblcs ($100 in chips) 
Seat 2: jockywils100 ($98.57 in chips) 
Seat 3: coeeeelho ($174.75 in chips) 
Seat 4: ka100pka527 ($101.50 in chips) 
Seat 5: ptolejmus ($10 in chips) 
Seat 6: Nicedaymybro ($115.16 in chips) 
jockywils100: posts small blind $0.50
coeeeelho: posts big blind $1
*** HOLE CARDS ***
ka100pka527: folds 
ptolejmus: folds 
Nicedaymybro: raises $1.50 to $2.50
kvcsszblcs: folds 
jockywils100: folds 
coeeeelho: raises $10 to $12.50
Nicedaymybro: folds 
Uncalled bet ($10) returned to coeeeelho
coeeeelho collected $5.50 from pot
*** SUMMARY ***
Total pot $5.50 | Rake $0 
Seat 1: kvcsszblcs (button) folded before Flop (didn't bet)
Seat 2: jockywils100 (small blind) folded before Flop
Seat 3: coeeeelho (big blind) collected ($5.50)
Seat 4: ka100pka527 folded before Flop (didn't bet)
Seat 5: ptolejmus folded before Flop (didn't bet)
Seat 6: Nicedaymybro folded before Flop



PokerStars Hand #254396654766:  Hold'em No Limit ($0.50/$1.00 USD) - 2025/01/16 12:01:55 WET [2025/01/16 7:01:55 ET]
Table 'Stereoskopia III' 6-max Seat #2 is the button
Seat 4: ka100pka527 ($101.50 in chips) is sitting out
Seat 1: kvcsszblcs ($100 in chips) 
Seat 2: jockywils100 ($98.07 in chips) 
Seat 3: coeeeelho ($177.75 in chips) 
Seat 5: ptolejmus ($10 in chips) 
Seat 6: Nicedaymybro ($112.66 in chips) 
coeeeelho: posts small blind $0.50
ptolejmus: posts big blind $1
*** HOLE CARDS ***
Nicedaymybro: folds 
kvcsszblcs: raises $1 to $2
jockywils100: folds 
coeeeelho: raises $7 to $9
ptolejmus: folds 
kvcsszblcs: folds 
Uncalled bet ($7) returned to coeeeelho
coeeeelho collected $5 from pot
*** SUMMARY ***
Total pot $5 | Rake $0 
Seat 4: ka100pka527
Seat 1: kvcsszblcs folded before Flop
Seat 2: jockywils100 (button) folded before Flop (didn't bet)
Seat 3: coeeeelho (small blind) collected ($5)
Seat 5: ptolejmus (big blind) folded before Flop
Seat 6: Nicedaymybro folded before Flop (didn't bet)



PokerStars Hand #254396658085:  Hold'em No Limit ($0.50/$1.00 USD) - 2025/01/16 12:02:21 WET [2025/01/16 7:02:21 ET]
Table 'Stereoskopia III' 6-max Seat #3 is the button
Seat 4: ka100pka527 ($101.50 in chips) is sitting out
Seat 1: kvcsszblcs ($100 in chips) 
Seat 2: jockywils100 ($98.07 in chips) 
Seat 3: coeeeelho ($180.75 in chips) 
Seat 5: ptolejmus ($10 in chips) 
Seat 6: Nicedaymybro ($112.66 in chips) 
ptolejmus: posts small blind $0.50
Nicedaymybro: posts big blind $1
*** HOLE CARDS ***
kvcsszblcs: raises $1 to $2
jockywils100: raises $2 to $4
coeeeelho: folds 
ptolejmus: folds 
Nicedaymybro: folds 
kvcsszblcs: calls $2
*** FLOP *** [6s Qc 2c]
kvcsszblcs: checks 
jockywils100: checks 
*** TURN *** [6s Qc 2c] [8c]
kvcsszblcs: bets $6.77
jockywils100: folds 
Uncalled bet ($6.77) returned to kvcsszblcs
kvcsszblcs collected $9.02 from pot
kvcsszblcs: doesn't show hand 
*** SUMMARY ***
Total pot $9.50 | Rake $0.48 
Board [6s Qc 2c 8c]
Seat 4: ka100pka527
Seat 1: kvcsszblcs collected ($9.02)
Seat 2: jockywils100 folded on the Turn
Seat 3: coeeeelho (button) folded before Flop (didn't bet)
Seat 5: ptolejmus (small blind) folded before Flop
Seat 6: Nicedaymybro (big blind) folded before Flop



PokerStars Hand #254396664725:  Hold'em No Limit ($0.50/$1.00 USD) - 2025/01/16 12:03:12 WET [2025/01/16 7:03:12 ET]
Table 'Stereoskopia III' 6-max Seat #5 is the button
Seat 4: ka100pka527 ($101.50 in chips) is sitting out
Seat 1: kvcsszblcs ($105.02 in chips) 
Seat 2: jockywils100 ($94.07 in chips) 
Seat 3: coeeeelho ($180.75 in chips) 
Seat 5: ptolejmus ($10 in chips) 
Seat 6: Nicedaymybro ($111.66 in chips) 
Nicedaymybro: posts small blind $0.50
kvcsszblcs: posts big blind $1
*** HOLE CARDS ***
jockywils100: folds 
coeeeelho: folds 
ptolejmus: raises $9 to $10 and is all-in
Nicedaymybro: folds 
kvcsszblcs: folds 
Uncalled bet ($9) returned to ptolejmus
ptolejmus collected $2.50 from pot
*** SUMMARY ***
Total pot $2.50 | Rake $0 
Seat 4: ka100pka527
Seat 1: kvcsszblcs (big blind) folded before Flop
Seat 2: jockywils100 folded before Flop (didn't bet)
Seat 3: coeeeelho folded before Flop (didn't bet)
Seat 5: ptolejmus (button) collected ($2.50)
Seat 6: Nicedaymybro (small blind) folded before Flop



PokerStars Hand #254396666986:  Hold'em No Limit ($0.50/$1.00 USD) - 2025/01/16 12:03:29 WET [2025/01/16 7:03:29 ET]
Table 'Stereoskopia III' 6-max Seat #6 is the button
Seat 4: ka100pka527 ($101.50 in chips) is sitting out
Seat 1: kvcsszblcs ($104.02 in chips) 
Seat 2: jockywils100 ($94.07 in chips) 
Seat 3: coeeeelho ($180.75 in chips) 
Seat 5: ptolejmus ($11.50 in chips) 
Seat 6: Nicedaymybro ($111.16 in chips) 
kvcsszblcs: posts small blind $0.50
jockywils100: posts big blind $1
ka100pka527: sits out 
*** HOLE CARDS ***
coeeeelho: folds 
ptolejmus: raises $1 to $2
Nicedaymybro: folds 
kvcsszblcs: folds 
jockywils100: calls $1
*** FLOP *** [6h Js 7s]
jockywils100: checks 
ptolejmus: bets $1.16
jockywils100: calls $1.16
*** TURN *** [6h Js 7s] [6d]
jockywils100: checks 
ptolejmus: checks 
*** RIVER *** [6h Js 7s 6d] [5h]
jockywils100: bets $3.24
ptolejmus: calls $3.24
*** SHOW DOWN ***
jockywils100: shows [8c 7d] (two pair, Sevens and Sixes)
ptolejmus: shows [7h As] (two pair, Sevens and Sixes - Ace kicker)
ptolejmus collected $12.64 from pot
*** SUMMARY ***
Total pot $13.30 | Rake $0.66 
Board [6h Js 7s 6d 5h]
Seat 4: ka100pka527
Seat 1: kvcsszblcs (small blind) folded before Flop
Seat 2: jockywils100 (big blind) showed [8c 7d] and lost with two pair, Sevens and Sixes
Seat 3: coeeeelho folded before Flop (didn't bet)
Seat 5: ptolejmus showed [7h As] and won ($12.64) with two pair, Sevens and Sixes
Seat 6: Nicedaymybro (button) folded before Flop (didn't bet)



PokerStars Hand #254396673365:  Hold'em No Limit ($0.50/$1.00 USD) - 2025/01/16 12:04:19 WET [2025/01/16 7:04:19 ET]
Table 'Stereoskopia III' 6-max Seat #1 is the button
Seat 4: ka100pka527 ($101.50 in chips) is sitting out
Seat 1: kvcsszblcs ($103.52 in chips) 
Seat 2: jockywils100 ($87.67 in chips) 
Seat 3: coeeeelho ($180.75 in chips) 
Seat 5: ptolejmus ($17.74 in chips) 
Seat 6: Nicedaymybro ($111.16 in chips) 
jockywils100: posts small blind $0.50
coeeeelho: posts big blind $1
ka100pka527: sits out 
*** HOLE CARDS ***
ptolejmus: folds 
Nicedaymybro: folds 
kvcsszblcs: raises $1.25 to $2.25
jockywils100: folds 
coeeeelho: folds 
Uncalled bet ($1.25) returned to kvcsszblcs
kvcsszblcs collected $2.50 from pot
kvcsszblcs: doesn't show hand 
*** SUMMARY ***
Total pot $2.50 | Rake $0 
Seat 4: ka100pka527
Seat 1: kvcsszblcs (button) collected ($2.50)
Seat 2: jockywils100 (small blind) folded before Flop
Seat 3: coeeeelho (big blind) folded before Flop
Seat 5: ptolejmus folded before Flop (didn't bet)
Seat 6: Nicedaymybro folded before Flop (didn't bet)



PokerStars Hand #254396674900:  Hold'em No Limit ($0.50/$1.00 USD) - 2025/01/16 12:04:30 WET [2025/01/16 7:04:30 ET]
Table 'Stereoskopia III' 6-max Seat #2 is the button
Seat 1: kvcsszblcs ($105.02 in chips) 
Seat 2: jockywils100 ($87.17 in chips) 
Seat 3: coeeeelho ($179.75 in chips) 
Seat 4: ka100pka527 ($101.50 in chips) 
Seat 5: ptolejmus ($17.74 in chips) 
Seat 6: Nicedaymybro ($111.16 in chips) 
coeeeelho: posts small blind $0.50
ka100pka527: posts big blind $1
*** HOLE CARDS ***
ptolejmus: folds 
Nicedaymybro: raises $1.50 to $2.50
kvcsszblcs: raises $5 to $7.50
jockywils100: folds 
coeeeelho: folds 
ka100pka527: folds 
Nicedaymybro: folds 
Uncalled bet ($5) returned to kvcsszblcs
kvcsszblcs collected $6.50 from pot
kvcsszblcs: doesn't show hand 
*** SUMMARY ***
Total pot $6.50 | Rake $0 
Seat 1: kvcsszblcs collected ($6.50)
Seat 2: jockywils100 (button) folded before Flop (didn't bet)
Seat 3: coeeeelho (small blind) folded before Flop
Seat 4: ka100pka527 (big blind) folded before Flop
Seat 5: ptolejmus folded before Flop (didn't bet)
Seat 6: Nicedaymybro folded before Flop



PokerStars Hand #254396677377:  Hold'em No Limit ($0.50/$1.00 USD) - 2025/01/16 12:04:48 WET [2025/01/16 7:04:48 ET]
Table 'Stereoskopia III' 6-max Seat #3 is the button
Seat 1: kvcsszblcs ($109.02 in chips) 
Seat 2: jockywils100 ($87.17 in chips) 
Seat 3: coeeeelho ($179.25 in chips) 
Seat 4: ka100pka527 ($100.50 in chips) 
Seat 5: ptolejmus ($17.74 in chips) 
Seat 6: Nicedaymybro ($108.66 in chips) 
ka100pka527: posts small blind $0.50
ptolejmus: posts big blind $1
*** HOLE CARDS ***
Nicedaymybro: folds 
kvcsszblcs: folds 
jockywils100: folds 
coeeeelho: folds 
ka100pka527: folds 
Uncalled bet ($0.50) returned to ptolejmus
ptolejmus collected $1 from pot
*** SUMMARY ***
Total pot $1 | Rake $0 
Seat 1: kvcsszblcs folded before Flop (didn't bet)
Seat 2: jockywils100 folded before Flop (didn't bet)
Seat 3: coeeeelho (button) folded before Flop (didn't bet)
Seat 4: ka100pka527 (small blind) folded before Flop
Seat 5: ptolejmus (big blind) collected ($1)
Seat 6: Nicedaymybro folded before Flop (didn't bet)



PokerStars Hand #254396679936:  Hold'em No Limit ($0.50/$1.00 USD) - 2025/01/16 12:05:08 WET [2025/01/16 7:05:08 ET]
Table 'Stereoskopia III' 6-max Seat #4 is the button
Seat 1: kvcsszblcs ($109.02 in chips) 
Seat 2: jockywils100 ($87.17 in chips) 
Seat 3: coeeeelho ($179.25 in chips) 
Seat 4: ka100pka527 ($100 in chips) 
Seat 5: ptolejmus ($18.24 in chips) 
Seat 6: Nicedaymybro ($108.66 in chips) 
ptolejmus: posts small blind $0.50
Nicedaymybro: posts big blind $1
*** HOLE CARDS ***
kvcsszblcs: folds 
jockywils100: calls $1
coeeeelho: folds 
ka100pka527: folds 
ptolejmus: folds 
Nicedaymybro: checks 
*** FLOP *** [2d Ah 7s]
Nicedaymybro: checks 
jockywils100: checks 
*** TURN *** [2d Ah 7s] [3h]
Nicedaymybro: checks 
jockywils100: bets $2.38
Nicedaymybro: folds 
Uncalled bet ($2.38) returned to jockywils100
jockywils100 collected $2.38 from pot
*** SUMMARY ***
Total pot $2.50 | Rake $0.12 
Board [2d Ah 7s 3h]
Seat 1: kvcsszblcs folded before Flop (didn't bet)
Seat 2: jockywils100 collected ($2.38)
Seat 3: coeeeelho folded before Flop (didn't bet)
Seat 4: ka100pka527 (button) folded before Flop (didn't bet)
Seat 5: ptolejmus (small blind) folded before Flop
Seat 6: Nicedaymybro (big blind) folded on the Turn



PokerStars Hand #254396684698:  Hold'em No Limit ($0.50/$1.00 USD) - 2025/01/16 12:05:44 WET [2025/01/16 7:05:44 ET]
Table 'Stereoskopia III' 6-max Seat #5 is the button
Seat 1: kvcsszblcs ($109.02 in chips) 
Seat 2: jockywils100 ($88.55 in chips) 
Seat 3: coeeeelho ($179.25 in chips) 
Seat 4: ka100pka527 ($100 in chips) 
Seat 5: ptolejmus ($17.74 in chips) 
Seat 6: Nicedaymybro ($107.66 in chips) 
Nicedaymybro: posts small blind $0.50
kvcsszblcs: posts big blind $1
*** HOLE CARDS ***
jockywils100: raises $2 to $3
coeeeelho: folds 
ka100pka527: folds 
ptolejmus: folds 
Nicedaymybro: folds 
kvcsszblcs: folds 
Uncalled bet ($2) returned to jockywils100
jockywils100 collected $2.50 from pot
*** SUMMARY ***
Total pot $2.50 | Rake $0 
Seat 1: kvcsszblcs (big blind) folded before Flop
Seat 2: jockywils100 collected ($2.50)
Seat 3: coeeeelho folded before Flop (didn't bet)
Seat 4: ka100pka527 folded before Flop (didn't bet)
Seat 5: ptolejmus (button) folded before Flop (didn't bet)
Seat 6: Nicedaymybro (small blind) folded before Flop



PokerStars Hand #254396686625:  Hold'em No Limit ($0.50/$1.00 USD) - 2025/01/16 12:05:58 WET [2025/01/16 7:05:58 ET]
Table 'Stereoskopia III' 6-max Seat #6 is the button
Seat 1: kvcsszblcs ($108.02 in chips) 
Seat 2: jockywils100 ($90.05 in chips) 
Seat 3: coeeeelho ($179.25 in chips) 
Seat 4: ka100pka527 ($100 in chips) 
Seat 5: ptolejmus ($17.74 in chips) 
Seat 6: Nicedaymybro ($107.16 in chips) 
kvcsszblcs: posts small blind $0.50
jockywils100: posts big blind $1
*** HOLE CARDS ***
coeeeelho: raises $1.20 to $2.20
ka100pka527: folds 
ptolejmus: raises $15.54 to $17.74 and is all-in
Nicedaymybro: folds 
kvcsszblcs: folds 
jockywils100: folds 
coeeeelho: folds 
Uncalled bet ($15.54) returned to ptolejmus
ptolejmus collected $5.90 from pot
*** SUMMARY ***
Total pot $5.90 | Rake $0 
Seat 1: kvcsszblcs (small blind) folded before Flop
Seat 2: jockywils100 (big blind) folded before Flop
Seat 3: coeeeelho folded before Flop
Seat 4: ka100pka527 folded before Flop (didn't bet)
Seat 5: ptolejmus collected ($5.90)
Seat 6: Nicedaymybro (button) folded before Flop (didn't bet)



PokerStars Hand #254396690745:  Hold'em No Limit ($0.50/$1.00 USD) - 2025/01/16 12:06:30 WET [2025/01/16 7:06:30 ET]
Table 'Stereoskopia III' 6-max Seat #1 is the button
Seat 1: kvcsszblcs ($107.52 in chips) 
Seat 2: jockywils100 ($89.05 in chips) 
Seat 3: coeeeelho ($177.05 in chips) 
Seat 4: ka100pka527 ($100 in chips) 
Seat 5: ptolejmus ($21.44 in chips) 
Seat 6: Nicedaymybro ($107.16 in chips) 
jockywils100: posts small blind $0.50
coeeeelho: posts big blind $1
*** HOLE CARDS ***
ka100pka527: raises $2 to $3
ptolejmus: folds 
Nicedaymybro: folds 
kvcsszblcs: folds 
jockywils100: calls $2.50
coeeeelho: folds 
*** FLOP *** [9c Jh As]
jockywils100: checks 
ka100pka527: bets $5.05
jockywils100: calls $5.05
*** TURN *** [9c Jh As] [4s]
jockywils100: checks 
ka100pka527: bets $10.83
jockywils100: calls $10.83
*** RIVER *** [9c Jh As 4s] [9s]
jockywils100: bets $26.41
ka100pka527: raises $54.71 to $81.12 and is all-in
jockywils100: folds 
Uncalled bet ($54.71) returned to ka100pka527
ka100pka527 collected $89.08 from pot
ka100pka527: doesn't show hand 
*** SUMMARY ***
Total pot $91.58 | Rake $2.50 
Board [9c Jh As 4s 9s]
Seat 1: kvcsszblcs (button) folded before Flop (didn't bet)
Seat 2: jockywils100 (small blind) folded on the River
Seat 3: coeeeelho (big blind) folded before Flop
Seat 4: ka100pka527 collected ($89.08)
Seat 5: ptolejmus folded before Flop (didn't bet)
Seat 6: Nicedaymybro folded before Flop (didn't bet)



PokerStars Hand #254396705283:  Hold'em No Limit ($0.50/$1.00 USD) - 2025/01/16 12:08:20 WET [2025/01/16 7:08:20 ET]
Table 'Stereoskopia III' 6-max Seat #2 is the button
Seat 1: kvcsszblcs ($107.52 in chips) 
Seat 2: jockywils100 ($43.76 in chips) 
Seat 3: coeeeelho ($176.05 in chips) 
Seat 4: ka100pka527 ($143.79 in chips) 
Seat 5: ptolejmus ($21.44 in chips) 
Seat 6: Nicedaymybro ($107.16 in chips) 
coeeeelho: posts small blind $0.50
ka100pka527: posts big blind $1
*** HOLE CARDS ***
ptolejmus: folds 
Nicedaymybro: folds 
kvcsszblcs: raises $1 to $2
jockywils100: folds 
jockywils100 leaves the table
coeeeelho: raises $8 to $10
ka100pka527: folds 
kvcsszblcs: folds 
Uncalled bet ($8) returned to coeeeelho
coeeeelho collected $5 from pot
*** SUMMARY ***
Total pot $5 | Rake $0 
Seat 1: kvcsszblcs folded before Flop
Seat 2: jockywils100 (button) folded before Flop (didn't bet)
Seat 3: coeeeelho (small blind) collected ($5)
Seat 4: ka100pka527 (big blind) folded before Flop
Seat 5: ptolejmus folded before Flop (didn't bet)
Seat 6: Nicedaymybro folded before Flop (didn't bet)



PokerStars Hand #254396707860:  Hold'em No Limit ($0.50/$1.00 USD) - 2025/01/16 12:08:39 WET [2025/01/16 7:08:39 ET]
Table 'Stereoskopia III' 6-max Seat #3 is the button
Seat 1: kvcsszblcs ($105.52 in chips) 
Seat 3: coeeeelho ($179.05 in chips) 
Seat 4: ka100pka527 ($142.79 in chips) 
Seat 5: ptolejmus ($21.44 in chips) 
Seat 6: Nicedaymybro ($107.16 in chips) 
ka100pka527: posts small blind $0.50
ptolejmus: posts big blind $1
*** HOLE CARDS ***
Nicedaymybro: folds 
Nicedaymybro leaves the table
kvcsszblcs: folds 
coeeeelho: raises $1.50 to $2.50
Freebet1 joins the table at seat #6 
Freebet1 is disconnected 
ka100pka527: calls $2
ptolejmus: folds 
*** FLOP *** [2d 6d 8d]
ka100pka527: checks 
avstero joins the table at seat #2 
coeeeelho: bets $1.43
ka100pka527: calls $1.43
*** TURN *** [2d 6d 8d] [5s]
ka100pka527: checks 
coeeeelho: bets $6.31
ka100pka527: calls $6.31
*** RIVER *** [2d 6d 8d 5s] [Qh]
ka100pka527: checks 
coeeeelho: bets $15.31
ka100pka527: calls $15.31
*** SHOW DOWN ***
coeeeelho: shows [5d Kd] (a flush, King high)
ka100pka527: mucks hand 
coeeeelho collected $49.60 from pot
*** SUMMARY ***
Total pot $52.10 | Rake $2.50 
Board [2d 6d 8d 5s Qh]
Seat 1: kvcsszblcs folded before Flop (didn't bet)
Seat 3: coeeeelho (button) showed [5d Kd] and won ($49.60) with a flush, King high
Seat 4: ka100pka527 (small blind) mucked
Seat 5: ptolejmus (big blind) folded before Flop
Seat 6: Nicedaymybro folded before Flop (didn't bet)



PokerStars Hand #254396719174:  Hold'em No Limit ($0.50/$1.00 USD) - 2025/01/16 12:10:03 WET [2025/01/16 7:10:03 ET]
Table 'Stereoskopia III' 6-max Seat #4 is the button
Seat 2: avstero ($100 in chips) is sitting out
Seat 1: kvcsszblcs ($105.52 in chips) 
Seat 3: coeeeelho ($203.10 in chips) 
Seat 4: ka100pka527 ($117.24 in chips) 
Seat 5: ptolejmus ($20.44 in chips) 
Seat 6: Freebet1 ($19.96 in chips) 
ptolejmus: posts small blind $0.50
Freebet1: posts big blind $1
avstero: sits out 
*** HOLE CARDS ***
kvcsszblcs: raises $1 to $2
coeeeelho: folds 
ka100pka527: folds 
ptolejmus: folds 
Freebet1: calls $1
*** FLOP *** [7c 6s Tc]
Freebet1: checks 
kvcsszblcs: bets $2.14
Freebet1: calls $2.14
*** TURN *** [7c 6s Tc] [5s]
Freebet1: checks 
kvcsszblcs: checks 
*** RIVER *** [7c 6s Tc 5s] [Jh]
Freebet1: checks 
kvcsszblcs: checks 
*** SHOW DOWN ***
Freebet1: shows [Jc 7s] (two pair, Jacks and Sevens)
kvcsszblcs: mucks hand 
Freebet1 collected $8.34 from pot
*** SUMMARY ***
Total pot $8.78 | Rake $0.44 
Board [7c 6s Tc 5s Jh]
Seat 2: avstero
Seat 1: kvcsszblcs mucked
Seat 3: coeeeelho folded before Flop (didn't bet)
Seat 4: ka100pka527 (button) folded before Flop (didn't bet)
Seat 5: ptolejmus (small blind) folded before Flop
Seat 6: Freebet1 (big blind) showed [Jc 7s] and won ($8.34) with two pair, Jacks and Sevens



PokerStars Hand #254396724413:  Hold'em No Limit ($0.50/$1.00 USD) - 2025/01/16 12:10:42 WET [2025/01/16 7:10:42 ET]
Table 'Stereoskopia III' 6-max Seat #5 is the button
Seat 2: avstero ($100 in chips) is sitting out
Seat 1: kvcsszblcs ($101.38 in chips) 
Seat 3: coeeeelho ($203.10 in chips) 
Seat 4: ka100pka527 ($117.24 in chips) 
Seat 5: ptolejmus ($19.94 in chips) 
Seat 6: Freebet1 ($24.16 in chips) 
Freebet1: posts small blind $0.50
kvcsszblcs: posts big blind $1
avstero: sits out 
*** HOLE CARDS ***
coeeeelho: raises $1.20 to $2.20
ka100pka527: raises $6.40 to $8.60
ptolejmus: raises $11.34 to $19.94 and is all-in
Freebet1: folds 
kvcsszblcs: folds 
coeeeelho: folds 
ka100pka527: calls $11.34
*** FIRST FLOP *** [4h 3s 7h]
*** FIRST TURN *** [4h 3s 7h] [6c]
*** FIRST RIVER *** [4h 3s 7h 6c] [5c]
*** SECOND FLOP *** [8h 4d 7d]
*** SECOND TURN *** [8h 4d 7d] [Kh]
*** SECOND RIVER *** [8h 4d 7d Kh] [Ac]
*** FIRST SHOW DOWN ***
ka100pka527: shows [Ah Qd] (a straight, Three to Seven)
ptolejmus: shows [Ts Th] (a straight, Three to Seven)
ka100pka527 collected $10.35 from pot
ptolejmus collected $10.35 from pot
*** SECOND SHOW DOWN ***
ka100pka527: shows [Ah Qd] (a pair of Aces)
ptolejmus: shows [Ts Th] (a pair of Tens)
ka100pka527 collected $20.70 from pot
*** SUMMARY ***
Total pot $43.58 | Rake $2.18 
Hand was run twice
FIRST Board [4h 3s 7h 6c 5c]
SECOND Board [8h 4d 7d Kh Ac]
Seat 2: avstero
Seat 1: kvcsszblcs (big blind) folded before Flop
Seat 3: coeeeelho folded before Flop
Seat 4: ka100pka527 showed [Ah Qd] and won ($10.35) with a straight, Three to Seven, and won ($20.70) with a pair of Aces
Seat 5: ptolejmus (button) showed [Ts Th] and won ($10.35) with a straight, Three to Seven, and lost with a pair of Tens
Seat 6: Freebet1 (small blind) folded before Flop



PokerStars Hand #254396730894:  Hold'em No Limit ($0.50/$1.00 USD) - 2025/01/16 12:11:30 WET [2025/01/16 7:11:30 ET]
Table 'Stereoskopia III' 6-max Seat #6 is the button
Seat 1: kvcsszblcs ($100.38 in chips) 
Seat 2: avstero ($100 in chips) 
Seat 3: coeeeelho ($200.90 in chips) 
Seat 4: ka100pka527 ($128.35 in chips) 
Seat 5: ptolejmus ($10.35 in chips) 
Seat 6: Freebet1 ($23.66 in chips) 
kvcsszblcs: posts small blind $0.50
avstero: posts big blind $1
*** HOLE CARDS ***
coeeeelho: folds 
ka100pka527: folds 
ptolejmus: raises $9.35 to $10.35 and is all-in
Freebet1: folds 
kvcsszblcs: folds 
avstero: calls $9.35
*** FIRST FLOP *** [Js Qc 3d]
*** FIRST TURN *** [Js Qc 3d] [4h]
*** FIRST RIVER *** [Js Qc 3d 4h] [8d]
*** SECOND FLOP *** [7h As Th]
*** SECOND TURN *** [7h As Th] [Tc]
*** SECOND RIVER *** [7h As Th Tc] [7s]
*** FIRST SHOW DOWN ***
avstero: shows [3c 3h] (three of a kind, Threes)
ptolejmus: shows [Ts Ac] (high card Ace)
avstero collected $10.07 from pot
*** SECOND SHOW DOWN ***
avstero: shows [3c 3h] (two pair, Tens and Sevens)
ptolejmus: shows [Ts Ac] (a full house, Tens full of Aces)
ptolejmus collected $10.07 from pot
*** SUMMARY ***
Total pot $21.20 | Rake $1.06 
Hand was run twice
FIRST Board [Js Qc 3d 4h 8d]
SECOND Board [7h As Th Tc 7s]
Seat 1: kvcsszblcs (small blind) folded before Flop
Seat 2: avstero (big blind) showed [3c 3h] and won ($10.07) with three of a kind, Threes, and lost with two pair, Tens and Sevens
Seat 3: coeeeelho folded before Flop (didn't bet)
Seat 4: ka100pka527 folded before Flop (didn't bet)
Seat 5: ptolejmus showed [Ts Ac] and lost with high card Ace, and won ($10.07) with a full house, Tens full of Aces
Seat 6: Freebet1 (button) folded before Flop (didn't bet)



PokerStars Hand #254396734115:  Hold'em No Limit ($0.50/$1.00 USD) - 2025/01/16 12:11:54 WET [2025/01/16 7:11:54 ET]
Table 'Stereoskopia III' 6-max Seat #1 is the button
Seat 1: kvcsszblcs ($100 in chips) 
Seat 2: avstero ($99.72 in chips) 
Seat 3: coeeeelho ($200.90 in chips) 
Seat 4: ka100pka527 ($128.35 in chips) 
Seat 5: ptolejmus ($10.07 in chips) 
Seat 6: Freebet1 ($23.66 in chips) 
avstero: posts small blind $0.50
coeeeelho: posts big blind $1
*** HOLE CARDS ***
ka100pka527: folds 
ptolejmus: folds 
Freebet1: raises $1 to $2
kvcsszblcs: raises $3.50 to $5.50
avstero: folds 
coeeeelho: folds 
Freebet1: calls $3.50
*** FLOP *** [4d 8h 7s]
Freebet1: checks 
kvcsszblcs: checks 
*** TURN *** [4d 8h 7s] [9s]
Freebet1: bets $3
kvcsszblcs: calls $3
*** RIVER *** [4d 8h 7s 9s] [6d]
Freebet1: bets $15.16 and is all-in
kvcsszblcs: folds 
Uncalled bet ($15.16) returned to Freebet1
Freebet1 collected $17.58 from pot
*** SUMMARY ***
Total pot $18.50 | Rake $0.92 
Board [4d 8h 7s 9s 6d]
Seat 1: kvcsszblcs (button) folded on the River
Seat 2: avstero (small blind) folded before Flop
Seat 3: coeeeelho (big blind) folded before Flop
Seat 4: ka100pka527 folded before Flop (didn't bet)
Seat 5: ptolejmus folded before Flop (didn't bet)
Seat 6: Freebet1 collected ($17.58)



PokerStars Hand #254396740327:  Hold'em No Limit ($0.50/$1.00 USD) - 2025/01/16 12:12:40 WET [2025/01/16 7:12:40 ET]
Table 'Stereoskopia III' 6-max Seat #2 is the button
Seat 1: kvcsszblcs ($100 in chips) 
Seat 2: avstero ($99.22 in chips) 
Seat 3: coeeeelho ($199.90 in chips) 
Seat 4: ka100pka527 ($128.35 in chips) 
Seat 5: ptolejmus ($10.07 in chips) 
Seat 6: Freebet1 ($32.74 in chips) 
coeeeelho: posts small blind $0.50
ka100pka527: posts big blind $1
*** HOLE CARDS ***
ptolejmus: folds 
Freebet1: folds 
kvcsszblcs: folds 
avstero: folds 
coeeeelho: folds 
Uncalled bet ($0.50) returned to ka100pka527
ka100pka527 collected $1 from pot
ka100pka527: doesn't show hand 
*** SUMMARY ***
Total pot $1 | Rake $0 
Seat 1: kvcsszblcs folded before Flop (didn't bet)
Seat 2: avstero (button) folded before Flop (didn't bet)
Seat 3: coeeeelho (small blind) folded before Flop
Seat 4: ka100pka527 (big blind) collected ($1)
Seat 5: ptolejmus folded before Flop (didn't bet)
Seat 6: Freebet1 folded before Flop (didn't bet)



PokerStars Hand #254396741925:  Hold'em No Limit ($0.50/$1.00 USD) - 2025/01/16 12:12:53 WET [2025/01/16 7:12:53 ET]
Table 'Stereoskopia III' 6-max Seat #3 is the button
Seat 1: kvcsszblcs ($100 in chips) 
Seat 2: avstero ($99.22 in chips) 
Seat 3: coeeeelho ($199.40 in chips) 
Seat 4: ka100pka527 ($128.85 in chips) 
Seat 5: ptolejmus ($10.07 in chips) 
Seat 6: Freebet1 ($32.74 in chips) 
ka100pka527: posts small blind $0.50
ptolejmus: posts big blind $1
*** HOLE CARDS ***
Freebet1: calls $1
kvcsszblcs: folds 
avstero: folds 
coeeeelho: folds 
ka100pka527: raises $4.50 to $5.50
ptolejmus: folds 
Freebet1: folds 
Uncalled bet ($4.50) returned to ka100pka527
ka100pka527 collected $3 from pot
ka100pka527: doesn't show hand 
*** SUMMARY ***
Total pot $3 | Rake $0 
Seat 1: kvcsszblcs folded before Flop (didn't bet)
Seat 2: avstero folded before Flop (didn't bet)
Seat 3: coeeeelho (button) folded before Flop (didn't bet)
Seat 4: ka100pka527 (small blind) collected ($3)
Seat 5: ptolejmus (big blind) folded before Flop
Seat 6: Freebet1 folded before Flop



PokerStars Hand #254396744601:  Hold'em No Limit ($0.50/$1.00 USD) - 2025/01/16 12:13:12 WET [2025/01/16 7:13:12 ET]
Table 'Stereoskopia III' 6-max Seat #4 is the button
Seat 1: kvcsszblcs ($100 in chips) 
Seat 2: avstero ($99.22 in chips) 
Seat 3: coeeeelho ($199.40 in chips) 
Seat 4: ka100pka527 ($130.85 in chips) 
Seat 5: ptolejmus ($10 in chips) 
Seat 6: Freebet1 ($31.74 in chips) 
ptolejmus: posts small blind $0.50
Freebet1: posts big blind $1
*** HOLE CARDS ***
kvcsszblcs: folds 
avstero: folds 
coeeeelho: raises $1.20 to $2.20
ka100pka527: folds 
ptolejmus: folds 
Freebet1: calls $1.20
*** FLOP *** [3d Qd 8s]
Freebet1: checks 
coeeeelho: bets $1.17
Freebet1: raises $4.17 to $5.34
coeeeelho: calls $4.17
*** TURN *** [3d Qd 8s] [Ad]
Freebet1: bets $8
coeeeelho: folds 
Uncalled bet ($8) returned to Freebet1
coeeeelho leaves the table
Freebet1 collected $14.80 from pot
*** SUMMARY ***
Total pot $15.58 | Rake $0.78 
Board [3d Qd 8s Ad]
Seat 1: kvcsszblcs folded before Flop (didn't bet)
Seat 2: avstero folded before Flop (didn't bet)
Seat 3: coeeeelho folded on the Turn
Seat 4: ka100pka527 (button) folded before Flop (didn't bet)
Seat 5: ptolejmus (small blind) folded before Flop
Seat 6: Freebet1 (big blind) collected ($14.80)



PokerStars Hand #254396751097:  Hold'em No Limit ($0.50/$1.00 USD) - 2025/01/16 12:14:01 WET [2025/01/16 7:14:01 ET]
Table 'Stereoskopia III' 6-max Seat #5 is the button
Seat 1: kvcsszblcs ($100 in chips) 
Seat 2: avstero ($99.22 in chips) 
Seat 4: ka100pka527 ($130.85 in chips) 
Seat 5: ptolejmus ($10 in chips) 
Seat 6: Freebet1 ($39 in chips) 
Freebet1: posts small blind $0.50
kvcsszblcs: posts big blind $1
*** HOLE CARDS ***
avstero: folds 
ka100pka527: raises $1.50 to $2.50
Evelexy1 joins the table at seat #3 
ptolejmus: folds 
Freebet1: folds 
kvcsszblcs: calls $1.50
*** FLOP *** [8h 2c Kd]
kvcsszblcs: checks 
ka100pka527: bets $1.72
kvcsszblcs: folds 
Uncalled bet ($1.72) returned to ka100pka527
ka100pka527 collected $5.22 from pot
ka100pka527: doesn't show hand 
*** SUMMARY ***
Total pot $5.50 | Rake $0.28 
Board [8h 2c Kd]
Seat 1: kvcsszblcs (big blind) folded on the Flop
Seat 2: avstero folded before Flop (didn't bet)
Seat 4: ka100pka527 collected ($5.22)
Seat 5: ptolejmus (button) folded before Flop (didn't bet)
Seat 6: Freebet1 (small blind) folded before Flop



PokerStars Hand #254396755657:  Hold'em No Limit ($0.50/$1.00 USD) - 2025/01/16 12:14:35 WET [2025/01/16 7:14:35 ET]
Table 'Stereoskopia III' 6-max Seat #6 is the button
Seat 3: Evelexy1 ($100 in chips) is sitting out
Seat 1: kvcsszblcs ($100 in chips) 
Seat 2: avstero ($99.22 in chips) 
Seat 4: ka100pka527 ($133.57 in chips) 
Seat 5: ptolejmus ($10 in chips) 
Seat 6: Freebet1 ($38.50 in chips) 
kvcsszblcs: posts small blind $0.50
avstero: posts big blind $1
Evelexy1: sits out 
*** HOLE CARDS ***
ka100pka527: raises $1.50 to $2.50
ptolejmus: folds 
Freebet1: calls $2.50
kvcsszblcs: folds 
avstero: folds 
*** FLOP *** [7c Jh 2h]
ka100pka527: checks 
Freebet1: bets $6.18
ka100pka527: folds 
Uncalled bet ($6.18) returned to Freebet1
Freebet1 collected $6.18 from pot
*** SUMMARY ***
Total pot $6.50 | Rake $0.32 
Board [7c Jh 2h]
Seat 3: Evelexy1
Seat 1: kvcsszblcs (small blind) folded before Flop
Seat 2: avstero (big blind) folded before Flop
Seat 4: ka100pka527 folded on the Flop
Seat 5: ptolejmus folded before Flop (didn't bet)
Seat 6: Freebet1 (button) collected ($6.18)



PokerStars Hand #254396758389:  Hold'em No Limit ($0.50/$1.00 USD) - 2025/01/16 12:14:55 WET [2025/01/16 7:14:55 ET]
Table 'Stereoskopia III' 6-max Seat #1 is the button
Seat 1: kvcsszblcs ($100 in chips) 
Seat 2: avstero ($100 in chips) 
Seat 3: Evelexy1 ($100 in chips) 
Seat 4: ka100pka527 ($131.07 in chips) 
Seat 5: ptolejmus ($10 in chips) 
Seat 6: Freebet1 ($42.18 in chips) 
avstero: posts small blind $0.50
Evelexy1: posts big blind $1
*** HOLE CARDS ***
ka100pka527: folds 
ptolejmus: folds 
Freebet1: raises $2.50 to $3.50
kvcsszblcs: folds 
avstero: folds 
Evelexy1: folds 
Uncalled bet ($2.50) returned to Freebet1
Freebet1 collected $2.50 from pot
*** SUMMARY ***
Total pot $2.50 | Rake $0 
Seat 1: kvcsszblcs (button) folded before Flop (didn't bet)
Seat 2: avstero (small blind) folded before Flop
Seat 3: Evelexy1 (big blind) folded before Flop
Seat 4: ka100pka527 folded before Flop (didn't bet)
Seat 5: ptolejmus folded before Flop (didn't bet)
Seat 6: Freebet1 collected ($2.50)



PokerStars Hand #254396760221:  Hold'em No Limit ($0.50/$1.00 USD) - 2025/01/16 12:15:08 WET [2025/01/16 7:15:08 ET]
Table 'Stereoskopia III' 6-max Seat #2 is the button
Seat 1: kvcsszblcs ($100 in chips) 
Seat 2: avstero ($99.50 in chips) 
Seat 3: Evelexy1 ($100 in chips) 
Seat 4: ka100pka527 ($131.07 in chips) 
Seat 5: ptolejmus ($10 in chips) 
Seat 6: Freebet1 ($43.68 in chips) 
Evelexy1: posts small blind $0.50
ka100pka527: posts big blind $1
*** HOLE CARDS ***
ptolejmus: raises $1 to $2
Freebet1: folds 
kvcsszblcs: folds 
avstero: folds 
Evelexy1: folds 
ka100pka527: folds 
Uncalled bet ($1) returned to ptolejmus
ptolejmus collected $2.50 from pot
*** SUMMARY ***
Total pot $2.50 | Rake $0 
Seat 1: kvcsszblcs folded before Flop (didn't bet)
Seat 2: avstero (button) folded before Flop (didn't bet)
Seat 3: Evelexy1 (small blind) folded before Flop
Seat 4: ka100pka527 (big blind) folded before Flop
Seat 5: ptolejmus collected ($2.50)
Seat 6: Freebet1 folded before Flop (didn't bet)



PokerStars Hand #254396762501:  Hold'em No Limit ($0.50/$1.00 USD) - 2025/01/16 12:15:26 WET [2025/01/16 7:15:26 ET]
Table 'Stereoskopia III' 6-max Seat #3 is the button
Seat 1: kvcsszblcs ($100 in chips) 
Seat 2: avstero ($99.50 in chips) 
Seat 3: Evelexy1 ($100 in chips) 
Seat 4: ka100pka527 ($130.07 in chips) 
Seat 5: ptolejmus ($11.50 in chips) 
Seat 6: Freebet1 ($43.68 in chips) 
ka100pka527: posts small blind $0.50
ptolejmus: posts big blind $1
*** HOLE CARDS ***
Freebet1: folds 
kvcsszblcs: raises $1 to $2
avstero: folds 
Evelexy1: raises $4 to $6
ka100pka527: folds 
ptolejmus: folds 
kvcsszblcs: calls $4
*** FLOP *** [Js 8c 7s]
kvcsszblcs: checks 
Evelexy1: checks 
*** TURN *** [Js 8c 7s] [4c]
kvcsszblcs: bets $3.21
Evelexy1: calls $3.21
*** RIVER *** [Js 8c 7s 4c] [Kc]
kvcsszblcs: checks 
Evelexy1: checks 
*** SHOW DOWN ***
kvcsszblcs: shows [6c 7c] (a flush, King high)
Evelexy1: mucks hand 
kvcsszblcs collected $18.92 from pot
*** SUMMARY ***
Total pot $19.92 | Rake $1 
Board [Js 8c 7s 4c Kc]
Seat 1: kvcsszblcs showed [6c 7c] and won ($18.92) with a flush, King high
Seat 2: avstero folded before Flop (didn't bet)
Seat 3: Evelexy1 (button) mucked
Seat 4: ka100pka527 (small blind) folded before Flop
Seat 5: ptolejmus (big blind) folded before Flop
Seat 6: Freebet1 folded before Flop (didn't bet)



PokerStars Hand #254396769992:  Hold'em No Limit ($0.50/$1.00 USD) - 2025/01/16 12:16:23 WET [2025/01/16 7:16:23 ET]
Table 'Stereoskopia III' 6-max Seat #4 is the button
Seat 1: kvcsszblcs ($109.71 in chips) 
Seat 2: avstero ($99.50 in chips) 
Seat 3: Evelexy1 ($100 in chips) 
Seat 4: ka100pka527 ($129.57 in chips) 
Seat 5: ptolejmus ($10.50 in chips) 
Seat 6: Freebet1 ($43.68 in chips) 
ptolejmus: posts small blind $0.50
Freebet1: posts big blind $1
*** HOLE CARDS ***
kvcsszblcs: raises $1 to $2
avstero: raises $5 to $7
Evelexy1: folds 
ka100pka527: folds 
ptolejmus: folds 
Freebet1: folds 
kvcsszblcs: folds 
Uncalled bet ($5) returned to avstero
avstero collected $5.50 from pot
avstero: doesn't show hand 
*** SUMMARY ***
Total pot $5.50 | Rake $0 
Seat 1: kvcsszblcs folded before Flop
Seat 2: avstero collected ($5.50)
Seat 3: Evelexy1 folded before Flop (didn't bet)
Seat 4: ka100pka527 (button) folded before Flop (didn't bet)
Seat 5: ptolejmus (small blind) folded before Flop
Seat 6: Freebet1 (big blind) folded before Flop



PokerStars Hand #254396772636:  Hold'em No Limit ($0.50/$1.00 USD) - 2025/01/16 12:16:43 WET [2025/01/16 7:16:43 ET]
Table 'Stereoskopia III' 6-max Seat #5 is the button
Seat 1: kvcsszblcs ($107.71 in chips) is sitting out
Seat 2: avstero ($103 in chips) 
Seat 3: Evelexy1 ($100 in chips) 
Seat 4: ka100pka527 ($129.57 in chips) 
Seat 5: ptolejmus ($10 in chips) 
Seat 6: Freebet1 ($42.68 in chips) 
Freebet1: posts small blind $0.50
kvcsszblcs: is sitting out 
avstero: posts big blind $1
*** HOLE CARDS ***
Evelexy1: folds 
ka100pka527: folds 
ptolejmus: folds 
Freebet1: calls $0.50
avstero: checks 
*** FLOP *** [Kd 8c 5c]
Freebet1: bets $1.90
avstero: folds 
Uncalled bet ($1.90) returned to Freebet1
Freebet1 collected $1.90 from pot
*** SUMMARY ***
Total pot $2 | Rake $0.10 
Board [Kd 8c 5c]
Seat 1: kvcsszblcs
Seat 2: avstero (big blind) folded on the Flop
Seat 3: Evelexy1 folded before Flop (didn't bet)
Seat 4: ka100pka527 folded before Flop (didn't bet)
Seat 5: ptolejmus (button) folded before Flop (didn't bet)
Seat 6: Freebet1 (small blind) collected ($1.90)



PokerStars Hand #254396775561:  Hold'em No Limit ($0.50/$1.00 USD) - 2025/01/16 12:17:05 WET [2025/01/16 7:17:05 ET]
Table 'Stereoskopia III' 6-max Seat #6 is the button
Seat 1: kvcsszblcs ($107.71 in chips) is sitting out
Seat 2: avstero ($102 in chips) 
Seat 3: Evelexy1 ($100 in chips) 
Seat 4: ka100pka527 ($129.57 in chips) 
Seat 5: ptolejmus ($10 in chips) 
Seat 6: Freebet1 ($43.58 in chips) 
avstero: posts small blind $0.50
Evelexy1: posts big blind $1
*** HOLE CARDS ***
ka100pka527: folds 
ptolejmus: raises $1 to $2
Freebet1: folds 
avstero: folds 
Evelexy1: folds 
Uncalled bet ($1) returned to ptolejmus
ptolejmus collected $2.50 from pot
*** SUMMARY ***
Total pot $2.50 | Rake $0 
Seat 1: kvcsszblcs
Seat 2: avstero (small blind) folded before Flop
Seat 3: Evelexy1 (big blind) folded before Flop
Seat 4: ka100pka527 folded before Flop (didn't bet)
Seat 5: ptolejmus collected ($2.50)
Seat 6: Freebet1 (button) folded before Flop (didn't bet)



PokerStars Hand #254396777832:  Hold'em No Limit ($0.50/$1.00 USD) - 2025/01/16 12:17:22 WET [2025/01/16 7:17:22 ET]
Table 'Stereoskopia III' 6-max Seat #2 is the button
Seat 1: kvcsszblcs ($107.71 in chips) is sitting out
Seat 2: avstero ($101.50 in chips) 
Seat 3: Evelexy1 ($100 in chips) 
Seat 4: ka100pka527 ($129.57 in chips) 
Seat 5: ptolejmus ($11.50 in chips) 
Seat 6: Freebet1 ($43.58 in chips) 
Evelexy1: posts small blind $0.50
ka100pka527: posts big blind $1
*** HOLE CARDS ***
ptolejmus: folds 
Freebet1: calls $1
avstero: folds 
Evelexy1: folds 
ka100pka527: checks 
*** FLOP *** [2h Jh 5s]
ka100pka527: checks 
Freebet1: checks 
*** TURN *** [2h Jh 5s] [8s]
ka100pka527: checks 
Freebet1: checks 
*** RIVER *** [2h Jh 5s 8s] [Js]
ka100pka527: checks 
Freebet1: checks 
*** SHOW DOWN ***
ka100pka527: shows [Td 3d] (a pair of Jacks)
Freebet1: mucks hand 
ka100pka527 collected $2.38 from pot
*** SUMMARY ***
Total pot $2.50 | Rake $0.12 
Board [2h Jh 5s 8s Js]
Seat 1: kvcsszblcs
Seat 2: avstero (button) folded before Flop (didn't bet)
Seat 3: Evelexy1 (small blind) folded before Flop
Seat 4: ka100pka527 (big blind) showed [Td 3d] and won ($2.38) with a pair of Jacks
Seat 5: ptolejmus folded before Flop (didn't bet)
Seat 6: Freebet1 mucked



PokerStars Hand #254396783540:  Hold'em No Limit ($0.50/$1.00 USD) - 2025/01/16 12:18:04 WET [2025/01/16 7:18:04 ET]
Table 'Stereoskopia III' 6-max Seat #3 is the button
Seat 1: kvcsszblcs ($107.71 in chips) is sitting out
Seat 2: avstero ($101.50 in chips) 
Seat 3: Evelexy1 ($100 in chips) 
Seat 4: ka100pka527 ($130.95 in chips) 
Seat 5: ptolejmus ($11.50 in chips) 
Seat 6: Freebet1 ($42.58 in chips) 
ka100pka527: posts small blind $0.50
ptolejmus: posts big blind $1
*** HOLE CARDS ***
Freebet1: folds 
avstero: folds 
Evelexy1: folds 
ka100pka527: raises $1 to $2
ptolejmus: folds 
Uncalled bet ($1) returned to ka100pka527
ka100pka527 collected $2 from pot
ka100pka527: doesn't show hand 
*** SUMMARY ***
Total pot $2 | Rake $0 
Seat 1: kvcsszblcs
Seat 2: avstero folded before Flop (didn't bet)
Seat 3: Evelexy1 (button) folded before Flop (didn't bet)
Seat 4: ka100pka527 (small blind) collected ($2)
Seat 5: ptolejmus (big blind) folded before Flop
Seat 6: Freebet1 folded before Flop (didn't bet)



PokerStars Hand #254396786370:  Hold'em No Limit ($0.50/$1.00 USD) - 2025/01/16 12:18:25 WET [2025/01/16 7:18:25 ET]
Table 'Stereoskopia III' 6-max Seat #4 is the button
Seat 1: kvcsszblcs ($107.71 in chips) is sitting out
Seat 2: avstero ($101.50 in chips) 
Seat 3: Evelexy1 ($100 in chips) 
Seat 4: ka100pka527 ($131.95 in chips) 
Seat 5: ptolejmus ($10.50 in chips) 
Seat 6: Freebet1 ($42.58 in chips) 
ptolejmus: posts small blind $0.50
Freebet1: posts big blind $1
*** HOLE CARDS ***
avstero: folds 
Evelexy1: folds 
ka100pka527: folds 
ptolejmus: raises $1 to $2
Freebet1: calls $1
*** FLOP *** [5s 6s 3d]
ptolejmus: checks 
Freebet1: checks 
*** TURN *** [5s 6s 3d] [2s]
ptolejmus: checks 
Freebet1: bets $1.90
ptolejmus: folds 
Uncalled bet ($1.90) returned to Freebet1
Freebet1 collected $3.80 from pot
*** SUMMARY ***
Total pot $4 | Rake $0.20 
Board [5s 6s 3d 2s]
Seat 1: kvcsszblcs
Seat 2: avstero folded before Flop (didn't bet)
Seat 3: Evelexy1 folded before Flop (didn't bet)
Seat 4: ka100pka527 (button) folded before Flop (didn't bet)
Seat 5: ptolejmus (small blind) folded on the Turn
Seat 6: Freebet1 (big blind) collected ($3.80)



PokerStars Hand #254396792970:  Hold'em No Limit ($0.50/$1.00 USD) - 2025/01/16 12:19:14 WET [2025/01/16 7:19:14 ET]
Table 'Stereoskopia III' 6-max Seat #5 is the button
Seat 1: kvcsszblcs ($107.71 in chips) is sitting out
Seat 2: avstero ($101.50 in chips) 
Seat 3: Evelexy1 ($100 in chips) 
Seat 4: ka100pka527 ($131.95 in chips) 
Seat 5: ptolejmus ($10 in chips) 
Seat 6: Freebet1 ($44.38 in chips) 
Freebet1: posts small blind $0.50
avstero: posts big blind $1
*** HOLE CARDS ***
Evelexy1: raises $1 to $2
ka100pka527: folds 
ptolejmus: raises $8 to $10 and is all-in
Freebet1: folds 
avstero: folds 
Evelexy1: folds 
Uncalled bet ($8) returned to ptolejmus
ptolejmus collected $5.50 from pot
*** SUMMARY ***
Total pot $5.50 | Rake $0 
Seat 1: kvcsszblcs
Seat 2: avstero (big blind) folded before Flop
Seat 3: Evelexy1 folded before Flop
Seat 4: ka100pka527 folded before Flop (didn't bet)
Seat 5: ptolejmus (button) collected ($5.50)
Seat 6: Freebet1 (small blind) folded before Flop



PokerStars Hand #254396795948:  Hold'em No Limit ($0.50/$1.00 USD) - 2025/01/16 12:19:36 WET [2025/01/16 7:19:36 ET]
Table 'Stereoskopia III' 6-max Seat #6 is the button
Seat 1: kvcsszblcs ($107.71 in chips) is sitting out
Seat 2: avstero ($100.50 in chips) 
Seat 3: Evelexy1 ($100 in chips) 
Seat 4: ka100pka527 ($131.95 in chips) 
Seat 5: ptolejmus ($13.50 in chips) 
Seat 6: Freebet1 ($43.88 in chips) 
avstero: posts small blind $0.50
Evelexy1: posts big blind $1
*** HOLE CARDS ***
ka100pka527: folds 
ptolejmus: folds 
Freebet1: calls $1
avstero: folds 
Evelexy1: checks 
*** FLOP *** [6c Kc 3c]
Evelexy1: checks 
Freebet1: checks 
*** TURN *** [6c Kc 3c] [7s]
Evelexy1: checks 
Freebet1: bets $1.19
Evelexy1: folds 
Uncalled bet ($1.19) returned to Freebet1
Freebet1 collected $2.38 from pot
*** SUMMARY ***
Total pot $2.50 | Rake $0.12 
Board [6c Kc 3c 7s]
Seat 1: kvcsszblcs
Seat 2: avstero (small blind) folded before Flop
Seat 3: Evelexy1 (big blind) folded on the Turn
Seat 4: ka100pka527 folded before Flop (didn't bet)
Seat 5: ptolejmus folded before Flop (didn't bet)
Seat 6: Freebet1 (button) collected ($2.38)



PokerStars Hand #254396798110:  Hold'em No Limit ($0.50/$1.00 USD) - 2025/01/16 12:19:52 WET [2025/01/16 7:19:52 ET]
Table 'Stereoskopia III' 6-max Seat #2 is the button
Seat 1: kvcsszblcs ($107.71 in chips) is sitting out
Seat 2: avstero ($100 in chips) 
Seat 3: Evelexy1 ($100 in chips) 
Seat 4: ka100pka527 ($131.95 in chips) 
Seat 5: ptolejmus ($13.50 in chips) 
Seat 6: Freebet1 ($45.26 in chips) 
Evelexy1: posts small blind $0.50
ka100pka527: posts big blind $1
*** HOLE CARDS ***
ptolejmus: folds 
Freebet1: folds 
avstero: folds 
Evelexy1: raises $1.50 to $2.50
ka100pka527: raises $5.50 to $8
Evelexy1: folds 
Uncalled bet ($5.50) returned to ka100pka527
ka100pka527 collected $5 from pot
ka100pka527: doesn't show hand 
*** SUMMARY ***
Total pot $5 | Rake $0 
Seat 1: kvcsszblcs
Seat 2: avstero (button) folded before Flop (didn't bet)
Seat 3: Evelexy1 (small blind) folded before Flop
Seat 4: ka100pka527 (big blind) collected ($5)
Seat 5: ptolejmus folded before Flop (didn't bet)
Seat 6: Freebet1 folded before Flop (didn't bet)



PokerStars Hand #254396800297:  Hold'em No Limit ($0.50/$1.00 USD) - 2025/01/16 12:20:07 WET [2025/01/16 7:20:07 ET]
Table 'Stereoskopia III' 6-max Seat #3 is the button
Seat 1: kvcsszblcs ($107.71 in chips) is sitting out
Seat 2: avstero ($100 in chips) 
Seat 3: Evelexy1 ($100 in chips) 
Seat 4: ka100pka527 ($134.45 in chips) 
Seat 5: ptolejmus ($13.50 in chips) 
Seat 6: Freebet1 ($45.26 in chips) 
ka100pka527: posts small blind $0.50
ptolejmus: posts big blind $1
*** HOLE CARDS ***
Freebet1: calls $1
avstero: folds 
Evelexy1: folds 
ka100pka527: folds 
ptolejmus: checks 
*** FLOP *** [6d 5h As]
ptolejmus: checks 
Freebet1: checks 
*** TURN *** [6d 5h As] [3c]
ptolejmus: checks 
Freebet1: checks 
*** RIVER *** [6d 5h As 3c] [7h]
ptolejmus: checks 
Freebet1: checks 
*** SHOW DOWN ***
ptolejmus: shows [Js Qs] (high card Ace)
Freebet1: shows [Kd 9c] (high card Ace - King kicker)
Freebet1 collected $2.38 from pot
*** SUMMARY ***
Total pot $2.50 | Rake $0.12 
Board [6d 5h As 3c 7h]
Seat 1: kvcsszblcs
Seat 2: avstero folded before Flop (didn't bet)
Seat 3: Evelexy1 (button) folded before Flop (didn't bet)
Seat 4: ka100pka527 (small blind) folded before Flop
Seat 5: ptolejmus (big blind) showed [Js Qs] and lost with high card Ace
Seat 6: Freebet1 showed [Kd 9c] and won ($2.38) with high card Ace



PokerStars Hand #254396805360:  Hold'em No Limit ($0.50/$1.00 USD) - 2025/01/16 12:20:45 WET [2025/01/16 7:20:45 ET]
Table 'Stereoskopia III' 6-max Seat #4 is the button
Seat 1: kvcsszblcs ($107.71 in chips) is sitting out
Seat 2: avstero ($100 in chips) 
Seat 3: Evelexy1 ($100 in chips) 
Seat 4: ka100pka527 ($133.95 in chips) 
Seat 5: ptolejmus ($12.50 in chips) 
Seat 6: Freebet1 ($46.64 in chips) 
ptolejmus: posts small blind $0.50
Freebet1: posts big blind $1
*** HOLE CARDS ***
avstero: folds 
Evelexy1: folds 
ka100pka527: folds 
ptolejmus: folds 
Uncalled bet ($0.50) returned to Freebet1
Freebet1 collected $1 from pot
*** SUMMARY ***
Total pot $1 | Rake $0 
Seat 1: kvcsszblcs
Seat 2: avstero folded before Flop (didn't bet)
Seat 3: Evelexy1 folded before Flop (didn't bet)
Seat 4: ka100pka527 (button) folded before Flop (didn't bet)
Seat 5: ptolejmus (small blind) folded before Flop
Seat 6: Freebet1 (big blind) collected ($1)



PokerStars Hand #254396807305:  Hold'em No Limit ($0.50/$1.00 USD) - 2025/01/16 12:20:59 WET [2025/01/16 7:20:59 ET]
Table 'Stereoskopia III' 6-max Seat #5 is the button
Seat 1: kvcsszblcs ($107.71 in chips) is sitting out
Seat 2: avstero ($100 in chips) 
Seat 3: Evelexy1 ($100 in chips) 
Seat 4: ka100pka527 ($133.95 in chips) 
Seat 5: ptolejmus ($12 in chips) 
Seat 6: Freebet1 ($47.14 in chips) 
Freebet1: posts small blind $0.50
avstero: posts big blind $1
*** HOLE CARDS ***
Evelexy1: raises $1.50 to $2.50
ka100pka527: calls $2.50
ptolejmus: folds 
Freebet1: calls $2
avstero: folds 
*** FLOP *** [2c 5d Tc]
Freebet1: checks 
Evelexy1: bets $4.04
ka100pka527: calls $4.04
Freebet1: folds 
*** TURN *** [2c 5d Tc] [Jd]
Evelexy1: bets $10.40
ka100pka527: raises $20.80 to $31.20
Evelexy1: folds 
Uncalled bet ($20.80) returned to ka100pka527
ka100pka527 collected $35.51 from pot
ka100pka527: doesn't show hand 
*** SUMMARY ***
Total pot $37.38 | Rake $1.87 
Board [2c 5d Tc Jd]
Seat 1: kvcsszblcs
Seat 2: avstero (big blind) folded before Flop
Seat 3: Evelexy1 folded on the Turn
Seat 4: ka100pka527 collected ($35.51)
Seat 5: ptolejmus (button) folded before Flop (didn't bet)
Seat 6: Freebet1 (small blind) folded on the Flop



PokerStars Hand #254396815972:  Hold'em No Limit ($0.50/$1.00 USD) - 2025/01/16 12:22:04 WET [2025/01/16 7:22:04 ET]
Table 'Stereoskopia III' 6-max Seat #6 is the button
Seat 1: kvcsszblcs ($107.71 in chips) is sitting out
Seat 2: avstero ($99 in chips) 
Seat 3: Evelexy1 ($100 in chips) 
Seat 4: ka100pka527 ($152.52 in chips) 
Seat 5: ptolejmus ($12 in chips) 
Seat 6: Freebet1 ($44.64 in chips) 
avstero: posts small blind $0.50
Evelexy1: posts big blind $1
*** HOLE CARDS ***
ka100pka527: folds 
ptolejmus: folds 
Freebet1: raises $1 to $2
avstero: folds 
Evelexy1: calls $1
*** FLOP *** [Qs Jh 2c]
Evelexy1: checks 
Freebet1: bets $2.14
Evelexy1: calls $2.14
*** TURN *** [Qs Jh 2c] [6h]
Evelexy1: checks 
Freebet1: bets $4.17
Evelexy1: folds 
Uncalled bet ($4.17) returned to Freebet1
Freebet1 collected $8.34 from pot
*** SUMMARY ***
Total pot $8.78 | Rake $0.44 
Board [Qs Jh 2c 6h]
Seat 1: kvcsszblcs
Seat 2: avstero (small blind) folded before Flop
Seat 3: Evelexy1 (big blind) folded on the Turn
Seat 4: ka100pka527 folded before Flop (didn't bet)
Seat 5: ptolejmus folded before Flop (didn't bet)
Seat 6: Freebet1 (button) collected ($8.34)



PokerStars Hand #254396819918:  Hold'em No Limit ($0.50/$1.00 USD) - 2025/01/16 12:22:32 WET [2025/01/16 7:22:32 ET]
Table 'Stereoskopia III' 6-max Seat #2 is the button
Seat 1: kvcsszblcs ($107.71 in chips) is sitting out
Seat 2: avstero ($100 in chips) 
Seat 3: Evelexy1 ($100 in chips) 
Seat 4: ka100pka527 ($152.52 in chips) 
Seat 5: ptolejmus ($12 in chips) 
Seat 6: Freebet1 ($48.84 in chips) 
Evelexy1: posts small blind $0.50
ka100pka527: posts big blind $1
*** HOLE CARDS ***
ptolejmus: folds 
Freebet1: folds 
avstero: raises $1.20 to $2.20
Evelexy1: folds 
ka100pka527: folds 
Uncalled bet ($1.20) returned to avstero
avstero collected $2.50 from pot
avstero: doesn't show hand 
*** SUMMARY ***
Total pot $2.50 | Rake $0 
Seat 1: kvcsszblcs
Seat 2: avstero (button) collected ($2.50)
Seat 3: Evelexy1 (small blind) folded before Flop
Seat 4: ka100pka527 (big blind) folded before Flop
Seat 5: ptolejmus folded before Flop (didn't bet)
Seat 6: Freebet1 folded before Flop (didn't bet)



PokerStars Hand #254396821546:  Hold'em No Limit ($0.50/$1.00 USD) - 2025/01/16 12:22:44 WET [2025/01/16 7:22:44 ET]
Table 'Stereoskopia III' 6-max Seat #3 is the button
Seat 1: kvcsszblcs ($107.71 in chips) is sitting out
Seat 2: avstero ($101.50 in chips) 
Seat 3: Evelexy1 ($100 in chips) 
Seat 4: ka100pka527 ($151.52 in chips) 
Seat 5: ptolejmus ($12 in chips) 
Seat 6: Freebet1 ($48.84 in chips) 
ka100pka527: posts small blind $0.50
ptolejmus: posts big blind $1
kvcsszblcs: sits out 
*** HOLE CARDS ***
Freebet1: folds 
avstero: folds 
Evelexy1: raises $1.50 to $2.50
ka100pka527: folds 
ptolejmus: folds 
Uncalled bet ($1.50) returned to Evelexy1
Evelexy1 collected $2.50 from pot
Evelexy1: doesn't show hand 
*** SUMMARY ***
Total pot $2.50 | Rake $0 
Seat 1: kvcsszblcs
Seat 2: avstero folded before Flop (didn't bet)
Seat 3: Evelexy1 (button) collected ($2.50)
Seat 4: ka100pka527 (small blind) folded before Flop
Seat 5: ptolejmus (big blind) folded before Flop
Seat 6: Freebet1 folded before Flop (didn't bet)



PokerStars Hand #254396824085:  Hold'em No Limit ($0.50/$1.00 USD) - 2025/01/16 12:23:03 WET [2025/01/16 7:23:03 ET]
Table 'Stereoskopia III' 6-max Seat #4 is the button
Seat 1: kvcsszblcs ($107.71 in chips) is sitting out
Seat 2: avstero ($101.50 in chips) 
Seat 3: Evelexy1 ($101.50 in chips) 
Seat 4: ka100pka527 ($151.02 in chips) 
Seat 5: ptolejmus ($11 in chips) 
Seat 6: Freebet1 ($48.84 in chips) 
ptolejmus: posts small blind $0.50
Freebet1: posts big blind $1
kvcsszblcs: sits out 
*** HOLE CARDS ***
avstero: folds 
Evelexy1: raises $1.50 to $2.50
ka100pka527: folds 
ptolejmus: folds 
Freebet1: calls $1.50
*** FLOP *** [Th 9h Qd]
Freebet1: checks 
Evelexy1: bets $1.74
Freebet1: calls $1.74
*** TURN *** [Th 9h Qd] [6d]
Freebet1: checks 
Evelexy1: checks 
*** RIVER *** [Th 9h Qd 6d] [3c]
Freebet1: checks 
Evelexy1: checks 
*** SHOW DOWN ***
Freebet1: shows [8c Ts] (a pair of Tens)
Evelexy1: mucks hand 
Freebet1 collected $8.53 from pot
*** SUMMARY ***
Total pot $8.98 | Rake $0.45 
Board [Th 9h Qd 6d 3c]
Seat 1: kvcsszblcs
Seat 2: avstero folded before Flop (didn't bet)
Seat 3: Evelexy1 mucked
Seat 4: ka100pka527 (button) folded before Flop (didn't bet)
Seat 5: ptolejmus (small blind) folded before Flop
Seat 6: Freebet1 (big blind) showed [8c Ts] and won ($8.53) with a pair of Tens



PokerStars Hand #254396827854:  Hold'em No Limit ($0.50/$1.00 USD) - 2025/01/16 12:23:31 WET [2025/01/16 7:23:31 ET]
Table 'Stereoskopia III' 6-max Seat #5 is the button
Seat 1: kvcsszblcs ($107.71 in chips) 
Seat 2: avstero ($101.50 in chips) 
Seat 3: Evelexy1 ($100 in chips) 
Seat 4: ka100pka527 ($151.02 in chips) 
Seat 5: ptolejmus ($10.50 in chips) 
Seat 6: Freebet1 ($53.13 in chips) 
Freebet1: posts small blind $0.50
kvcsszblcs: posts big blind $1
*** HOLE CARDS ***
avstero: folds 
Evelexy1: folds 
ka100pka527: folds 
ptolejmus: folds 
Freebet1: raises $1 to $2
kvcsszblcs: calls $1
*** FLOP *** [4c Qc Ts]
Freebet1: checks 
kvcsszblcs: bets $2
Freebet1: folds 
Uncalled bet ($2) returned to kvcsszblcs
kvcsszblcs collected $3.80 from pot
kvcsszblcs: doesn't show hand 
*** SUMMARY ***
Total pot $4 | Rake $0.20 
Board [4c Qc Ts]
Seat 1: kvcsszblcs (big blind) collected ($3.80)
Seat 2: avstero folded before Flop (didn't bet)
Seat 3: Evelexy1 folded before Flop (didn't bet)
Seat 4: ka100pka527 folded before Flop (didn't bet)
Seat 5: ptolejmus (button) folded before Flop (didn't bet)
Seat 6: Freebet1 (small blind) folded on the Flop



PokerStars Hand #254396831151:  Hold'em No Limit ($0.50/$1.00 USD) - 2025/01/16 12:23:55 WET [2025/01/16 7:23:55 ET]
Table 'Stereoskopia III' 6-max Seat #6 is the button
Seat 1: kvcsszblcs ($109.51 in chips) 
Seat 2: avstero ($101.50 in chips) 
Seat 3: Evelexy1 ($100 in chips) 
Seat 4: ka100pka527 ($151.02 in chips) 
Seat 5: ptolejmus ($10.50 in chips) 
Seat 6: Freebet1 ($51.13 in chips) 
kvcsszblcs: posts small blind $0.50
avstero: posts big blind $1
*** HOLE CARDS ***
Evelexy1: raises $1 to $2
ka100pka527: folds 
ptolejmus: folds 
Freebet1: folds 
kvcsszblcs: folds 
avstero: folds 
Uncalled bet ($1) returned to Evelexy1
Evelexy1 collected $2.50 from pot
Evelexy1: doesn't show hand 
*** SUMMARY ***
Total pot $2.50 | Rake $0 
Seat 1: kvcsszblcs (small blind) folded before Flop
Seat 2: avstero (big blind) folded before Flop
Seat 3: Evelexy1 collected ($2.50)
Seat 4: ka100pka527 folded before Flop (didn't bet)
Seat 5: ptolejmus folded before Flop (didn't bet)
Seat 6: Freebet1 (button) folded before Flop (didn't bet)



PokerStars Hand #254396833118:  Hold'em No Limit ($0.50/$1.00 USD) - 2025/01/16 12:24:09 WET [2025/01/16 7:24:09 ET]
Table 'Stereoskopia III' 6-max Seat #1 is the button
Seat 1: kvcsszblcs ($109.01 in chips) 
Seat 2: avstero ($100.50 in chips) 
Seat 3: Evelexy1 ($101.50 in chips) 
Seat 4: ka100pka527 ($151.02 in chips) 
Seat 5: ptolejmus ($10.50 in chips) 
Seat 6: Freebet1 ($51.13 in chips) 
avstero: posts small blind $0.50
Evelexy1: posts big blind $1
*** HOLE CARDS ***
ka100pka527: folds 
ptolejmus: folds 
Freebet1: raises $1 to $2
kvcsszblcs: folds 
avstero: folds 
Evelexy1: folds 
Uncalled bet ($1) returned to Freebet1
Freebet1 collected $2.50 from pot
*** SUMMARY ***
Total pot $2.50 | Rake $0 
Seat 1: kvcsszblcs (button) folded before Flop (didn't bet)
Seat 2: avstero (small blind) folded before Flop
Seat 3: Evelexy1 (big blind) folded before Flop
Seat 4: ka100pka527 folded before Flop (didn't bet)
Seat 5: ptolejmus folded before Flop (didn't bet)
Seat 6: Freebet1 collected ($2.50)



PokerStars Hand #254396835117:  Hold'em No Limit ($0.50/$1.00 USD) - 2025/01/16 12:24:23 WET [2025/01/16 7:24:23 ET]
Table 'Stereoskopia III' 6-max Seat #2 is the button
Seat 4: ka100pka527 ($151.02 in chips) is sitting out
Seat 1: kvcsszblcs ($109.01 in chips) 
Seat 2: avstero ($100 in chips) 
Seat 3: Evelexy1 ($100.50 in chips) 
Seat 5: ptolejmus ($10.50 in chips) 
Seat 6: Freebet1 ($52.63 in chips) 
Evelexy1: posts small blind $0.50
ka100pka527: is sitting out 
ptolejmus: posts big blind $1
*** HOLE CARDS ***
Freebet1: raises $1 to $2
kvcsszblcs: folds 
avstero: folds 
Evelexy1: folds 
ptolejmus: folds 
Uncalled bet ($1) returned to Freebet1
Freebet1 collected $2.50 from pot
*** SUMMARY ***
Total pot $2.50 | Rake $0 
Seat 4: ka100pka527
Seat 1: kvcsszblcs folded before Flop (didn't bet)
Seat 2: avstero (button) folded before Flop (didn't bet)
Seat 3: Evelexy1 (small blind) folded before Flop
Seat 5: ptolejmus (big blind) folded before Flop
Seat 6: Freebet1 collected ($2.50)



PokerStars Hand #254396837718:  Hold'em No Limit ($0.50/$1.00 USD) - 2025/01/16 12:24:42 WET [2025/01/16 7:24:42 ET]
Table 'Stereoskopia III' 6-max Seat #3 is the button
Seat 4: ka100pka527 ($151.02 in chips) is sitting out
Seat 1: kvcsszblcs ($109.01 in chips) 
Seat 2: avstero ($100 in chips) 
Seat 3: Evelexy1 ($100 in chips) 
Seat 5: ptolejmus ($10 in chips) 
Seat 6: Freebet1 ($54.13 in chips) 
ptolejmus: posts small blind $0.50
Freebet1: posts big blind $1
*** HOLE CARDS ***
kvcsszblcs: folds 
avstero: folds 
Evelexy1: folds 
ptolejmus: raises $1.25 to $2.25
Freebet1: calls $1.25
*** FLOP *** [Jd 5d 4h]
ptolejmus: checks 
Freebet1: bets $4.28
ptolejmus: raises $3.47 to $7.75 and is all-in
ka100pka527 leaves the table
Freebet1: calls $3.47
*** TURN *** [Jd 5d 4h] [2c]
*** RIVER *** [Jd 5d 4h 2c] [9d]
*** SHOW DOWN ***
ptolejmus: shows [9s 9h] (three of a kind, Nines)
Freebet1: shows [Qd Js] (a pair of Jacks)
ptolejmus collected $19 from pot
*** SUMMARY ***
Total pot $20 | Rake $1 
Board [Jd 5d 4h 2c 9d]
Seat 4: ka100pka527
Seat 1: kvcsszblcs folded before Flop (didn't bet)
Seat 2: avstero folded before Flop (didn't bet)
Seat 3: Evelexy1 (button) folded before Flop (didn't bet)
Seat 5: ptolejmus (small blind) showed [9s 9h] and won ($19) with three of a kind, Nines
Seat 6: Freebet1 (big blind) showed [Qd Js] and lost with a pair of Jacks



PokerStars Hand #254396844740:  Hold'em No Limit ($0.50/$1.00 USD) - 2025/01/16 12:25:32 WET [2025/01/16 7:25:32 ET]
Table 'Stereoskopia III' 6-max Seat #5 is the button
Seat 1: kvcsszblcs ($109.01 in chips) 
Seat 2: avstero ($100 in chips) 
Seat 3: Evelexy1 ($100 in chips) 
Seat 5: ptolejmus ($19 in chips) 
Seat 6: Freebet1 ($44.13 in chips) 
Freebet1: posts small blind $0.50
kvcsszblcs: posts big blind $1
*** HOLE CARDS ***
avstero: folds 
Evelexy1: raises $2 to $3
ptolejmus: folds 
Freebet1: raises $7 to $10
kvcsszblcs: folds 
Evelexy1: calls $7
*** FLOP *** [9s 4s 6h]
Freebet1: bets $34.13 and is all-in
Evelexy1: folds 
Uncalled bet ($34.13) returned to Freebet1
Freebet1 collected $19.95 from pot
*** SUMMARY ***
Total pot $21 | Rake $1.05 
Board [9s 4s 6h]
Seat 1: kvcsszblcs (big blind) folded before Flop
Seat 2: avstero folded before Flop (didn't bet)
Seat 3: Evelexy1 folded on the Flop
Seat 5: ptolejmus (button) folded before Flop (didn't bet)
Seat 6: Freebet1 (small blind) collected ($19.95)



PokerStars Hand #254396847543:  Hold'em No Limit ($0.50/$1.00 USD) - 2025/01/16 12:25:52 WET [2025/01/16 7:25:52 ET]
Table 'Stereoskopia III' 6-max Seat #6 is the button
Seat 1: kvcsszblcs ($108.01 in chips) 
Seat 2: avstero ($100 in chips) 
Seat 3: Evelexy1 ($100 in chips) 
Seat 5: ptolejmus ($19 in chips) 
Seat 6: Freebet1 ($54.08 in chips) 
kvcsszblcs: posts small blind $0.50
avstero: posts big blind $1
*** HOLE CARDS ***
Evelexy1: folds 
ptolejmus: raises $1 to $2
Freebet1: folds 
kvcsszblcs: folds 
avstero: calls $1
*** FLOP *** [7s 6d 8d]
avstero: checks 
Pon4uk.ua joins the table at seat #4 
ptolejmus: checks 
*** TURN *** [7s 6d 8d] [Td]
avstero: bets $1.28
ptolejmus: folds 
Uncalled bet ($1.28) returned to avstero
avstero collected $4.28 from pot
avstero: doesn't show hand 
*** SUMMARY ***
Total pot $4.50 | Rake $0.22 
Board [7s 6d 8d Td]
Seat 1: kvcsszblcs (small blind) folded before Flop
Seat 2: avstero (big blind) collected ($4.28)
Seat 3: Evelexy1 folded before Flop (didn't bet)
Seat 5: ptolejmus folded on the Turn
Seat 6: Freebet1 (button) folded before Flop (didn't bet)



PokerStars Hand #254396860360:  Hold'em No Limit ($0.50/$1.00 USD) - 2025/01/16 12:27:23 WET [2025/01/16 7:27:23 ET]
Table 'Stereoskopia III' 6-max Seat #1 is the button
Seat 4: Pon4uk.ua ($233.35 in chips) is sitting out
Seat 1: kvcsszblcs ($107.51 in chips) 
Seat 2: avstero ($102.28 in chips) 
Seat 3: Evelexy1 ($100 in chips) 
Seat 5: ptolejmus ($17 in chips) 
Seat 6: Freebet1 ($54.08 in chips) 
avstero: posts small blind $0.50
Evelexy1: posts big blind $1
Pon4uk.ua: sits out 
*** HOLE CARDS ***
ptolejmus: folds 
Freebet1: folds 
kvcsszblcs: raises $1.25 to $2.25
avstero: folds 
Evelexy1: folds 
Uncalled bet ($1.25) returned to kvcsszblcs
kvcsszblcs collected $2.50 from pot
kvcsszblcs: doesn't show hand 
*** SUMMARY ***
Total pot $2.50 | Rake $0 
Seat 4: Pon4uk.ua
Seat 1: kvcsszblcs (button) collected ($2.50)
Seat 2: avstero (small blind) folded before Flop
Seat 3: Evelexy1 (big blind) folded before Flop
Seat 5: ptolejmus folded before Flop (didn't bet)
Seat 6: Freebet1 folded before Flop (didn't bet)



PokerStars Hand #254396862915:  Hold'em No Limit ($0.50/$1.00 USD) - 2025/01/16 12:27:41 WET [2025/01/16 7:27:41 ET]
Table 'Stereoskopia III' 6-max Seat #2 is the button
Seat 1: kvcsszblcs ($109.01 in chips) 
Seat 2: avstero ($101.78 in chips) 
Seat 3: Evelexy1 ($100 in chips) 
Seat 4: Pon4uk.ua ($233.35 in chips) 
Seat 5: ptolejmus ($17 in chips) 
Seat 6: Freebet1 ($54.08 in chips) 
Evelexy1: posts small blind $0.50
Pon4uk.ua: posts big blind $1
*** HOLE CARDS ***
ptolejmus: folds 
Freebet1: calls $1
kvcsszblcs: folds 
avstero: folds 
Evelexy1: folds 
Pon4uk.ua: checks 
*** FLOP *** [6c 2c 5s]
Pon4uk.ua: checks 
Freebet1: checks 
*** TURN *** [6c 2c 5s] [6h]
Pon4uk.ua: bets $1.79
Freebet1: folds 
Uncalled bet ($1.79) returned to Pon4uk.ua
Pon4uk.ua collected $2.38 from pot
Pon4uk.ua: doesn't show hand 
*** SUMMARY ***
Total pot $2.50 | Rake $0.12 
Board [6c 2c 5s 6h]
Seat 1: kvcsszblcs folded before Flop (didn't bet)
Seat 2: avstero (button) folded before Flop (didn't bet)
Seat 3: Evelexy1 (small blind) folded before Flop
Seat 4: Pon4uk.ua (big blind) collected ($2.38)
Seat 5: ptolejmus folded before Flop (didn't bet)
Seat 6: Freebet1 folded on the Turn



PokerStars Hand #254396867323:  Hold'em No Limit ($0.50/$1.00 USD) - 2025/01/16 12:28:12 WET [2025/01/16 7:28:12 ET]
Table 'Stereoskopia III' 6-max Seat #4 is the button
Seat 3: Evelexy1 ($100 in chips) is sitting out
Seat 1: kvcsszblcs ($109.01 in chips) 
Seat 2: avstero ($101.78 in chips) 
Seat 4: Pon4uk.ua ($234.73 in chips) 
Seat 5: ptolejmus ($17 in chips) 
Seat 6: Freebet1 ($53.08 in chips) 
ptolejmus: posts small blind $0.50
Freebet1: posts big blind $1
*** HOLE CARDS ***
kvcsszblcs: folds 
avstero: raises $1.20 to $2.20
Pon4uk.ua: folds 
ptolejmus: folds 
Freebet1: folds 
Uncalled bet ($1.20) returned to avstero
avstero collected $2.50 from pot
avstero: doesn't show hand 
*** SUMMARY ***
Total pot $2.50 | Rake $0 
Seat 3: Evelexy1
Seat 1: kvcsszblcs folded before Flop (didn't bet)
Seat 2: avstero collected ($2.50)
Seat 4: Pon4uk.ua (button) folded before Flop (didn't bet)
Seat 5: ptolejmus (small blind) folded before Flop
Seat 6: Freebet1 (big blind) folded before Flop



PokerStars Hand #254396870102:  Hold'em No Limit ($0.50/$1.00 USD) - 2025/01/16 12:28:31 WET [2025/01/16 7:28:31 ET]
Table 'Stereoskopia III' 6-max Seat #5 is the button
Seat 3: Evelexy1 ($100 in chips) is sitting out
Seat 1: kvcsszblcs ($109.01 in chips) 
Seat 2: avstero ($103.28 in chips) 
Seat 4: Pon4uk.ua ($234.73 in chips) 
Seat 5: ptolejmus ($16.50 in chips) 
Seat 6: Freebet1 ($52.08 in chips) 
Freebet1: posts small blind $0.50
kvcsszblcs: posts big blind $1
*** HOLE CARDS ***
avstero: folds 
Pon4uk.ua: folds 
ptolejmus: raises $15.50 to $16.50 and is all-in
Freebet1: calls $16
kvcsszblcs: folds 
*** FLOP *** [4c 3d 8c]
*** TURN *** [4c 3d 8c] [2s]
*** RIVER *** [4c 3d 8c 2s] [Qd]
*** SHOW DOWN ***
Freebet1: shows [9c Kc] (high card King)
ptolejmus: shows [Ts Qs] (a pair of Queens)
ptolejmus collected $32.30 from pot
*** SUMMARY ***
Total pot $34 | Rake $1.70 
Board [4c 3d 8c 2s Qd]
Seat 3: Evelexy1
Seat 1: kvcsszblcs (big blind) folded before Flop
Seat 2: avstero folded before Flop (didn't bet)
Seat 4: Pon4uk.ua folded before Flop (didn't bet)
Seat 5: ptolejmus (button) showed [Ts Qs] and won ($32.30) with a pair of Queens
Seat 6: Freebet1 (small blind) showed [9c Kc] and lost with high card King



PokerStars Hand #254396875529:  Hold'em No Limit ($0.50/$1.00 USD) - 2025/01/16 12:29:10 WET [2025/01/16 7:29:10 ET]
Table 'Stereoskopia III' 6-max Seat #6 is the button
Seat 3: Evelexy1 ($100 in chips) is sitting out
Seat 1: kvcsszblcs ($108.01 in chips) 
Seat 2: avstero ($103.28 in chips) 
Seat 4: Pon4uk.ua ($234.73 in chips) 
Seat 5: ptolejmus ($32.30 in chips) 
Seat 6: Freebet1 ($35.58 in chips) 
kvcsszblcs: posts small blind $0.50
avstero: posts big blind $1
*** HOLE CARDS ***
Pon4uk.ua: folds 
ptolejmus: folds 
Freebet1: raises $1 to $2
kvcsszblcs: folds 
avstero: folds 
Uncalled bet ($1) returned to Freebet1
Freebet1 collected $2.50 from pot
*** SUMMARY ***
Total pot $2.50 | Rake $0 
Seat 3: Evelexy1
Seat 1: kvcsszblcs (small blind) folded before Flop
Seat 2: avstero (big blind) folded before Flop
Seat 4: Pon4uk.ua folded before Flop (didn't bet)
Seat 5: ptolejmus folded before Flop (didn't bet)
Seat 6: Freebet1 (button) collected ($2.50)



PokerStars Hand #254396878821:  Hold'em No Limit ($0.50/$1.00 USD) - 2025/01/16 12:29:33 WET [2025/01/16 7:29:33 ET]
Table 'Stereoskopia III' 6-max Seat #1 is the button
Seat 3: Evelexy1 ($100 in chips) is sitting out
Seat 1: kvcsszblcs ($107.51 in chips) 
Seat 2: avstero ($102.28 in chips) 
Seat 4: Pon4uk.ua ($234.73 in chips) 
Seat 5: ptolejmus ($32.30 in chips) 
Seat 6: Freebet1 ($37.08 in chips) 
avstero: posts small blind $0.50
Pon4uk.ua: posts big blind $1
*** HOLE CARDS ***
ptolejmus: folds 
Freebet1: folds 
kvcsszblcs: raises $1.25 to $2.25
avstero: raises $9.05 to $11.30
Pon4uk.ua: folds 
kvcsszblcs: folds 
Uncalled bet ($9.05) returned to avstero
avstero collected $5.50 from pot
avstero: doesn't show hand 
*** SUMMARY ***
Total pot $5.50 | Rake $0 
Seat 3: Evelexy1
Seat 1: kvcsszblcs (button) folded before Flop
Seat 2: avstero (small blind) collected ($5.50)
Seat 4: Pon4uk.ua (big blind) folded before Flop
Seat 5: ptolejmus folded before Flop (didn't bet)
Seat 6: Freebet1 folded before Flop (didn't bet)



PokerStars Hand #254396884761:  Hold'em No Limit ($0.50/$1.00 USD) - 2025/01/16 12:30:14 WET [2025/01/16 7:30:14 ET]
Table 'Stereoskopia III' 6-max Seat #2 is the button
Seat 3: Evelexy1 ($100 in chips) is sitting out
Seat 5: ptolejmus ($32.30 in chips) is sitting out
Seat 1: kvcsszblcs ($105.26 in chips) 
Seat 2: avstero ($105.53 in chips) 
Seat 4: Pon4uk.ua ($233.73 in chips) 
Seat 6: Freebet1 ($37.08 in chips) 
Pon4uk.ua: posts small blind $0.50
ptolejmus: is sitting out 
Freebet1: posts big blind $1
*** HOLE CARDS ***
kvcsszblcs: folds 
ptolejmus leaves the table
avstero: raises $1.20 to $2.20
Pon4uk.ua: folds 
Freebet1: calls $1.20
*** FLOP *** [9c Qh Td]
Freebet1: checks 
avstero: bets $2
Freebet1: calls $2
*** TURN *** [9c Qh Td] [3d]
Freebet1: checks 
avstero: bets $8.50
Freebet1: folds 
Uncalled bet ($8.50) returned to avstero
avstero collected $8.46 from pot
avstero: doesn't show hand 
*** SUMMARY ***
Total pot $8.90 | Rake $0.44 
Board [9c Qh Td 3d]
Seat 3: Evelexy1
Seat 5: ptolejmus
Seat 1: kvcsszblcs folded before Flop (didn't bet)
Seat 2: avstero (button) collected ($8.46)
Seat 4: Pon4uk.ua (small blind) folded before Flop
Seat 6: Freebet1 (big blind) folded on the Turn



PokerStars Hand #254396890921:  Hold'em No Limit ($0.50/$1.00 USD) - 2025/01/16 12:30:56 WET [2025/01/16 7:30:56 ET]
Table 'Stereoskopia III' 6-max Seat #4 is the button
Seat 3: Evelexy1 ($100 in chips) is sitting out
Seat 1: kvcsszblcs ($105.26 in chips) 
Seat 2: avstero ($109.79 in chips) 
Seat 4: Pon4uk.ua ($233.23 in chips) 
Seat 6: Freebet1 ($32.88 in chips) 
Freebet1: posts small blind $0.50
kvcsszblcs: posts big blind $1
*** HOLE CARDS ***
avstero: folds 
Pon4uk.ua: folds 
Freebet1: calls $0.50
kvcsszblcs: checks 
*** FLOP *** [2s 7c 5d]
Freebet1: checks 
kvcsszblcs: checks 
*** TURN *** [2s 7c 5d] [5h]
Freebet1: checks 
nastja336 joins the table at seat #5 
kvcsszblcs: checks 
*** RIVER *** [2s 7c 5d 5h] [2c]
Freebet1: checks 
kvcsszblcs: checks 
*** SHOW DOWN ***
Freebet1: shows [Kh 6s] (two pair, Fives and Deuces)
kvcsszblcs: mucks hand 
Freebet1 collected $1.90 from pot
*** SUMMARY ***
Total pot $2 | Rake $0.10 
Board [2s 7c 5d 5h 2c]
Seat 3: Evelexy1
Seat 1: kvcsszblcs (big blind) mucked
Seat 2: avstero folded before Flop (didn't bet)
Seat 4: Pon4uk.ua (button) folded before Flop (didn't bet)
Seat 6: Freebet1 (small blind) showed [Kh 6s] and won ($1.90) with two pair, Fives and Deuces



PokerStars Hand #254396895937:  Hold'em No Limit ($0.50/$1.00 USD) - 2025/01/16 12:31:31 WET [2025/01/16 7:31:31 ET]
Table 'Stereoskopia III' 6-max Seat #6 is the button
Seat 3: Evelexy1 ($100 in chips) is sitting out
Seat 5: nastja336 ($100 in chips) is sitting out
Seat 1: kvcsszblcs ($104.26 in chips) 
Seat 2: avstero ($109.79 in chips) 
Seat 4: Pon4uk.ua ($233.23 in chips) 
Seat 6: Freebet1 ($33.78 in chips) 
kvcsszblcs: posts small blind $0.50
avstero: posts big blind $1
nastja336: sits out 
*** HOLE CARDS ***
Pon4uk.ua: folds 
Freebet1: raises $1 to $2
kvcsszblcs: raises $7 to $9
avstero: folds 
Freebet1: raises $24.78 to $33.78 and is all-in
kvcsszblcs: calls $24.78
*** FLOP *** [7s 2d Th]
*** TURN *** [7s 2d Th] [9c]
*** RIVER *** [7s 2d Th 9c] [8c]
*** SHOW DOWN ***
kvcsszblcs: shows [Ah Qs] (high card Ace)
Freebet1: shows [Ts 6d] (a straight, Six to Ten)
Freebet1 collected $67.56 from pot
*** SUMMARY ***
Total pot $68.56 | Rake $1 
Board [7s 2d Th 9c 8c]
Seat 3: Evelexy1
Seat 5: nastja336
Seat 1: kvcsszblcs (small blind) showed [Ah Qs] and lost with high card Ace
Seat 2: avstero (big blind) folded before Flop
Seat 4: Pon4uk.ua folded before Flop (didn't bet)
Seat 6: Freebet1 (button) showed [Ts 6d] and won ($67.56) with a straight, Six to Ten



PokerStars Hand #254396900253:  Hold'em No Limit ($0.50/$1.00 USD) - 2025/01/16 12:32:01 WET [2025/01/16 7:32:01 ET]
Table 'Stereoskopia III' 6-max Seat #1 is the button
Seat 3: Evelexy1 ($100 in chips) is sitting out
Seat 5: nastja336 ($100 in chips) is sitting out
Seat 1: kvcsszblcs ($100 in chips) 
Seat 2: avstero ($108.79 in chips) 
Seat 4: Pon4uk.ua ($233.23 in chips) 
Seat 6: Freebet1 ($67.56 in chips) 
avstero: posts small blind $0.50
Pon4uk.ua: posts big blind $1
nastja336: sits out 
*** HOLE CARDS ***
Freebet1: raises $1 to $2
kvcsszblcs: calls $2
avstero: folds 
Pon4uk.ua: folds 
*** FLOP *** [6s 8h 7h]
Freebet1: checks 
kvcsszblcs: checks 
*** TURN *** [6s 8h 7h] [2h]
Freebet1: checks 
kvcsszblcs: bets $3.92
Freebet1: folds 
Uncalled bet ($3.92) returned to kvcsszblcs
kvcsszblcs collected $5.22 from pot
kvcsszblcs: doesn't show hand 
*** SUMMARY ***
Total pot $5.50 | Rake $0.28 
Board [6s 8h 7h 2h]
Seat 3: Evelexy1
Seat 5: nastja336
Seat 1: kvcsszblcs (button) collected ($5.22)
Seat 2: avstero (small blind) folded before Flop
Seat 4: Pon4uk.ua (big blind) folded before Flop
Seat 6: Freebet1 folded on the Turn



PokerStars Hand #254396907831:  Hold'em No Limit ($0.50/$1.00 USD) - 2025/01/16 12:32:55 WET [2025/01/16 7:32:55 ET]
Table 'Stereoskopia III' 6-max Seat #2 is the button
Seat 3: Evelexy1 ($100 in chips) is sitting out
Seat 1: kvcsszblcs ($103.22 in chips) 
Seat 2: avstero ($108.29 in chips) 
Seat 4: Pon4uk.ua ($232.23 in chips) 
Seat 5: nastja336 ($100 in chips) 
Seat 6: Freebet1 ($65.56 in chips) 
Pon4uk.ua: posts small blind $0.50
nastja336: posts big blind $1
*** HOLE CARDS ***
Freebet1: raises $1 to $2
kvcsszblcs: folds 
avstero: folds 
Pon4uk.ua: folds 
nastja336: folds 
Uncalled bet ($1) returned to Freebet1
Freebet1 collected $2.50 from pot
*** SUMMARY ***
Total pot $2.50 | Rake $0 
Seat 3: Evelexy1
Seat 1: kvcsszblcs folded before Flop (didn't bet)
Seat 2: avstero (button) folded before Flop (didn't bet)
Seat 4: Pon4uk.ua (small blind) folded before Flop
Seat 5: nastja336 (big blind) folded before Flop
Seat 6: Freebet1 collected ($2.50)



PokerStars Hand #254396909889:  Hold'em No Limit ($0.50/$1.00 USD) - 2025/01/16 12:33:09 WET [2025/01/16 7:33:09 ET]
Table 'Stereoskopia III' 6-max Seat #4 is the button
Seat 3: Evelexy1 ($100 in chips) is sitting out
Seat 1: kvcsszblcs ($103.22 in chips) 
Seat 2: avstero ($108.29 in chips) 
Seat 4: Pon4uk.ua ($231.73 in chips) 
Seat 5: nastja336 ($100 in chips) 
Seat 6: Freebet1 ($67.06 in chips) 
nastja336: posts small blind $0.50
Freebet1: posts big blind $1
*** HOLE CARDS ***
kvcsszblcs: folds 
avstero: folds 
Pon4uk.ua: folds 
nastja336: folds 
Uncalled bet ($0.50) returned to Freebet1
Freebet1 collected $1 from pot
*** SUMMARY ***
Total pot $1 | Rake $0 
Seat 3: Evelexy1
Seat 1: kvcsszblcs folded before Flop (didn't bet)
Seat 2: avstero folded before Flop (didn't bet)
Seat 4: Pon4uk.ua (button) folded before Flop (didn't bet)
Seat 5: nastja336 (small blind) folded before Flop
Seat 6: Freebet1 (big blind) collected ($1)



PokerStars Hand #254396911194:  Hold'em No Limit ($0.50/$1.00 USD) - 2025/01/16 12:33:18 WET [2025/01/16 7:33:18 ET]
Table 'Stereoskopia III' 6-max Seat #5 is the button
Seat 3: Evelexy1 ($100 in chips) is sitting out
Seat 1: kvcsszblcs ($103.22 in chips) 
Seat 2: avstero ($108.29 in chips) 
Seat 4: Pon4uk.ua ($231.73 in chips) 
Seat 5: nastja336 ($100 in chips) 
Seat 6: Freebet1 ($67.56 in chips) 
Freebet1: posts small blind $0.50
kvcsszblcs: posts big blind $1
*** HOLE CARDS ***
avstero: folds 
Pon4uk.ua: folds 
nastja336: raises $1.50 to $2.50
Freebet1: calls $2
kvcsszblcs: calls $1.50
*** FLOP *** [2h 8s Qs]
Freebet1: checks 
kvcsszblcs: checks 
nastja336: checks 
*** TURN *** [2h 8s Qs] [2s]
Freebet1: bets $2
kvcsszblcs: folds 
nastja336: folds 
Uncalled bet ($2) returned to Freebet1
Freebet1 collected $7.12 from pot
*** SUMMARY ***
Total pot $7.50 | Rake $0.38 
Board [2h 8s Qs 2s]
Seat 3: Evelexy1
Seat 1: kvcsszblcs (big blind) folded on the Turn
Seat 2: avstero folded before Flop (didn't bet)
Seat 4: Pon4uk.ua folded before Flop (didn't bet)
Seat 5: nastja336 (button) folded on the Turn
Seat 6: Freebet1 (small blind) collected ($7.12)



PokerStars Hand #254396918514:  Hold'em No Limit ($0.50/$1.00 USD) - 2025/01/16 12:34:10 WET [2025/01/16 7:34:10 ET]
Table 'Stereoskopia III' 6-max Seat #6 is the button
Seat 3: Evelexy1 ($100 in chips) is sitting out
Seat 1: kvcsszblcs ($100.72 in chips) 
Seat 2: avstero ($108.29 in chips) 
Seat 4: Pon4uk.ua ($231.73 in chips) 
Seat 5: nastja336 ($100 in chips) 
Seat 6: Freebet1 ($72.18 in chips) 
kvcsszblcs: posts small blind $0.50
avstero: posts big blind $1
Evelexy1: sits out 
*** HOLE CARDS ***
Pon4uk.ua: folds 
nastja336: raises $1.50 to $2.50
Freebet1: folds 
kvcsszblcs: folds 
avstero: folds 
Uncalled bet ($1.50) returned to nastja336
nastja336 collected $2.50 from pot
nastja336: doesn't show hand 
*** SUMMARY ***
Total pot $2.50 | Rake $0 
Seat 3: Evelexy1
Seat 1: kvcsszblcs (small blind) folded before Flop
Seat 2: avstero (big blind) folded before Flop
Seat 4: Pon4uk.ua folded before Flop (didn't bet)
Seat 5: nastja336 collected ($2.50)
Seat 6: Freebet1 (button) folded before Flop (didn't bet)



PokerStars Hand #254396921715:  Hold'em No Limit ($0.50/$1.00 USD) - 2025/01/16 12:34:32 WET [2025/01/16 7:34:32 ET]
Table 'Stereoskopia III' 6-max Seat #1 is the button
Seat 1: kvcsszblcs ($100.22 in chips) 
Seat 2: avstero ($107.29 in chips) 
Seat 3: Evelexy1 ($100 in chips) 
Seat 4: Pon4uk.ua ($231.73 in chips) 
Seat 5: nastja336 ($101.50 in chips) 
Seat 6: Freebet1 ($72.18 in chips) 
avstero: posts small blind $0.50
Evelexy1: posts big blind $1
*** HOLE CARDS ***
Pon4uk.ua: folds 
nastja336: raises $1.50 to $2.50
Freebet1: folds 
kvcsszblcs: folds 
avstero: folds 
Evelexy1: folds 
Uncalled bet ($1.50) returned to nastja336
nastja336 collected $2.50 from pot
nastja336: doesn't show hand 
*** SUMMARY ***
Total pot $2.50 | Rake $0 
Seat 1: kvcsszblcs (button) folded before Flop (didn't bet)
Seat 2: avstero (small blind) folded before Flop
Seat 3: Evelexy1 (big blind) folded before Flop
Seat 4: Pon4uk.ua folded before Flop (didn't bet)
Seat 5: nastja336 collected ($2.50)
Seat 6: Freebet1 folded before Flop (didn't bet)



PokerStars Hand #254396924909:  Hold'em No Limit ($0.50/$1.00 USD) - 2025/01/16 12:34:55 WET [2025/01/16 7:34:55 ET]
Table 'Stereoskopia III' 6-max Seat #2 is the button
Seat 1: kvcsszblcs ($100.22 in chips) 
Seat 2: avstero ($106.79 in chips) 
Seat 3: Evelexy1 ($100 in chips) 
Seat 4: Pon4uk.ua ($231.73 in chips) 
Seat 5: nastja336 ($103 in chips) 
Seat 6: Freebet1 ($72.18 in chips) 
Evelexy1: posts small blind $0.50
Pon4uk.ua: posts big blind $1
*** HOLE CARDS ***
nastja336: raises $1.50 to $2.50
Freebet1 has timed out
Freebet1: folds 
kvcsszblcs: folds 
avstero: folds 
Evelexy1: folds 
Pon4uk.ua: folds 
Uncalled bet ($1.50) returned to nastja336
nastja336 collected $2.50 from pot
nastja336: doesn't show hand 
*** SUMMARY ***
Total pot $2.50 | Rake $0 
Seat 1: kvcsszblcs folded before Flop (didn't bet)
Seat 2: avstero (button) folded before Flop (didn't bet)
Seat 3: Evelexy1 (small blind) folded before Flop
Seat 4: Pon4uk.ua (big blind) folded before Flop
Seat 5: nastja336 collected ($2.50)
Seat 6: Freebet1 folded before Flop (didn't bet)



PokerStars Hand #254396932918:  Hold'em No Limit ($0.50/$1.00 USD) - 2025/01/16 12:35:50 WET [2025/01/16 7:35:50 ET]
Table 'Stereoskopia III' 6-max Seat #3 is the button
Seat 6: Freebet1 ($72.18 in chips) is sitting out
Seat 1: kvcsszblcs ($100.22 in chips) 
Seat 2: avstero ($106.79 in chips) 
Seat 3: Evelexy1 ($100 in chips) 
Seat 4: Pon4uk.ua ($230.73 in chips) 
Seat 5: nastja336 ($104.50 in chips) 
Pon4uk.ua: posts small blind $0.50
nastja336: posts big blind $1
*** HOLE CARDS ***
kvcsszblcs: folds 
avstero: folds 
Evelexy1: raises $1.50 to $2.50
Pon4uk.ua: folds 
nastja336: folds 
Uncalled bet ($1.50) returned to Evelexy1
Evelexy1 collected $2.50 from pot
Evelexy1: doesn't show hand 
*** SUMMARY ***
Total pot $2.50 | Rake $0 
Seat 6: Freebet1
Seat 1: kvcsszblcs folded before Flop (didn't bet)
Seat 2: avstero folded before Flop (didn't bet)
Seat 3: Evelexy1 (button) collected ($2.50)
Seat 4: Pon4uk.ua (small blind) folded before Flop
Seat 5: nastja336 (big blind) folded before Flop



PokerStars Hand #254396935549:  Hold'em No Limit ($0.50/$1.00 USD) - 2025/01/16 12:36:09 WET [2025/01/16 7:36:09 ET]
Table 'Stereoskopia III' 6-max Seat #4 is the button
Seat 6: Freebet1 ($72.18 in chips) is sitting out
Seat 1: kvcsszblcs ($100.22 in chips) 
Seat 2: avstero ($106.79 in chips) 
Seat 3: Evelexy1 ($101.50 in chips) 
Seat 4: Pon4uk.ua ($230.23 in chips) 
Seat 5: nastja336 ($103.50 in chips) 
nastja336: posts small blind $0.50
kvcsszblcs: posts big blind $1
*** HOLE CARDS ***
avstero: folds 
Evelexy1: raises $1.50 to $2.50
Pon4uk.ua: folds 
nastja336: folds 
kvcsszblcs: calls $1.50
*** FLOP *** [8c 6c 9d]
kvcsszblcs: checks 
Evelexy1: checks 
*** TURN *** [8c 6c 9d] [Qd]
kvcsszblcs: checks 
Evelexy1: checks 
*** RIVER *** [8c 6c 9d Qd] [Qs]
kvcsszblcs: bets $3.92
Evelexy1: folds 
Uncalled bet ($3.92) returned to kvcsszblcs
kvcsszblcs collected $5.22 from pot
kvcsszblcs: doesn't show hand 
*** SUMMARY ***
Total pot $5.50 | Rake $0.28 
Board [8c 6c 9d Qd Qs]
Seat 6: Freebet1
Seat 1: kvcsszblcs (big blind) collected ($5.22)
Seat 2: avstero folded before Flop (didn't bet)
Seat 3: Evelexy1 folded on the River
Seat 4: Pon4uk.ua (button) folded before Flop (didn't bet)
Seat 5: nastja336 (small blind) folded before Flop



PokerStars Hand #254396941846:  Hold'em No Limit ($0.50/$1.00 USD) - 2025/01/16 12:36:54 WET [2025/01/16 7:36:54 ET]
Table 'Stereoskopia III' 6-max Seat #5 is the button
Seat 2: avstero ($106.79 in chips) is sitting out
Seat 6: Freebet1 ($72.18 in chips) is sitting out
Seat 1: kvcsszblcs ($102.94 in chips) 
Seat 3: Evelexy1 ($100 in chips) 
Seat 4: Pon4uk.ua ($230.23 in chips) 
Seat 5: nastja336 ($103 in chips) 
kvcsszblcs: posts small blind $0.50
avstero: is sitting out 
Evelexy1: posts big blind $1
*** HOLE CARDS ***
Pon4uk.ua: folds 
nastja336: raises $1.50 to $2.50
kvcsszblcs: folds 
Evelexy1: calls $1.50
*** FLOP *** [3d 4h Kc]
Evelexy1: checks 
nastja336: bets $2.61
Evelexy1: folds 
Uncalled bet ($2.61) returned to nastja336
nastja336 collected $5.22 from pot
nastja336: doesn't show hand 
*** SUMMARY ***
Total pot $5.50 | Rake $0.28 
Board [3d 4h Kc]
Seat 2: avstero
Seat 6: Freebet1
Seat 1: kvcsszblcs (small blind) folded before Flop
Seat 3: Evelexy1 (big blind) folded on the Flop
Seat 4: Pon4uk.ua folded before Flop (didn't bet)
Seat 5: nastja336 (button) collected ($5.22)



PokerStars Hand #254396947289:  Hold'em No Limit ($0.50/$1.00 USD) - 2025/01/16 12:37:32 WET [2025/01/16 7:37:32 ET]
Table 'Stereoskopia III' 6-max Seat #1 is the button
Seat 2: avstero ($106.79 in chips) is sitting out
Seat 1: kvcsszblcs ($102.44 in chips) 
Seat 3: Evelexy1 ($100 in chips) 
Seat 4: Pon4uk.ua ($230.23 in chips) 
Seat 5: nastja336 ($105.72 in chips) 
Seat 6: Freebet1 ($72.18 in chips) 
Evelexy1: posts small blind $0.50
Pon4uk.ua: posts big blind $1
Freebet1: posts small & big blinds $1.50
*** HOLE CARDS ***
nastja336: folds 
Freebet1: checks 
kvcsszblcs: raises $2.50 to $3.50
Evelexy1: folds 
Pon4uk.ua: folds 
Freebet1: folds 
Uncalled bet ($2.50) returned to kvcsszblcs
kvcsszblcs collected $4 from pot
kvcsszblcs: doesn't show hand 
*** SUMMARY ***
Total pot $4 | Rake $0 
Seat 2: avstero
Seat 1: kvcsszblcs (button) collected ($4)
Seat 3: Evelexy1 (small blind) folded before Flop
Seat 4: Pon4uk.ua (big blind) folded before Flop
Seat 5: nastja336 folded before Flop (didn't bet)
Seat 6: Freebet1 folded before Flop (didn't bet)



PokerStars Hand #254396949273:  Hold'em No Limit ($0.50/$1.00 USD) - 2025/01/16 12:37:46 WET [2025/01/16 7:37:46 ET]
Table 'Stereoskopia III' 6-max Seat #3 is the button
Seat 2: avstero ($106.79 in chips) is sitting out
Seat 1: kvcsszblcs ($105.44 in chips) 
Seat 3: Evelexy1 ($100 in chips) 
Seat 4: Pon4uk.ua ($229.23 in chips) 
Seat 5: nastja336 ($105.72 in chips) 
Seat 6: Freebet1 ($70.68 in chips) 
Pon4uk.ua: posts small blind $0.50
nastja336: posts big blind $1
avstero: sits out 
*** HOLE CARDS ***
Freebet1: folds 
kvcsszblcs: folds 
Evelexy1: folds 
Pon4uk.ua: raises $1.75 to $2.75
nastja336: folds 
Uncalled bet ($1.75) returned to Pon4uk.ua
Pon4uk.ua collected $2 from pot
Pon4uk.ua: doesn't show hand 
*** SUMMARY ***
Total pot $2 | Rake $0 
Seat 2: avstero
Seat 1: kvcsszblcs folded before Flop (didn't bet)
Seat 3: Evelexy1 (button) folded before Flop (didn't bet)
Seat 4: Pon4uk.ua (small blind) collected ($2)
Seat 5: nastja336 (big blind) folded before Flop
Seat 6: Freebet1 folded before Flop (didn't bet)



PokerStars Hand #254396953504:  Hold'em No Limit ($0.50/$1.00 USD) - 2025/01/16 12:38:15 WET [2025/01/16 7:38:15 ET]
Table 'Stereoskopia III' 6-max Seat #4 is the button
Seat 2: avstero ($106.79 in chips) is sitting out
Seat 1: kvcsszblcs ($105.44 in chips) 
Seat 3: Evelexy1 ($100 in chips) 
Seat 4: Pon4uk.ua ($230.23 in chips) 
Seat 5: nastja336 ($104.72 in chips) 
Seat 6: Freebet1 ($70.68 in chips) 
nastja336: posts small blind $0.50
Freebet1: posts big blind $1
avstero: sits out 
*** HOLE CARDS ***
kvcsszblcs: folds 
Evelexy1: folds 
Pon4uk.ua: folds 
nastja336: folds 
Uncalled bet ($0.50) returned to Freebet1
Freebet1 collected $1 from pot
*** SUMMARY ***
Total pot $1 | Rake $0 
Seat 2: avstero
Seat 1: kvcsszblcs folded before Flop (didn't bet)
Seat 3: Evelexy1 folded before Flop (didn't bet)
Seat 4: Pon4uk.ua (button) folded before Flop (didn't bet)
Seat 5: nastja336 (small blind) folded before Flop
Seat 6: Freebet1 (big blind) collected ($1)



PokerStars Hand #254396955657:  Hold'em No Limit ($0.50/$1.00 USD) - 2025/01/16 12:38:30 WET [2025/01/16 7:38:30 ET]
Table 'Stereoskopia III' 6-max Seat #5 is the button
Seat 2: avstero ($106.79 in chips) is sitting out
Seat 1: kvcsszblcs ($105.44 in chips) 
Seat 3: Evelexy1 ($100 in chips) 
Seat 4: Pon4uk.ua ($230.23 in chips) 
Seat 5: nastja336 ($104.22 in chips) 
Seat 6: Freebet1 ($71.18 in chips) 
Freebet1: posts small blind $0.50
kvcsszblcs: posts big blind $1
avstero: sits out 
*** HOLE CARDS ***
Evelexy1: folds 
Pon4uk.ua: folds 
nastja336: folds 
Freebet1: raises $1 to $2
kvcsszblcs: folds 
Uncalled bet ($1) returned to Freebet1
Freebet1 collected $2 from pot
*** SUMMARY ***
Total pot $2 | Rake $0 
Seat 2: avstero
Seat 1: kvcsszblcs (big blind) folded before Flop
Seat 3: Evelexy1 folded before Flop (didn't bet)
Seat 4: Pon4uk.ua folded before Flop (didn't bet)
Seat 5: nastja336 (button) folded before Flop (didn't bet)
Seat 6: Freebet1 (small blind) collected ($2)



PokerStars Hand #254396957746:  Hold'em No Limit ($0.50/$1.00 USD) - 2025/01/16 12:38:44 WET [2025/01/16 7:38:44 ET]
Table 'Stereoskopia III' 6-max Seat #6 is the button
Seat 1: kvcsszblcs ($104.44 in chips) 
Seat 2: avstero ($106.79 in chips) 
Seat 3: Evelexy1 ($100 in chips) 
Seat 4: Pon4uk.ua ($230.23 in chips) 
Seat 5: nastja336 ($104.22 in chips) 
Seat 6: Freebet1 ($72.18 in chips) 
kvcsszblcs: posts small blind $0.50
avstero: posts big blind $1
*** HOLE CARDS ***
Evelexy1: folds 
Pon4uk.ua: folds 
nastja336: folds 
Freebet1: raises $2.50 to $3.50
kvcsszblcs: folds 
avstero: folds 
Uncalled bet ($2.50) returned to Freebet1
Freebet1 collected $2.50 from pot
*** SUMMARY ***
Total pot $2.50 | Rake $0 
Seat 1: kvcsszblcs (small blind) folded before Flop
Seat 2: avstero (big blind) folded before Flop
Seat 3: Evelexy1 folded before Flop (didn't bet)
Seat 4: Pon4uk.ua folded before Flop (didn't bet)
Seat 5: nastja336 folded before Flop (didn't bet)
Seat 6: Freebet1 (button) collected ($2.50)



PokerStars Hand #254396959662:  Hold'em No Limit ($0.50/$1.00 USD) - 2025/01/16 12:38:58 WET [2025/01/16 7:38:58 ET]
Table 'Stereoskopia III' 6-max Seat #1 is the button
Seat 1: kvcsszblcs ($103.94 in chips) 
Seat 2: avstero ($105.79 in chips) 
Seat 3: Evelexy1 ($100 in chips) 
Seat 4: Pon4uk.ua ($230.23 in chips) 
Seat 5: nastja336 ($104.22 in chips) 
Seat 6: Freebet1 ($73.68 in chips) 
avstero: posts small blind $0.50
Evelexy1: posts big blind $1
*** HOLE CARDS ***
Pon4uk.ua: folds 
nastja336: folds 
Freebet1: folds 
kvcsszblcs: folds 
avstero: raises $1.80 to $2.80
Evelexy1: calls $1.80
*** FLOP *** [Th Kd 8d]
avstero: checks 
Evelexy1: checks 
*** TURN *** [Th Kd 8d] [2d]
avstero: checks 
Evelexy1: bets $3.99
avstero: folds 
Uncalled bet ($3.99) returned to Evelexy1
Evelexy1 collected $5.32 from pot
Evelexy1: doesn't show hand 
*** SUMMARY ***
Total pot $5.60 | Rake $0.28 
Board [Th Kd 8d 2d]
Seat 1: kvcsszblcs (button) folded before Flop (didn't bet)
Seat 2: avstero (small blind) folded on the Turn
Seat 3: Evelexy1 (big blind) collected ($5.32)
Seat 4: Pon4uk.ua folded before Flop (didn't bet)
Seat 5: nastja336 folded before Flop (didn't bet)
Seat 6: Freebet1 folded before Flop (didn't bet)



PokerStars Hand #254396966325:  Hold'em No Limit ($0.50/$1.00 USD) - 2025/01/16 12:39:45 WET [2025/01/16 7:39:45 ET]
Table 'Stereoskopia III' 6-max Seat #2 is the button
Seat 1: kvcsszblcs ($103.94 in chips) 
Seat 2: avstero ($102.99 in chips) 
Seat 3: Evelexy1 ($102.52 in chips) 
Seat 4: Pon4uk.ua ($230.23 in chips) 
Seat 5: nastja336 ($104.22 in chips) 
Seat 6: Freebet1 ($73.68 in chips) 
Evelexy1: posts small blind $0.50
Pon4uk.ua: posts big blind $1
*** HOLE CARDS ***
nastja336: folds 
Freebet1: folds 
kvcsszblcs: raises $1 to $2
avstero: folds 
Evelexy1: raises $7.76 to $9.76
Pon4uk.ua: folds 
kvcsszblcs: calls $7.76
*** FLOP *** [7s Ac 9c]
Evelexy1: checks 
kvcsszblcs: bets $9.75
Evelexy1: folds 
Uncalled bet ($9.75) returned to kvcsszblcs
kvcsszblcs collected $19.49 from pot
kvcsszblcs: doesn't show hand 
*** SUMMARY ***
Total pot $20.52 | Rake $1.03 
Board [7s Ac 9c]
Seat 1: kvcsszblcs collected ($19.49)
Seat 2: avstero (button) folded before Flop (didn't bet)
Seat 3: Evelexy1 (small blind) folded on the Flop
Seat 4: Pon4uk.ua (big blind) folded before Flop
Seat 5: nastja336 folded before Flop (didn't bet)
Seat 6: Freebet1 folded before Flop (didn't bet)



PokerStars Hand #254396972327:  Hold'em No Limit ($0.50/$1.00 USD) - 2025/01/16 12:40:25 WET [2025/01/16 7:40:25 ET]
Table 'Stereoskopia III' 6-max Seat #3 is the button
Seat 1: kvcsszblcs ($113.67 in chips) 
Seat 2: avstero ($102.99 in chips) 
Seat 3: Evelexy1 ($100 in chips) 
Seat 4: Pon4uk.ua ($229.23 in chips) 
Seat 5: nastja336 ($104.22 in chips) 
Seat 6: Freebet1 ($73.68 in chips) 
Pon4uk.ua: posts small blind $0.50
nastja336: posts big blind $1
*** HOLE CARDS ***
Freebet1: folds 
kvcsszblcs: folds 
avstero: folds 
Evelexy1: folds 
Pon4uk.ua: raises $1.75 to $2.75
nastja336: folds 
Uncalled bet ($1.75) returned to Pon4uk.ua
Pon4uk.ua collected $2 from pot
Pon4uk.ua: doesn't show hand 
*** SUMMARY ***
Total pot $2 | Rake $0 
Seat 1: kvcsszblcs folded before Flop (didn't bet)
Seat 2: avstero folded before Flop (didn't bet)
Seat 3: Evelexy1 (button) folded before Flop (didn't bet)
Seat 4: Pon4uk.ua (small blind) collected ($2)
Seat 5: nastja336 (big blind) folded before Flop
Seat 6: Freebet1 folded before Flop (didn't bet)



PokerStars Hand #254396975721:  Hold'em No Limit ($0.50/$1.00 USD) - 2025/01/16 12:40:48 WET [2025/01/16 7:40:48 ET]
Table 'Stereoskopia III' 6-max Seat #4 is the button
Seat 1: kvcsszblcs ($113.67 in chips) 
Seat 2: avstero ($102.99 in chips) 
Seat 3: Evelexy1 ($100 in chips) 
Seat 4: Pon4uk.ua ($230.23 in chips) 
Seat 5: nastja336 ($103.22 in chips) 
Seat 6: Freebet1 ($73.68 in chips) 
nastja336: posts small blind $0.50
Freebet1: posts big blind $1
*** HOLE CARDS ***
kvcsszblcs: raises $1 to $2
avstero: raises $5 to $7
Evelexy1: folds 
Pon4uk.ua: folds 
nastja336: folds 
Freebet1: calls $6
kvcsszblcs: folds 
*** FLOP *** [5h Ks Qd]
Freebet1: checks 
avstero: bets $4.70
Freebet1: folds 
Uncalled bet ($4.70) returned to avstero
avstero collected $15.68 from pot
avstero: doesn't show hand 
*** SUMMARY ***
Total pot $16.50 | Rake $0.82 
Board [5h Ks Qd]
Seat 1: kvcsszblcs folded before Flop
Seat 2: avstero collected ($15.68)
Seat 3: Evelexy1 folded before Flop (didn't bet)
Seat 4: Pon4uk.ua (button) folded before Flop (didn't bet)
Seat 5: nastja336 (small blind) folded before Flop
Seat 6: Freebet1 (big blind) folded on the Flop



PokerStars Hand #254396980863:  Hold'em No Limit ($0.50/$1.00 USD) - 2025/01/16 12:41:22 WET [2025/01/16 7:41:22 ET]
Table 'Stereoskopia III' 6-max Seat #5 is the button
Seat 1: kvcsszblcs ($111.67 in chips) 
Seat 2: avstero ($111.67 in chips) 
Seat 3: Evelexy1 ($100 in chips) 
Seat 4: Pon4uk.ua ($230.23 in chips) 
Seat 5: nastja336 ($102.72 in chips) 
Seat 6: Freebet1 ($66.68 in chips) 
Freebet1: posts small blind $0.50
kvcsszblcs: posts big blind $1
*** HOLE CARDS ***
avstero: folds 
Evelexy1: folds 
Pon4uk.ua: folds 
nastja336: raises $1.50 to $2.50
Freebet1: calls $2
kvcsszblcs: folds 
*** FLOP *** [7d Qd 7s]
Freebet1: checks 
nastja336: bets $1.88
Freebet1: folds 
Uncalled bet ($1.88) returned to nastja336
nastja336 collected $5.70 from pot
nastja336: doesn't show hand 
*** SUMMARY ***
Total pot $6 | Rake $0.30 
Board [7d Qd 7s]
Seat 1: kvcsszblcs (big blind) folded before Flop
Seat 2: avstero folded before Flop (didn't bet)
Seat 3: Evelexy1 folded before Flop (didn't bet)
Seat 4: Pon4uk.ua folded before Flop (didn't bet)
Seat 5: nastja336 (button) collected ($5.70)
Seat 6: Freebet1 (small blind) folded on the Flop



PokerStars Hand #254396984222:  Hold'em No Limit ($0.50/$1.00 USD) - 2025/01/16 12:41:45 WET [2025/01/16 7:41:45 ET]
Table 'Stereoskopia III' 6-max Seat #6 is the button
Seat 1: kvcsszblcs ($110.67 in chips) 
Seat 2: avstero ($111.67 in chips) 
Seat 3: Evelexy1 ($100 in chips) 
Seat 4: Pon4uk.ua ($230.23 in chips) 
Seat 5: nastja336 ($105.92 in chips) 
Seat 6: Freebet1 ($64.18 in chips) 
kvcsszblcs: posts small blind $0.50
avstero: posts big blind $1
*** HOLE CARDS ***
Evelexy1: folds 
Pon4uk.ua: raises $1 to $2
nastja336: folds 
Freebet1: calls $2
kvcsszblcs: folds 
avstero: folds 
*** FLOP *** [As Qd 9d]
Pon4uk.ua: bets $1.72
Freebet1: raises $2.72 to $4.44
Pon4uk.ua: folds 
Uncalled bet ($2.72) returned to Freebet1
Freebet1 collected $8.49 from pot
*** SUMMARY ***
Total pot $8.94 | Rake $0.45 
Board [As Qd 9d]
Seat 1: kvcsszblcs (small blind) folded before Flop
Seat 2: avstero (big blind) folded before Flop
Seat 3: Evelexy1 folded before Flop (didn't bet)
Seat 4: Pon4uk.ua folded on the Flop
Seat 5: nastja336 folded before Flop (didn't bet)
Seat 6: Freebet1 (button) collected ($8.49)



PokerStars Hand #254396991152:  Hold'em No Limit ($0.50/$1.00 USD) - 2025/01/16 12:42:31 WET [2025/01/16 7:42:31 ET]
Table 'Stereoskopia III' 6-max Seat #1 is the button
Seat 1: kvcsszblcs ($110.17 in chips) 
Seat 2: avstero ($110.67 in chips) 
Seat 3: Evelexy1 ($100 in chips) 
Seat 4: Pon4uk.ua ($226.51 in chips) 
Seat 5: nastja336 ($105.92 in chips) 
Seat 6: Freebet1 ($68.95 in chips) 
avstero: posts small blind $0.50
Evelexy1: posts big blind $1
*** HOLE CARDS ***
Pon4uk.ua: folds 
nastja336: folds 
Freebet1: folds 
kvcsszblcs: raises $1.25 to $2.25
avstero: folds 
Evelexy1: calls $1.25
*** FLOP *** [Qs 7d Ks]
Evelexy1: checks 
kvcsszblcs: bets $7.13
Evelexy1: folds 
Uncalled bet ($7.13) returned to kvcsszblcs
kvcsszblcs collected $4.75 from pot
kvcsszblcs: doesn't show hand 
*** SUMMARY ***
Total pot $5 | Rake $0.25 
Board [Qs 7d Ks]
Seat 1: kvcsszblcs (button) collected ($4.75)
Seat 2: avstero (small blind) folded before Flop
Seat 3: Evelexy1 (big blind) folded on the Flop
Seat 4: Pon4uk.ua folded before Flop (didn't bet)
Seat 5: nastja336 folded before Flop (didn't bet)
Seat 6: Freebet1 folded before Flop (didn't bet)



PokerStars Hand #254396997262:  Hold'em No Limit ($0.50/$1.00 USD) - 2025/01/16 12:43:12 WET [2025/01/16 7:43:12 ET]
Table 'Stereoskopia III' 6-max Seat #2 is the button
Seat 1: kvcsszblcs ($112.67 in chips) 
Seat 2: avstero ($110.17 in chips) 
Seat 3: Evelexy1 ($100 in chips) 
Seat 4: Pon4uk.ua ($226.51 in chips) 
Seat 5: nastja336 ($105.92 in chips) 
Seat 6: Freebet1 ($68.95 in chips) 
Evelexy1: posts small blind $0.50
Pon4uk.ua: posts big blind $1
*** HOLE CARDS ***
nastja336: folds 
Freebet1: calls $1
kvcsszblcs: folds 
avstero: folds 
Evelexy1: folds 
Pon4uk.ua: checks 
*** FLOP *** [2d 4s Kc]
Pon4uk.ua: checks 
Freebet1: checks 
*** TURN *** [2d 4s Kc] [Jh]
Pon4uk.ua: checks 
Freebet1: checks 
*** RIVER *** [2d 4s Kc Jh] [Ac]
Pon4uk.ua: checks 
Freebet1: checks 
*** SHOW DOWN ***
Pon4uk.ua: shows [Th 5d] (high card Ace)
Freebet1: shows [9d Qs] (high card Ace - King+Queen kicker)
Freebet1 collected $2.38 from pot
*** SUMMARY ***
Total pot $2.50 | Rake $0.12 
Board [2d 4s Kc Jh Ac]
Seat 1: kvcsszblcs folded before Flop (didn't bet)
Seat 2: avstero (button) folded before Flop (didn't bet)
Seat 3: Evelexy1 (small blind) folded before Flop
Seat 4: Pon4uk.ua (big blind) showed [Th 5d] and lost with high card Ace
Seat 5: nastja336 folded before Flop (didn't bet)
Seat 6: Freebet1 showed [9d Qs] and won ($2.38) with high card Ace



PokerStars Hand #254397006178:  Hold'em No Limit ($0.50/$1.00 USD) - 2025/01/16 12:44:12 WET [2025/01/16 7:44:12 ET]
Table 'Stereoskopia III' 6-max Seat #3 is the button
Seat 1: kvcsszblcs ($112.67 in chips) 
Seat 2: avstero ($110.17 in chips) 
Seat 3: Evelexy1 ($100 in chips) 
Seat 4: Pon4uk.ua ($225.51 in chips) 
Seat 5: nastja336 ($105.92 in chips) 
Seat 6: Freebet1 ($70.33 in chips) 
Pon4uk.ua: posts small blind $0.50
nastja336: posts big blind $1
*** HOLE CARDS ***
Freebet1: calls $1
kvcsszblcs: folds 
avstero: raises $3 to $4
Evelexy1: calls $4
Pon4uk.ua: folds 
nastja336: calls $3
Freebet1: calls $3
*** FLOP *** [6d 4d Qc]
nastja336: checks 
Freebet1: checks 
avstero: checks 
Evelexy1: checks 
*** TURN *** [6d 4d Qc] [Tc]
nastja336: checks 
Freebet1: bets $4
avstero: calls $4
Evelexy1: folds 
nastja336: folds 
*** RIVER *** [6d 4d Qc Tc] [3h]
Freebet1: bets $8
avstero: folds 
Uncalled bet ($8) returned to Freebet1
Freebet1 collected $23.28 from pot
*** SUMMARY ***
Total pot $24.50 | Rake $1.22 
Board [6d 4d Qc Tc 3h]
Seat 1: kvcsszblcs folded before Flop (didn't bet)
Seat 2: avstero folded on the River
Seat 3: Evelexy1 (button) folded on the Turn
Seat 4: Pon4uk.ua (small blind) folded before Flop
Seat 5: nastja336 (big blind) folded on the Turn
Seat 6: Freebet1 collected ($23.28)



PokerStars Hand #254397016939:  Hold'em No Limit ($0.50/$1.00 USD) - 2025/01/16 12:45:22 WET [2025/01/16 7:45:22 ET]
Table 'Stereoskopia III' 6-max Seat #4 is the button
Seat 1: kvcsszblcs ($112.67 in chips) 
Seat 2: avstero ($102.17 in chips) 
Seat 3: Evelexy1 ($100 in chips) 
Seat 4: Pon4uk.ua ($225.01 in chips) 
Seat 5: nastja336 ($101.92 in chips) 
Seat 6: Freebet1 ($85.61 in chips) 
nastja336: posts small blind $0.50
Freebet1: posts big blind $1
*** HOLE CARDS ***
kvcsszblcs: folds 
avstero: folds 
Evelexy1: folds 
Pon4uk.ua: folds 
nastja336: folds 
Uncalled bet ($0.50) returned to Freebet1
Freebet1 collected $1 from pot
*** SUMMARY ***
Total pot $1 | Rake $0 
Seat 1: kvcsszblcs folded before Flop (didn't bet)
Seat 2: avstero folded before Flop (didn't bet)
Seat 3: Evelexy1 folded before Flop (didn't bet)
Seat 4: Pon4uk.ua (button) folded before Flop (didn't bet)
Seat 5: nastja336 (small blind) folded before Flop
Seat 6: Freebet1 (big blind) collected ($1)



PokerStars Hand #254397019022:  Hold'em No Limit ($0.50/$1.00 USD) - 2025/01/16 12:45:36 WET [2025/01/16 7:45:36 ET]
Table 'Stereoskopia III' 6-max Seat #5 is the button
Seat 1: kvcsszblcs ($112.67 in chips) 
Seat 2: avstero ($102.17 in chips) 
Seat 3: Evelexy1 ($100 in chips) 
Seat 4: Pon4uk.ua ($225.01 in chips) 
Seat 5: nastja336 ($101.42 in chips) 
Seat 6: Freebet1 ($86.11 in chips) 
Freebet1: posts small blind $0.50
kvcsszblcs: posts big blind $1
*** HOLE CARDS ***
avstero: folds 
Evelexy1: folds 
Pon4uk.ua: folds 
nastja336: raises $1.50 to $2.50
Freebet1: folds 
kvcsszblcs: folds 
Uncalled bet ($1.50) returned to nastja336
nastja336 collected $2.50 from pot
nastja336: doesn't show hand 
*** SUMMARY ***
Total pot $2.50 | Rake $0 
Seat 1: kvcsszblcs (big blind) folded before Flop
Seat 2: avstero folded before Flop (didn't bet)
Seat 3: Evelexy1 folded before Flop (didn't bet)
Seat 4: Pon4uk.ua folded before Flop (didn't bet)
Seat 5: nastja336 (button) collected ($2.50)
Seat 6: Freebet1 (small blind) folded before Flop



PokerStars Hand #254397022775:  Hold'em No Limit ($0.50/$1.00 USD) - 2025/01/16 12:46:01 WET [2025/01/16 7:46:01 ET]
Table 'Stereoskopia III' 6-max Seat #6 is the button
Seat 1: kvcsszblcs ($111.67 in chips) 
Seat 2: avstero ($102.17 in chips) 
Seat 3: Evelexy1 ($100 in chips) 
Seat 4: Pon4uk.ua ($225.01 in chips) 
Seat 5: nastja336 ($102.92 in chips) 
Seat 6: Freebet1 ($85.61 in chips) 
kvcsszblcs: posts small blind $0.50
avstero: posts big blind $1
*** HOLE CARDS ***
Evelexy1: folds 
Pon4uk.ua: folds 
nastja336: folds 
Freebet1: raises $1 to $2
kvcsszblcs: folds 
avstero: folds 
Uncalled bet ($1) returned to Freebet1
Freebet1 collected $2.50 from pot
*** SUMMARY ***
Total pot $2.50 | Rake $0 
Seat 1: kvcsszblcs (small blind) folded before Flop
Seat 2: avstero (big blind) folded before Flop
Seat 3: Evelexy1 folded before Flop (didn't bet)
Seat 4: Pon4uk.ua folded before Flop (didn't bet)
Seat 5: nastja336 folded before Flop (didn't bet)
Seat 6: Freebet1 (button) collected ($2.50)



PokerStars Hand #254397025129:  Hold'em No Limit ($0.50/$1.00 USD) - 2025/01/16 12:46:17 WET [2025/01/16 7:46:17 ET]
Table 'Stereoskopia III' 6-max Seat #1 is the button
Seat 1: kvcsszblcs ($111.17 in chips) 
Seat 2: avstero ($101.17 in chips) 
Seat 3: Evelexy1 ($100 in chips) 
Seat 4: Pon4uk.ua ($225.01 in chips) 
Seat 5: nastja336 ($102.92 in chips) 
Seat 6: Freebet1 ($87.11 in chips) 
avstero: posts small blind $0.50
Evelexy1: posts big blind $1
*** HOLE CARDS ***
Pon4uk.ua: folds 
nastja336: folds 
Freebet1: calls $1
kvcsszblcs: folds 
avstero: raises $3 to $4
Evelexy1: folds 
Freebet1: calls $3
*** FLOP *** [6c Qc Th]
avstero: bets $2.57
Freebet1: calls $2.57
*** TURN *** [6c Qc Th] [7c]
avstero: checks 
Freebet1: checks 
*** RIVER *** [6c Qc Th 7c] [Kh]
avstero: bets $9
Freebet1: folds 
Uncalled bet ($9) returned to avstero
avstero collected $13.43 from pot
avstero: doesn't show hand 
*** SUMMARY ***
Total pot $14.14 | Rake $0.71 
Board [6c Qc Th 7c Kh]
Seat 1: kvcsszblcs (button) folded before Flop (didn't bet)
Seat 2: avstero (small blind) collected ($13.43)
Seat 3: Evelexy1 (big blind) folded before Flop
Seat 4: Pon4uk.ua folded before Flop (didn't bet)
Seat 5: nastja336 folded before Flop (didn't bet)
Seat 6: Freebet1 folded on the River



PokerStars Hand #254397032744:  Hold'em No Limit ($0.50/$1.00 USD) - 2025/01/16 12:47:06 WET [2025/01/16 7:47:06 ET]
Table 'Stereoskopia III' 6-max Seat #2 is the button
Seat 1: kvcsszblcs ($111.17 in chips) 
Seat 2: avstero ($108.03 in chips) 
Seat 3: Evelexy1 ($100 in chips) 
Seat 4: Pon4uk.ua ($225.01 in chips) 
Seat 5: nastja336 ($102.92 in chips) 
Seat 6: Freebet1 ($80.54 in chips) 
Evelexy1: posts small blind $0.50
Pon4uk.ua: posts big blind $1
*** HOLE CARDS ***
nastja336: folds 
Freebet1: calls $1
kvcsszblcs: folds 
avstero: folds 
Evelexy1: calls $0.50
Pon4uk.ua: checks 
*** FLOP *** [Qs 6s 8s]
Evelexy1: checks 
Pon4uk.ua: checks 
Freebet1: bets $2
Evelexy1: folds 
Pon4uk.ua: calls $2
*** TURN *** [Qs 6s 8s] [2d]
Pon4uk.ua: checks 
Freebet1: checks 
*** RIVER *** [Qs 6s 8s 2d] [8c]
Pon4uk.ua: bets $2.19
Freebet1: folds 
Uncalled bet ($2.19) returned to Pon4uk.ua
Pon4uk.ua collected $6.65 from pot
Pon4uk.ua: doesn't show hand 
*** SUMMARY ***
Total pot $7 | Rake $0.35 
Board [Qs 6s 8s 2d 8c]
Seat 1: kvcsszblcs folded before Flop (didn't bet)
Seat 2: avstero (button) folded before Flop (didn't bet)
Seat 3: Evelexy1 (small blind) folded on the Flop
Seat 4: Pon4uk.ua (big blind) collected ($6.65)
Seat 5: nastja336 folded before Flop (didn't bet)
Seat 6: Freebet1 folded on the River



PokerStars Hand #254397041959:  Hold'em No Limit ($0.50/$1.00 USD) - 2025/01/16 12:48:07 WET [2025/01/16 7:48:07 ET]
Table 'Stereoskopia III' 6-max Seat #3 is the button
Seat 1: kvcsszblcs ($111.17 in chips) 
Seat 2: avstero ($108.03 in chips) 
Seat 3: Evelexy1 ($100 in chips) 
Seat 4: Pon4uk.ua ($228.66 in chips) 
Seat 5: nastja336 ($102.92 in chips) 
Seat 6: Freebet1 ($77.54 in chips) 
Pon4uk.ua: posts small blind $0.50
nastja336: posts big blind $1
*** HOLE CARDS ***
Freebet1: calls $1
kvcsszblcs: folds 
avstero: raises $3.40 to $4.40
Evelexy1: folds 
Pon4uk.ua: folds 
nastja336: folds 
Freebet1: calls $3.40
*** FLOP *** [Td Kd 2s]
Freebet1: checks 
avstero: bets $2.90
Freebet1: folds 
Uncalled bet ($2.90) returned to avstero
avstero collected $9.78 from pot
avstero: doesn't show hand 
*** SUMMARY ***
Total pot $10.30 | Rake $0.52 
Board [Td Kd 2s]
Seat 1: kvcsszblcs folded before Flop (didn't bet)
Seat 2: avstero collected ($9.78)
Seat 3: Evelexy1 (button) folded before Flop (didn't bet)
Seat 4: Pon4uk.ua (small blind) folded before Flop
Seat 5: nastja336 (big blind) folded before Flop
Seat 6: Freebet1 folded on the Flop



PokerStars Hand #254397047889:  Hold'em No Limit ($0.50/$1.00 USD) - 2025/01/16 12:48:46 WET [2025/01/16 7:48:46 ET]
Table 'Stereoskopia III' 6-max Seat #4 is the button
Seat 1: kvcsszblcs ($111.17 in chips) 
Seat 2: avstero ($113.41 in chips) 
Seat 3: Evelexy1 ($100 in chips) 
Seat 4: Pon4uk.ua ($228.16 in chips) 
Seat 5: nastja336 ($101.92 in chips) 
Seat 6: Freebet1 ($73.14 in chips) 
nastja336: posts small blind $0.50
Freebet1: posts big blind $1
*** HOLE CARDS ***
kvcsszblcs: folds 
avstero: raises $1.20 to $2.20
Evelexy1: folds 
Pon4uk.ua: folds 
nastja336: folds 
Freebet1: calls $1.20
*** FLOP *** [5c 9h 4s]
Freebet1: checks 
avstero: checks 
*** TURN *** [5c 9h 4s] [3s]
Freebet1: bets $4.66
avstero: folds 
Uncalled bet ($4.66) returned to Freebet1
Freebet1 collected $4.66 from pot
*** SUMMARY ***
Total pot $4.90 | Rake $0.24 
Board [5c 9h 4s 3s]
Seat 1: kvcsszblcs folded before Flop (didn't bet)
Seat 2: avstero folded on the Turn
Seat 3: Evelexy1 folded before Flop (didn't bet)
Seat 4: Pon4uk.ua (button) folded before Flop (didn't bet)
Seat 5: nastja336 (small blind) folded before Flop
Seat 6: Freebet1 (big blind) collected ($4.66)



PokerStars Hand #254397054976:  Hold'em No Limit ($0.50/$1.00 USD) - 2025/01/16 12:49:32 WET [2025/01/16 7:49:32 ET]
Table 'Stereoskopia III' 6-max Seat #5 is the button
Seat 1: kvcsszblcs ($111.17 in chips) 
Seat 2: avstero ($111.21 in chips) 
Seat 3: Evelexy1 ($100 in chips) 
Seat 4: Pon4uk.ua ($228.16 in chips) 
Seat 5: nastja336 ($101.42 in chips) 
Seat 6: Freebet1 ($75.60 in chips) 
Freebet1: posts small blind $0.50
kvcsszblcs: posts big blind $1
*** HOLE CARDS ***
avstero: folds 
Evelexy1: folds 
Pon4uk.ua: raises $1.50 to $2.50
nastja336: raises $5 to $7.50
Freebet1: folds 
kvcsszblcs: folds 
Pon4uk.ua: folds 
Uncalled bet ($5) returned to nastja336
nastja336 collected $6.50 from pot
nastja336: doesn't show hand 
*** SUMMARY ***
Total pot $6.50 | Rake $0 
Seat 1: kvcsszblcs (big blind) folded before Flop
Seat 2: avstero folded before Flop (didn't bet)
Seat 3: Evelexy1 folded before Flop (didn't bet)
Seat 4: Pon4uk.ua folded before Flop
Seat 5: nastja336 (button) collected ($6.50)
Seat 6: Freebet1 (small blind) folded before Flop



PokerStars Hand #254397058097:  Hold'em No Limit ($0.50/$1.00 USD) - 2025/01/16 12:49:52 WET [2025/01/16 7:49:52 ET]
Table 'Stereoskopia III' 6-max Seat #6 is the button
Seat 1: kvcsszblcs ($110.17 in chips) 
Seat 2: avstero ($111.21 in chips) 
Seat 3: Evelexy1 ($100 in chips) 
Seat 4: Pon4uk.ua ($225.66 in chips) 
Seat 5: nastja336 ($105.42 in chips) 
Seat 6: Freebet1 ($75.10 in chips) 
kvcsszblcs: posts small blind $0.50
avstero: posts big blind $1
*** HOLE CARDS ***
Evelexy1: folds 
Pon4uk.ua: folds 
nastja336: folds 
Freebet1: folds 
kvcsszblcs: raises $1.85 to $2.85
avstero: folds 
Uncalled bet ($1.85) returned to kvcsszblcs
kvcsszblcs collected $2 from pot
kvcsszblcs: doesn't show hand 
*** SUMMARY ***
Total pot $2 | Rake $0 
Seat 1: kvcsszblcs (small blind) collected ($2)
Seat 2: avstero (big blind) folded before Flop
Seat 3: Evelexy1 folded before Flop (didn't bet)
Seat 4: Pon4uk.ua folded before Flop (didn't bet)
Seat 5: nastja336 folded before Flop (didn't bet)
Seat 6: Freebet1 (button) folded before Flop (didn't bet)



PokerStars Hand #254397060012:  Hold'em No Limit ($0.50/$1.00 USD) - 2025/01/16 12:50:05 WET [2025/01/16 7:50:05 ET]
Table 'Stereoskopia III' 6-max Seat #1 is the button
Seat 1: kvcsszblcs ($111.17 in chips) 
Seat 2: avstero ($110.21 in chips) 
Seat 3: Evelexy1 ($100 in chips) 
Seat 4: Pon4uk.ua ($225.66 in chips) 
Seat 5: nastja336 ($105.42 in chips) 
Seat 6: Freebet1 ($75.10 in chips) 
avstero: posts small blind $0.50
Evelexy1: posts big blind $1
*** HOLE CARDS ***
Pon4uk.ua: folds 
nastja336: folds 
Freebet1: calls $1
kvcsszblcs: raises $4 to $5
avstero: folds 
Evelexy1: folds 
Freebet1: folds 
Uncalled bet ($4) returned to kvcsszblcs
kvcsszblcs collected $3.50 from pot
kvcsszblcs: doesn't show hand 
*** SUMMARY ***
Total pot $3.50 | Rake $0 
Seat 1: kvcsszblcs (button) collected ($3.50)
Seat 2: avstero (small blind) folded before Flop
Seat 3: Evelexy1 (big blind) folded before Flop
Seat 4: Pon4uk.ua folded before Flop (didn't bet)
Seat 5: nastja336 folded before Flop (didn't bet)
Seat 6: Freebet1 folded before Flop



PokerStars Hand #254397062690:  Hold'em No Limit ($0.50/$1.00 USD) - 2025/01/16 12:50:22 WET [2025/01/16 7:50:22 ET]
Table 'Stereoskopia III' 6-max Seat #2 is the button
Seat 4: Pon4uk.ua ($225.66 in chips) is sitting out
Seat 5: nastja336 ($105.42 in chips) is sitting out
Seat 1: kvcsszblcs ($113.67 in chips) 
Seat 2: avstero ($109.71 in chips) 
Seat 3: Evelexy1 ($100 in chips) 
Seat 6: Freebet1 ($74.10 in chips) 
Evelexy1: posts small blind $0.50
Pon4uk.ua: is sitting out 
Freebet1: posts big blind $1
*** HOLE CARDS ***
Pon4uk.ua leaves the table
kvcsszblcs: folds 
avstero: folds 
Evelexy1: folds 
Uncalled bet ($0.50) returned to Freebet1
Freebet1 collected $1 from pot
*** SUMMARY ***
Total pot $1 | Rake $0 
Seat 4: Pon4uk.ua
Seat 5: nastja336
Seat 1: kvcsszblcs folded before Flop (didn't bet)
Seat 2: avstero (button) folded before Flop (didn't bet)
Seat 3: Evelexy1 (small blind) folded before Flop
Seat 6: Freebet1 (big blind) collected ($1)



PokerStars Hand #254397064445:  Hold'em No Limit ($0.50/$1.00 USD) - 2025/01/16 12:50:33 WET [2025/01/16 7:50:33 ET]
Table 'Stereoskopia III' 6-max Seat #3 is the button
Seat 5: nastja336 ($105.42 in chips) is sitting out
Seat 1: kvcsszblcs ($113.67 in chips) 
Seat 2: avstero ($109.71 in chips) 
Seat 3: Evelexy1 ($100 in chips) 
Seat 6: Freebet1 ($74.60 in chips) 
Freebet1: posts small blind $0.50
kvcsszblcs: posts big blind $1
*** HOLE CARDS ***
avstero: folds 
Evelexy1: raises $1.50 to $2.50
Freebet1: calls $2
kvcsszblcs: calls $1.50
*** FLOP *** [9c 2s 2d]
Freebet1: checks 
coeeeelho joins the table at seat #4 
kvcsszblcs: checks 
Evelexy1: bets $3.56
Freebet1: folds 
kvcsszblcs: folds 
Uncalled bet ($3.56) returned to Evelexy1
Evelexy1 collected $7.12 from pot
Evelexy1: doesn't show hand 
*** SUMMARY ***
Total pot $7.50 | Rake $0.38 
Board [9c 2s 2d]
Seat 5: nastja336
Seat 1: kvcsszblcs (big blind) folded on the Flop
Seat 2: avstero folded before Flop (didn't bet)
Seat 3: Evelexy1 (button) collected ($7.12)
Seat 6: Freebet1 (small blind) folded on the Flop



PokerStars Hand #254397069007:  Hold'em No Limit ($0.50/$1.00 USD) - 2025/01/16 12:51:03 WET [2025/01/16 7:51:03 ET]
Table 'Stereoskopia III' 6-max Seat #6 is the button
Seat 4: coeeeelho ($191.86 in chips) is sitting out
Seat 5: nastja336 ($105.42 in chips) is sitting out
Seat 1: kvcsszblcs ($111.17 in chips) 
Seat 2: avstero ($109.71 in chips) 
Seat 3: Evelexy1 ($104.62 in chips) 
Seat 6: Freebet1 ($72.10 in chips) 
kvcsszblcs: posts small blind $0.50
avstero: posts big blind $1
coeeeelho: sits out 
*** HOLE CARDS ***
Evelexy1: raises $1.50 to $2.50
Freebet1: calls $2.50
kvcsszblcs: folds 
avstero: raises $11 to $13.50
Evelexy1: raises $91.12 to $104.62 and is all-in
Freebet1: folds 
avstero: calls $91.12
*** FLOP *** [Tc 3c 9s]
*** TURN *** [Tc 3c 9s] [8s]
*** RIVER *** [Tc 3c 9s 8s] [2s]
*** SHOW DOWN ***
avstero: shows [Ks Kc] (a pair of Kings)
Evelexy1: shows [Qh Qc] (a pair of Queens)
avstero collected $211.24 from pot
*** SUMMARY ***
Total pot $212.24 | Rake $1 
Board [Tc 3c 9s 8s 2s]
Seat 4: coeeeelho
Seat 5: nastja336
Seat 1: kvcsszblcs (small blind) folded before Flop
Seat 2: avstero (big blind) showed [Ks Kc] and won ($211.24) with a pair of Kings
Seat 3: Evelexy1 showed [Qh Qc] and lost with a pair of Queens
Seat 6: Freebet1 (button) folded before Flop



PokerStars Hand #254397074710:  Hold'em No Limit ($0.50/$1.00 USD) - 2025/01/16 12:51:39 WET [2025/01/16 7:51:39 ET]
Table 'Stereoskopia III' 6-max Seat #1 is the button
Seat 4: coeeeelho ($191.86 in chips) is sitting out
Seat 5: nastja336 ($105.42 in chips) is sitting out
Seat 1: kvcsszblcs ($110.67 in chips) 
Seat 2: avstero ($216.33 in chips) 
Seat 3: Evelexy1 ($100 in chips) 
Seat 6: Freebet1 ($69.60 in chips) 
avstero: posts small blind $0.50
Evelexy1: posts big blind $1
coeeeelho: sits out 
*** HOLE CARDS ***
Freebet1: raises $1 to $2
kvcsszblcs: folds 
avstero: folds 
Evelexy1: calls $1
*** FLOP *** [8d 5d 8s]
Evelexy1: checks 
Freebet1: checks 
*** TURN *** [8d 5d 8s] [Ts]
Evelexy1: bets $2.82
Freebet1: raises $2.82 to $5.64
Evelexy1: calls $2.82
*** RIVER *** [8d 5d 8s Ts] [5c]
Evelexy1: checks 
Freebet1: bets $35
Evelexy1: folds 
Uncalled bet ($35) returned to Freebet1
Freebet1 collected $14.99 from pot
*** SUMMARY ***
Total pot $15.78 | Rake $0.79 
Board [8d 5d 8s Ts 5c]
Seat 4: coeeeelho
Seat 5: nastja336
Seat 1: kvcsszblcs (button) folded before Flop (didn't bet)
Seat 2: avstero (small blind) folded before Flop
Seat 3: Evelexy1 (big blind) folded on the River
Seat 6: Freebet1 collected ($14.99)



PokerStars Hand #254397079638:  Hold'em No Limit ($0.50/$1.00 USD) - 2025/01/16 12:52:11 WET [2025/01/16 7:52:11 ET]
Table 'Stereoskopia III' 6-max Seat #2 is the button
Seat 5: nastja336 ($105.42 in chips) is sitting out
Seat 1: kvcsszblcs ($110.67 in chips) 
Seat 2: avstero ($215.83 in chips) 
Seat 3: Evelexy1 ($100 in chips) 
Seat 4: coeeeelho ($191.86 in chips) 
Seat 6: Freebet1 ($76.95 in chips) 
Evelexy1: posts small blind $0.50
coeeeelho: posts big blind $1
*** HOLE CARDS ***
Freebet1: raises $1 to $2
kvcsszblcs: folds 
avstero: folds 
Evelexy1: folds 
coeeeelho: folds 
Uncalled bet ($1) returned to Freebet1
Freebet1 collected $2.50 from pot
*** SUMMARY ***
Total pot $2.50 | Rake $0 
Seat 5: nastja336
Seat 1: kvcsszblcs folded before Flop (didn't bet)
Seat 2: avstero (button) folded before Flop (didn't bet)
Seat 3: Evelexy1 (small blind) folded before Flop
Seat 4: coeeeelho (big blind) folded before Flop
Seat 6: Freebet1 collected ($2.50)



PokerStars Hand #254397081527:  Hold'em No Limit ($0.50/$1.00 USD) - 2025/01/16 12:52:23 WET [2025/01/16 7:52:23 ET]
Table 'Stereoskopia III' 6-max Seat #3 is the button
Seat 5: nastja336 ($105.42 in chips) is sitting out
Seat 1: kvcsszblcs ($110.67 in chips) 
Seat 2: avstero ($215.83 in chips) 
Seat 3: Evelexy1 ($100 in chips) 
Seat 4: coeeeelho ($190.86 in chips) 
Seat 6: Freebet1 ($78.45 in chips) 
coeeeelho: posts small blind $0.50
Freebet1: posts big blind $1
*** HOLE CARDS ***
kvcsszblcs: folds 
avstero: folds 
Evelexy1: raises $2 to $3
coeeeelho: folds 
Freebet1: folds 
Uncalled bet ($2) returned to Evelexy1
Evelexy1 collected $2.50 from pot
Evelexy1: doesn't show hand 
*** SUMMARY ***
Total pot $2.50 | Rake $0 
Seat 5: nastja336
Seat 1: kvcsszblcs folded before Flop (didn't bet)
Seat 2: avstero folded before Flop (didn't bet)
Seat 3: Evelexy1 (button) collected ($2.50)
Seat 4: coeeeelho (small blind) folded before Flop
Seat 6: Freebet1 (big blind) folded before Flop



PokerStars Hand #254397087038:  Hold'em No Limit ($0.50/$1.00 USD) - 2025/01/16 12:52:58 WET [2025/01/16 7:52:58 ET]
Table 'Stereoskopia III' 6-max Seat #4 is the button
Seat 5: nastja336 ($105.42 in chips) is sitting out
Seat 1: kvcsszblcs ($110.67 in chips) 
Seat 2: avstero ($215.83 in chips) 
Seat 3: Evelexy1 ($101.50 in chips) 
Seat 4: coeeeelho ($190.36 in chips) 
Seat 6: Freebet1 ($77.45 in chips) 
Freebet1: posts small blind $0.50
kvcsszblcs: posts big blind $1
*** HOLE CARDS ***
avstero: folds 
Evelexy1: folds 
coeeeelho: raises $1.20 to $2.20
Freebet1: calls $1.70
kvcsszblcs: calls $1.20
*** FLOP *** [2h 3c Jd]
Freebet1: checks 
kvcsszblcs: checks 
coeeeelho: bets $1.57
Freebet1: folds 
kvcsszblcs: folds 
Uncalled bet ($1.57) returned to coeeeelho
coeeeelho collected $6.27 from pot
*** SUMMARY ***
Total pot $6.60 | Rake $0.33 
Board [2h 3c Jd]
Seat 5: nastja336
Seat 1: kvcsszblcs (big blind) folded on the Flop
Seat 2: avstero folded before Flop (didn't bet)
Seat 3: Evelexy1 folded before Flop (didn't bet)
Seat 4: coeeeelho (button) collected ($6.27)
Seat 6: Freebet1 (small blind) folded on the Flop



PokerStars Hand #254397092247:  Hold'em No Limit ($0.50/$1.00 USD) - 2025/01/16 12:53:32 WET [2025/01/16 7:53:32 ET]
Table 'Stereoskopia III' 6-max Seat #6 is the button
Seat 5: nastja336 ($105.42 in chips) is sitting out
Seat 1: kvcsszblcs ($108.47 in chips) 
Seat 2: avstero ($215.83 in chips) 
Seat 3: Evelexy1 ($101.50 in chips) 
Seat 4: coeeeelho ($194.43 in chips) 
Seat 6: Freebet1 ($75.25 in chips) 
kvcsszblcs: posts small blind $0.50
avstero: posts big blind $1
nastja336: sits out 
*** HOLE CARDS ***
Evelexy1: raises $1 to $2
coeeeelho: folds 
Freebet1: folds 
kvcsszblcs: folds 
avstero: folds 
Uncalled bet ($1) returned to Evelexy1
Evelexy1 collected $2.50 from pot
Evelexy1: doesn't show hand 
*** SUMMARY ***
Total pot $2.50 | Rake $0 
Seat 5: nastja336
Seat 1: kvcsszblcs (small blind) folded before Flop
Seat 2: avstero (big blind) folded before Flop
Seat 3: Evelexy1 collected ($2.50)
Seat 4: coeeeelho folded before Flop (didn't bet)
Seat 6: Freebet1 (button) folded before Flop (didn't bet)



PokerStars Hand #254397094136:  Hold'em No Limit ($0.50/$1.00 USD) - 2025/01/16 12:53:44 WET [2025/01/16 7:53:44 ET]
Table 'Stereoskopia III' 6-max Seat #1 is the button
Seat 5: nastja336 ($105.42 in chips) is sitting out
Seat 1: kvcsszblcs ($107.97 in chips) 
Seat 2: avstero ($214.83 in chips) 
Seat 3: Evelexy1 ($103 in chips) 
Seat 4: coeeeelho ($194.43 in chips) 
Seat 6: Freebet1 ($75.25 in chips) 
avstero: posts small blind $0.50
Evelexy1: posts big blind $1
nastja336: sits out 
*** HOLE CARDS ***
coeeeelho: folds 
Freebet1: folds 
kvcsszblcs: folds 
avstero: folds 
Uncalled bet ($0.50) returned to Evelexy1
Evelexy1 collected $1 from pot
Evelexy1: doesn't show hand 
*** SUMMARY ***
Total pot $1 | Rake $0 
Seat 5: nastja336
Seat 1: kvcsszblcs (button) folded before Flop (didn't bet)
Seat 2: avstero (small blind) folded before Flop
Seat 3: Evelexy1 (big blind) collected ($1)
Seat 4: coeeeelho folded before Flop (didn't bet)
Seat 6: Freebet1 folded before Flop (didn't bet)



PokerStars Hand #254397096380:  Hold'em No Limit ($0.50/$1.00 USD) - 2025/01/16 12:53:59 WET [2025/01/16 7:53:59 ET]
Table 'Stereoskopia III' 6-max Seat #2 is the button
Seat 5: nastja336 ($105.42 in chips) is sitting out
Seat 1: kvcsszblcs ($107.97 in chips) 
Seat 2: avstero ($214.33 in chips) 
Seat 3: Evelexy1 ($103.50 in chips) 
Seat 4: coeeeelho ($194.43 in chips) 
Seat 6: Freebet1 ($75.25 in chips) 
Evelexy1: posts small blind $0.50
coeeeelho: posts big blind $1
nastja336: sits out 
*** HOLE CARDS ***
Freebet1: raises $1 to $2
kvcsszblcs: folds 
avstero: folds 
Evelexy1: folds 
coeeeelho: folds 
Uncalled bet ($1) returned to Freebet1
Freebet1 collected $2.50 from pot
*** SUMMARY ***
Total pot $2.50 | Rake $0 
Seat 5: nastja336
Seat 1: kvcsszblcs folded before Flop (didn't bet)
Seat 2: avstero (button) folded before Flop (didn't bet)
Seat 3: Evelexy1 (small blind) folded before Flop
Seat 4: coeeeelho (big blind) folded before Flop
Seat 6: Freebet1 collected ($2.50)



PokerStars Hand #254397098777:  Hold'em No Limit ($0.50/$1.00 USD) - 2025/01/16 12:54:14 WET [2025/01/16 7:54:14 ET]
Table 'Stereoskopia III' 6-max Seat #3 is the button
Seat 1: kvcsszblcs ($107.97 in chips) 
Seat 2: avstero ($214.33 in chips) 
Seat 3: Evelexy1 ($103 in chips) 
Seat 4: coeeeelho ($193.43 in chips) 
Seat 5: nastja336 ($105.42 in chips) 
Seat 6: Freebet1 ($76.75 in chips) 
coeeeelho: posts small blind $0.50
nastja336: posts big blind $1
*** HOLE CARDS ***
Freebet1: calls $1
kvcsszblcs: folds 
avstero: folds 
Evelexy1: folds 
coeeeelho: folds 
nastja336: raises $4 to $5
Freebet1: calls $4
*** FLOP *** [Ac Qh Ts]
nastja336: bets $7.20
Freebet1: folds 
Uncalled bet ($7.20) returned to nastja336
nastja336 collected $9.98 from pot
nastja336: doesn't show hand 
*** SUMMARY ***
Total pot $10.50 | Rake $0.52 
Board [Ac Qh Ts]
Seat 1: kvcsszblcs folded before Flop (didn't bet)
Seat 2: avstero folded before Flop (didn't bet)
Seat 3: Evelexy1 (button) folded before Flop (didn't bet)
Seat 4: coeeeelho (small blind) folded before Flop
Seat 5: nastja336 (big blind) collected ($9.98)
Seat 6: Freebet1 folded on the Flop



PokerStars Hand #254397103633:  Hold'em No Limit ($0.50/$1.00 USD) - 2025/01/16 12:54:46 WET [2025/01/16 7:54:46 ET]
Table 'Stereoskopia III' 6-max Seat #4 is the button
Seat 1: kvcsszblcs ($107.97 in chips) 
Seat 2: avstero ($214.33 in chips) 
Seat 3: Evelexy1 ($103 in chips) 
Seat 4: coeeeelho ($192.93 in chips) 
Seat 5: nastja336 ($110.40 in chips) 
Seat 6: Freebet1 ($71.75 in chips) 
nastja336: posts small blind $0.50
Freebet1: posts big blind $1
*** HOLE CARDS ***
kvcsszblcs: raises $1 to $2
avstero: folds 
Evelexy1: raises $4 to $6
coeeeelho: folds 
nastja336: folds 
Freebet1: folds 
kvcsszblcs: folds 
Uncalled bet ($4) returned to Evelexy1
Evelexy1 collected $5.50 from pot
Evelexy1: doesn't show hand 
*** SUMMARY ***
Total pot $5.50 | Rake $0 
Seat 1: kvcsszblcs folded before Flop
Seat 2: avstero folded before Flop (didn't bet)
Seat 3: Evelexy1 collected ($5.50)
Seat 4: coeeeelho (button) folded before Flop (didn't bet)
Seat 5: nastja336 (small blind) folded before Flop
Seat 6: Freebet1 (big blind) folded before Flop



PokerStars Hand #254397106177:  Hold'em No Limit ($0.50/$1.00 USD) - 2025/01/16 12:55:02 WET [2025/01/16 7:55:02 ET]
Table 'Stereoskopia III' 6-max Seat #5 is the button
Seat 1: kvcsszblcs ($105.97 in chips) 
Seat 2: avstero ($214.33 in chips) 
Seat 3: Evelexy1 ($106.50 in chips) 
Seat 4: coeeeelho ($192.93 in chips) 
Seat 5: nastja336 ($109.90 in chips) 
Seat 6: Freebet1 ($70.75 in chips) 
Freebet1: posts small blind $0.50
kvcsszblcs: posts big blind $1
*** HOLE CARDS ***
avstero: folds 
Evelexy1: folds 
coeeeelho: raises $1.20 to $2.20
nastja336: folds 
Freebet1: calls $1.70
kvcsszblcs: folds 
*** FLOP *** [Th Kc 3h]
Freebet1: bets $1
coeeeelho: folds 
Uncalled bet ($1) returned to Freebet1
Freebet1 collected $5.13 from pot
*** SUMMARY ***
Total pot $5.40 | Rake $0.27 
Board [Th Kc 3h]
Seat 1: kvcsszblcs (big blind) folded before Flop
Seat 2: avstero folded before Flop (didn't bet)
Seat 3: Evelexy1 folded before Flop (didn't bet)
Seat 4: coeeeelho folded on the Flop
Seat 5: nastja336 (button) folded before Flop (didn't bet)
Seat 6: Freebet1 (small blind) collected ($5.13)



PokerStars Hand #254397111672:  Hold'em No Limit ($0.50/$1.00 USD) - 2025/01/16 12:55:47 WET [2025/01/16 7:55:47 ET]
Table 'Stereoskopia III' 6-max Seat #6 is the button
Seat 1: kvcsszblcs ($104.97 in chips) 
Seat 2: avstero ($214.33 in chips) 
Seat 3: Evelexy1 ($106.50 in chips) 
Seat 4: coeeeelho ($190.73 in chips) 
Seat 5: nastja336 ($109.90 in chips) 
Seat 6: Freebet1 ($73.68 in chips) 
kvcsszblcs: posts small blind $0.50
avstero: posts big blind $1
*** HOLE CARDS ***
Evelexy1: folds 
coeeeelho: folds 
nastja336: folds 
Freebet1: folds 
kvcsszblcs: raises $1.85 to $2.85
avstero: folds 
Uncalled bet ($1.85) returned to kvcsszblcs
kvcsszblcs collected $2 from pot
kvcsszblcs: doesn't show hand 
*** SUMMARY ***
Total pot $2 | Rake $0 
Seat 1: kvcsszblcs (small blind) collected ($2)
Seat 2: avstero (big blind) folded before Flop
Seat 3: Evelexy1 folded before Flop (didn't bet)
Seat 4: coeeeelho folded before Flop (didn't bet)
Seat 5: nastja336 folded before Flop (didn't bet)
Seat 6: Freebet1 (button) folded before Flop (didn't bet)



PokerStars Hand #254397113637:  Hold'em No Limit ($0.50/$1.00 USD) - 2025/01/16 12:56:03 WET [2025/01/16 7:56:03 ET]
Table 'Stereoskopia III' 6-max Seat #1 is the button
Seat 1: kvcsszblcs ($105.97 in chips) 
Seat 2: avstero ($213.33 in chips) 
Seat 3: Evelexy1 ($106.50 in chips) 
Seat 4: coeeeelho ($190.73 in chips) 
Seat 5: nastja336 ($109.90 in chips) 
Seat 6: Freebet1 ($73.68 in chips) 
avstero: posts small blind $0.50
Evelexy1: posts big blind $1
*** HOLE CARDS ***
coeeeelho: raises $1.20 to $2.20
nastja336: folds 
Freebet1: folds 
kvcsszblcs: folds 
avstero: folds 
Evelexy1: raises $8.80 to $11
coeeeelho: calls $8.80
*** FLOP *** [Js 5h Ad]
Evelexy1: bets $5
coeeeelho: folds 
Uncalled bet ($5) returned to Evelexy1
Evelexy1 collected $21.38 from pot
Evelexy1: doesn't show hand 
*** SUMMARY ***
Total pot $22.50 | Rake $1.12 
Board [Js 5h Ad]
Seat 1: kvcsszblcs (button) folded before Flop (didn't bet)
Seat 2: avstero (small blind) folded before Flop
Seat 3: Evelexy1 (big blind) collected ($21.38)
Seat 4: coeeeelho folded on the Flop
Seat 5: nastja336 folded before Flop (didn't bet)
Seat 6: Freebet1 folded before Flop (didn't bet)



PokerStars Hand #254397116149:  Hold'em No Limit ($0.50/$1.00 USD) - 2025/01/16 12:56:24 WET [2025/01/16 7:56:24 ET]
Table 'Stereoskopia III' 6-max Seat #2 is the button
Seat 1: kvcsszblcs ($105.97 in chips) 
Seat 2: avstero ($212.83 in chips) 
Seat 3: Evelexy1 ($116.88 in chips) 
Seat 4: coeeeelho ($179.73 in chips) 
Seat 5: nastja336 ($109.90 in chips) 
Seat 6: Freebet1 ($73.68 in chips) 
Evelexy1: posts small blind $0.50
coeeeelho: posts big blind $1
*** HOLE CARDS ***
nastja336: folds 
Freebet1: raises $2.50 to $3.50
kvcsszblcs: folds 
avstero: raises $2.50 to $6
Evelexy1: folds 
coeeeelho: folds 
Freebet1: raises $67.68 to $73.68 and is all-in
avstero: folds 
Uncalled bet ($67.68) returned to Freebet1
Freebet1 collected $13.50 from pot
*** SUMMARY ***
Total pot $13.50 | Rake $0 
Seat 1: kvcsszblcs folded before Flop (didn't bet)
Seat 2: avstero (button) folded before Flop
Seat 3: Evelexy1 (small blind) folded before Flop
Seat 4: coeeeelho (big blind) folded before Flop
Seat 5: nastja336 folded before Flop (didn't bet)
Seat 6: Freebet1 collected ($13.50)



PokerStars Hand #254397119058:  Hold'em No Limit ($0.50/$1.00 USD) - 2025/01/16 12:56:47 WET [2025/01/16 7:56:47 ET]
Table 'Stereoskopia III' 6-max Seat #3 is the button
Seat 1: kvcsszblcs ($105.97 in chips) 
Seat 2: avstero ($206.83 in chips) 
Seat 3: Evelexy1 ($116.38 in chips) 
Seat 4: coeeeelho ($178.73 in chips) 
Seat 5: nastja336 ($109.90 in chips) 
Seat 6: Freebet1 ($81.18 in chips) 
coeeeelho: posts small blind $0.50
nastja336: posts big blind $1
*** HOLE CARDS ***
Freebet1: calls $1
kvcsszblcs: folds 
avstero: folds 
Evelexy1: folds 
coeeeelho: folds 
nastja336: raises $3 to $4
Freebet1: calls $3
*** FLOP *** [4s 3s 2d]
nastja336: checks 
Freebet1: checks 
*** TURN *** [4s 3s 2d] [3c]
nastja336: bets $2.67
Freebet1: calls $2.67
*** RIVER *** [4s 3s 2d 3c] [Ac]
nastja336: checks 
Freebet1: bets $30
nastja336: folds 
Uncalled bet ($30) returned to Freebet1
Freebet1 collected $13.15 from pot
*** SUMMARY ***
Total pot $13.84 | Rake $0.69 
Board [4s 3s 2d 3c Ac]
Seat 1: kvcsszblcs folded before Flop (didn't bet)
Seat 2: avstero folded before Flop (didn't bet)
Seat 3: Evelexy1 (button) folded before Flop (didn't bet)
Seat 4: coeeeelho (small blind) folded before Flop
Seat 5: nastja336 (big blind) folded on the River
Seat 6: Freebet1 collected ($13.15)



PokerStars Hand #254397122822:  Hold'em No Limit ($0.50/$1.00 USD) - 2025/01/16 12:57:18 WET [2025/01/16 7:57:18 ET]
Table 'Stereoskopia III' 6-max Seat #4 is the button
Seat 1: kvcsszblcs ($105.97 in chips) 
Seat 2: avstero ($206.83 in chips) 
Seat 3: Evelexy1 ($116.38 in chips) 
Seat 4: coeeeelho ($178.23 in chips) 
Seat 5: nastja336 ($103.23 in chips) 
Seat 6: Freebet1 ($87.66 in chips) 
nastja336: posts small blind $0.50
Freebet1: posts big blind $1
*** HOLE CARDS ***
kvcsszblcs: folds 
avstero: folds 
Evelexy1: raises $1.50 to $2.50
coeeeelho: folds 
nastja336: folds 
Freebet1: raises $5.50 to $8
Evelexy1: folds 
Uncalled bet ($5.50) returned to Freebet1
Freebet1 collected $5.50 from pot
*** SUMMARY ***
Total pot $5.50 | Rake $0 
Seat 1: kvcsszblcs folded before Flop (didn't bet)
Seat 2: avstero folded before Flop (didn't bet)
Seat 3: Evelexy1 folded before Flop
Seat 4: coeeeelho (button) folded before Flop (didn't bet)
Seat 5: nastja336 (small blind) folded before Flop
Seat 6: Freebet1 (big blind) collected ($5.50)



PokerStars Hand #254397125383:  Hold'em No Limit ($0.50/$1.00 USD) - 2025/01/16 12:57:38 WET [2025/01/16 7:57:38 ET]
Table 'Stereoskopia III' 6-max Seat #5 is the button
Seat 1: kvcsszblcs ($105.97 in chips) 
Seat 2: avstero ($206.83 in chips) 
Seat 3: Evelexy1 ($113.88 in chips) 
Seat 4: coeeeelho ($178.23 in chips) 
Seat 5: nastja336 ($102.73 in chips) 
Seat 6: Freebet1 ($90.66 in chips) 
Freebet1: posts small blind $0.50
kvcsszblcs: posts big blind $1
*** HOLE CARDS ***
avstero: raises $1.20 to $2.20
Evelexy1: folds 
coeeeelho: folds 
nastja336: folds 
Freebet1: calls $1.70
kvcsszblcs: folds 
*** FLOP *** [Tc Jd Td]
Freebet1: bets $1
avstero: raises $3 to $4
Freebet1: calls $3
*** TURN *** [Tc Jd Td] [Ts]
Freebet1: checks 
avstero: bets $15
Freebet1: folds 
Uncalled bet ($15) returned to avstero
avstero collected $12.73 from pot
avstero: doesn't show hand 
*** SUMMARY ***
Total pot $13.40 | Rake $0.67 
Board [Tc Jd Td Ts]
Seat 1: kvcsszblcs (big blind) folded before Flop
Seat 2: avstero collected ($12.73)
Seat 3: Evelexy1 folded before Flop (didn't bet)
Seat 4: coeeeelho folded before Flop (didn't bet)
Seat 5: nastja336 (button) folded before Flop (didn't bet)
Seat 6: Freebet1 (small blind) folded on the Turn



PokerStars Hand #254397130480:  Hold'em No Limit ($0.50/$1.00 USD) - 2025/01/16 12:58:20 WET [2025/01/16 7:58:20 ET]
Table 'Stereoskopia III' 6-max Seat #6 is the button
Seat 1: kvcsszblcs ($104.97 in chips) 
Seat 2: avstero ($213.36 in chips) 
Seat 3: Evelexy1 ($113.88 in chips) 
Seat 4: coeeeelho ($178.23 in chips) 
Seat 5: nastja336 ($102.73 in chips) 
Seat 6: Freebet1 ($84.46 in chips) 
kvcsszblcs: posts small blind $0.50
avstero: posts big blind $1
*** HOLE CARDS ***
Evelexy1: folds 
coeeeelho: folds 
nastja336: folds 
Freebet1: raises $1 to $2
kvcsszblcs: folds 
avstero: calls $1
*** FLOP *** [9h Td 7h]
avstero: checks 
Freebet1: bets $2
avstero: calls $2
*** TURN *** [9h Td 7h] [Qd]
avstero: checks 
Freebet1: checks 
*** RIVER *** [9h Td 7h Qd] [4c]
avstero: checks 
Freebet1: checks 
*** SHOW DOWN ***
avstero: shows [3h 5h] (high card Queen)
Freebet1: shows [9d 2d] (a pair of Nines)
Freebet1 collected $8.08 from pot
*** SUMMARY ***
Total pot $8.50 | Rake $0.42 
Board [9h Td 7h Qd 4c]
Seat 1: kvcsszblcs (small blind) folded before Flop
Seat 2: avstero (big blind) showed [3h 5h] and lost with high card Queen
Seat 3: Evelexy1 folded before Flop (didn't bet)
Seat 4: coeeeelho folded before Flop (didn't bet)
Seat 5: nastja336 folded before Flop (didn't bet)
Seat 6: Freebet1 (button) showed [9d 2d] and won ($8.08) with a pair of Nines



PokerStars Hand #254397139341:  Hold'em No Limit ($0.50/$1.00 USD) - 2025/01/16 12:59:34 WET [2025/01/16 7:59:34 ET]
Table 'Stereoskopia III' 6-max Seat #1 is the button
Seat 1: kvcsszblcs ($104.47 in chips) 
Seat 2: avstero ($209.36 in chips) 
Seat 3: Evelexy1 ($113.88 in chips) 
Seat 4: coeeeelho ($178.23 in chips) 
Seat 5: nastja336 ($102.73 in chips) 
Seat 6: Freebet1 ($88.54 in chips) 
avstero: posts small blind $0.50
Evelexy1: posts big blind $1
*** HOLE CARDS ***
coeeeelho: folds 
nastja336: folds 
Freebet1: calls $1
kvcsszblcs: folds 
avstero: folds 
coeeeelho leaves the table
Evelexy1: checks 
*** FLOP *** [7h 6h 4h]
Evelexy1: checks 
Freebet1: checks 
*** TURN *** [7h 6h 4h] [Jc]
ChuckNorrisQ joins the table at seat #4 
Evelexy1: bets $1
Freebet1: folds 
Uncalled bet ($1) returned to Evelexy1
Evelexy1 collected $2.38 from pot
Evelexy1: doesn't show hand 
*** SUMMARY ***
Total pot $2.50 | Rake $0.12 
Board [7h 6h 4h Jc]
Seat 1: kvcsszblcs (button) folded before Flop (didn't bet)
Seat 2: avstero (small blind) folded before Flop
Seat 3: Evelexy1 (big blind) collected ($2.38)
Seat 4: coeeeelho folded before Flop (didn't bet)
Seat 5: nastja336 folded before Flop (didn't bet)
Seat 6: Freebet1 folded on the Turn



PokerStars Hand #254397142403:  Hold'em No Limit ($0.50/$1.00 USD) - 2025/01/16 12:59:59 WET [2025/01/16 7:59:59 ET]
Table 'Stereoskopia III' 6-max Seat #2 is the button
Seat 1: kvcsszblcs ($104.47 in chips) 
Seat 2: avstero ($208.86 in chips) 
Seat 3: Evelexy1 ($115.26 in chips) 
Seat 4: ChuckNorrisQ ($100 in chips) 
Seat 5: nastja336 ($102.73 in chips) 
Seat 6: Freebet1 ($87.54 in chips) 
Evelexy1: posts small blind $0.50
ChuckNorrisQ: posts big blind $1
*** HOLE CARDS ***
nastja336: folds 
Freebet1: raises $1 to $2
kvcsszblcs: raises $7 to $9
avstero: folds 
Evelexy1: folds 
ChuckNorrisQ: folds 
Freebet1: folds 
Uncalled bet ($7) returned to kvcsszblcs
kvcsszblcs collected $5.50 from pot
kvcsszblcs: doesn't show hand 
*** SUMMARY ***
Total pot $5.50 | Rake $0 
Seat 1: kvcsszblcs collected ($5.50)
Seat 2: avstero (button) folded before Flop (didn't bet)
Seat 3: Evelexy1 (small blind) folded before Flop
Seat 4: ChuckNorrisQ (big blind) folded before Flop
Seat 5: nastja336 folded before Flop (didn't bet)
Seat 6: Freebet1 folded before Flop



PokerStars Hand #254397144261:  Hold'em No Limit ($0.50/$1.00 USD) - 2025/01/16 13:00:13 WET [2025/01/16 8:00:13 ET]
Table 'Stereoskopia III' 6-max Seat #3 is the button
Seat 1: kvcsszblcs ($107.97 in chips) 
Seat 2: avstero ($208.86 in chips) 
Seat 3: Evelexy1 ($114.76 in chips) 
Seat 4: ChuckNorrisQ ($100 in chips) 
Seat 5: nastja336 ($102.73 in chips) 
Seat 6: Freebet1 ($85.54 in chips) 
ChuckNorrisQ: posts small blind $0.50
nastja336: posts big blind $1
*** HOLE CARDS ***
Freebet1: calls $1
kvcsszblcs: folds 
avstero: folds 
Evelexy1: raises $2.50 to $3.50
ChuckNorrisQ: folds 
nastja336: calls $2.50
Freebet1: raises $11 to $14.50
Evelexy1: folds 
nastja336: folds 
Uncalled bet ($11) returned to Freebet1
Freebet1 collected $11 from pot
*** SUMMARY ***
Total pot $11 | Rake $0 
Seat 1: kvcsszblcs folded before Flop (didn't bet)
Seat 2: avstero folded before Flop (didn't bet)
Seat 3: Evelexy1 (button) folded before Flop
Seat 4: ChuckNorrisQ (small blind) folded before Flop
Seat 5: nastja336 (big blind) folded before Flop
Seat 6: Freebet1 collected ($11)



PokerStars Hand #254397146573:  Hold'em No Limit ($0.50/$1.00 USD) - 2025/01/16 13:00:32 WET [2025/01/16 8:00:32 ET]
Table 'Stereoskopia III' 6-max Seat #4 is the button
Seat 1: kvcsszblcs ($107.97 in chips) 
Seat 2: avstero ($208.86 in chips) 
Seat 3: Evelexy1 ($111.26 in chips) 
Seat 4: ChuckNorrisQ ($100 in chips) 
Seat 5: nastja336 ($100 in chips) 
Seat 6: Freebet1 ($93.04 in chips) 
nastja336: posts small blind $0.50
Freebet1: posts big blind $1
*** HOLE CARDS ***
kvcsszblcs: folds 
avstero: raises $1.20 to $2.20
Evelexy1: folds 
ChuckNorrisQ: folds 
nastja336: folds 
Freebet1: calls $1.20
*** FLOP *** [5h Qd Tc]
Freebet1: checks 
avstero: bets $1.55
Freebet1: folds 
Uncalled bet ($1.55) returned to avstero
avstero collected $4.66 from pot
avstero: doesn't show hand 
*** SUMMARY ***
Total pot $4.90 | Rake $0.24 
Board [5h Qd Tc]
Seat 1: kvcsszblcs folded before Flop (didn't bet)
Seat 2: avstero collected ($4.66)
Seat 3: Evelexy1 folded before Flop (didn't bet)
Seat 4: ChuckNorrisQ (button) folded before Flop (didn't bet)
Seat 5: nastja336 (small blind) folded before Flop
Seat 6: Freebet1 (big blind) folded on the Flop



PokerStars Hand #254397150208:  Hold'em No Limit ($0.50/$1.00 USD) - 2025/01/16 13:00:58 WET [2025/01/16 8:00:58 ET]
Table 'Stereoskopia III' 6-max Seat #5 is the button
Seat 1: kvcsszblcs ($107.97 in chips) 
Seat 2: avstero ($211.32 in chips) 
Seat 3: Evelexy1 ($111.26 in chips) 
Seat 4: ChuckNorrisQ ($100 in chips) 
Seat 5: nastja336 ($100 in chips) 
Seat 6: Freebet1 ($90.84 in chips) 
Freebet1: posts small blind $0.50
kvcsszblcs: posts big blind $1
*** HOLE CARDS ***
avstero: folds 
Evelexy1: folds 
ChuckNorrisQ: folds 
nastja336: raises $1.50 to $2.50
Freebet1: calls $2
kvcsszblcs: folds 
*** FLOP *** [3c Kh 6c]
Freebet1: checks 
nastja336: bets $2.85
Freebet1: folds 
Uncalled bet ($2.85) returned to nastja336
nastja336 collected $5.70 from pot
nastja336: doesn't show hand 
*** SUMMARY ***
Total pot $6 | Rake $0.30 
Board [3c Kh 6c]
Seat 1: kvcsszblcs (big blind) folded before Flop
Seat 2: avstero folded before Flop (didn't bet)
Seat 3: Evelexy1 folded before Flop (didn't bet)
Seat 4: ChuckNorrisQ folded before Flop (didn't bet)
Seat 5: nastja336 (button) collected ($5.70)
Seat 6: Freebet1 (small blind) folded on the Flop



PokerStars Hand #254397155123:  Hold'em No Limit ($0.50/$1.00 USD) - 2025/01/16 13:01:30 WET [2025/01/16 8:01:30 ET]
Table 'Stereoskopia III' 6-max Seat #6 is the button
Seat 1: kvcsszblcs ($106.97 in chips) 
Seat 2: avstero ($211.32 in chips) 
Seat 3: Evelexy1 ($111.26 in chips) 
Seat 4: ChuckNorrisQ ($100 in chips) 
Seat 5: nastja336 ($103.20 in chips) 
Seat 6: Freebet1 ($88.34 in chips) 
kvcsszblcs: posts small blind $0.50
avstero: posts big blind $1
*** HOLE CARDS ***
Evelexy1: raises $1 to $2
ChuckNorrisQ: folds 
nastja336: folds 
Freebet1: folds 
kvcsszblcs: folds 
avstero: folds 
Uncalled bet ($1) returned to Evelexy1
Evelexy1 collected $2.50 from pot
Evelexy1: doesn't show hand 
*** SUMMARY ***
Total pot $2.50 | Rake $0 
Seat 1: kvcsszblcs (small blind) folded before Flop
Seat 2: avstero (big blind) folded before Flop
Seat 3: Evelexy1 collected ($2.50)
Seat 4: ChuckNorrisQ folded before Flop (didn't bet)
Seat 5: nastja336 folded before Flop (didn't bet)
Seat 6: Freebet1 (button) folded before Flop (didn't bet)



PokerStars Hand #254397158444:  Hold'em No Limit ($0.50/$1.00 USD) - 2025/01/16 13:01:52 WET [2025/01/16 8:01:52 ET]
Table 'Stereoskopia III' 6-max Seat #1 is the button
Seat 1: kvcsszblcs ($106.47 in chips) 
Seat 2: avstero ($210.32 in chips) 
Seat 3: Evelexy1 ($112.76 in chips) 
Seat 4: ChuckNorrisQ ($100 in chips) 
Seat 5: nastja336 ($103.20 in chips) 
Seat 6: Freebet1 ($88.34 in chips) 
avstero: posts small blind $0.50
Evelexy1: posts big blind $1
*** HOLE CARDS ***
ChuckNorrisQ: folds 
nastja336: folds 
Freebet1: raises $1 to $2
kvcsszblcs: folds 
avstero: folds 
Evelexy1: calls $1
*** FLOP *** [4c As 7c]
Evelexy1: checks 
Freebet1: checks 
*** TURN *** [4c As 7c] [6d]
Evelexy1: checks 
Freebet1: checks 
*** RIVER *** [4c As 7c 6d] [9d]
Evelexy1: checks 
Freebet1: checks 
*** SHOW DOWN ***
Evelexy1: shows [8d Jd] (high card Ace)
Freebet1: shows [Jh Ks] (high card Ace - King kicker)
Freebet1 collected $4.28 from pot
*** SUMMARY ***
Total pot $4.50 | Rake $0.22 
Board [4c As 7c 6d 9d]
Seat 1: kvcsszblcs (button) folded before Flop (didn't bet)
Seat 2: avstero (small blind) folded before Flop
Seat 3: Evelexy1 (big blind) showed [8d Jd] and lost with high card Ace
Seat 4: ChuckNorrisQ folded before Flop (didn't bet)
Seat 5: nastja336 folded before Flop (didn't bet)
Seat 6: Freebet1 showed [Jh Ks] and won ($4.28) with high card Ace



PokerStars Hand #254397164029:  Hold'em No Limit ($0.50/$1.00 USD) - 2025/01/16 13:02:28 WET [2025/01/16 8:02:28 ET]
Table 'Stereoskopia III' 6-max Seat #2 is the button
Seat 1: kvcsszblcs ($106.47 in chips) 
Seat 2: avstero ($209.82 in chips) 
Seat 3: Evelexy1 ($110.76 in chips) 
Seat 4: ChuckNorrisQ ($100 in chips) 
Seat 5: nastja336 ($103.20 in chips) 
Seat 6: Freebet1 ($90.62 in chips) 
Evelexy1: posts small blind $0.50
ChuckNorrisQ: posts big blind $1
*** HOLE CARDS ***
nastja336: folds 
Freebet1: calls $1
kvcsszblcs: folds 
avstero: raises $3 to $4
Evelexy1: folds 
ChuckNorrisQ: folds 
Freebet1: folds 
Uncalled bet ($3) returned to avstero
avstero collected $3.50 from pot
avstero: doesn't show hand 
*** SUMMARY ***
Total pot $3.50 | Rake $0 
Seat 1: kvcsszblcs folded before Flop (didn't bet)
Seat 2: avstero (button) collected ($3.50)
Seat 3: Evelexy1 (small blind) folded before Flop
Seat 4: ChuckNorrisQ (big blind) folded before Flop
Seat 5: nastja336 folded before Flop (didn't bet)
Seat 6: Freebet1 folded before Flop



PokerStars Hand #254397167002:  Hold'em No Limit ($0.50/$1.00 USD) - 2025/01/16 13:02:47 WET [2025/01/16 8:02:47 ET]
Table 'Stereoskopia III' 6-max Seat #3 is the button
Seat 1: kvcsszblcs ($106.47 in chips) 
Seat 2: avstero ($212.32 in chips) 
Seat 3: Evelexy1 ($110.26 in chips) 
Seat 4: ChuckNorrisQ ($100 in chips) 
Seat 5: nastja336 ($103.20 in chips) 
Seat 6: Freebet1 ($89.62 in chips) 
ChuckNorrisQ: posts small blind $0.50
nastja336: posts big blind $1
*** HOLE CARDS ***
Freebet1: raises $1 to $2
kvcsszblcs: folds 
avstero: folds 
Evelexy1: raises $4 to $6
ChuckNorrisQ: raises $12 to $18
nastja336: folds 
Freebet1: folds 
Evelexy1: folds 
Uncalled bet ($12) returned to ChuckNorrisQ
ChuckNorrisQ collected $15 from pot
ChuckNorrisQ: doesn't show hand 
*** SUMMARY ***
Total pot $15 | Rake $0 
Seat 1: kvcsszblcs folded before Flop (didn't bet)
Seat 2: avstero folded before Flop (didn't bet)
Seat 3: Evelexy1 (button) folded before Flop
Seat 4: ChuckNorrisQ (small blind) collected ($15)
Seat 5: nastja336 (big blind) folded before Flop
Seat 6: Freebet1 folded before Flop



PokerStars Hand #254397171754:  Hold'em No Limit ($0.50/$1.00 USD) - 2025/01/16 13:03:17 WET [2025/01/16 8:03:17 ET]
Table 'Stereoskopia III' 6-max Seat #4 is the button
Seat 1: kvcsszblcs ($106.47 in chips) 
Seat 2: avstero ($212.32 in chips) 
Seat 3: Evelexy1 ($104.26 in chips) 
Seat 4: ChuckNorrisQ ($109 in chips) 
Seat 5: nastja336 ($102.20 in chips) 
Seat 6: Freebet1 ($87.62 in chips) 
nastja336: posts small blind $0.50
Freebet1: posts big blind $1
*** HOLE CARDS ***
kvcsszblcs: folds 
avstero: folds 
Evelexy1: raises $1.50 to $2.50
ChuckNorrisQ: folds 
nastja336: folds 
Freebet1: calls $1.50
*** FLOP *** [2c 9h 8s]
Freebet1: checks 
Evelexy1: checks 
*** TURN *** [2c 9h 8s] [Ad]
Freebet1: bets $2
Evelexy1: folds 
Uncalled bet ($2) returned to Freebet1
Freebet1 collected $5.22 from pot
*** SUMMARY ***
Total pot $5.50 | Rake $0.28 
Board [2c 9h 8s Ad]
Seat 1: kvcsszblcs folded before Flop (didn't bet)
Seat 2: avstero folded before Flop (didn't bet)
Seat 3: Evelexy1 folded on the Turn
Seat 4: ChuckNorrisQ (button) folded before Flop (didn't bet)
Seat 5: nastja336 (small blind) folded before Flop
Seat 6: Freebet1 (big blind) collected ($5.22)



PokerStars Hand #254397175206:  Hold'em No Limit ($0.50/$1.00 USD) - 2025/01/16 13:03:39 WET [2025/01/16 8:03:39 ET]
Table 'Stereoskopia III' 6-max Seat #5 is the button
Seat 1: kvcsszblcs ($106.47 in chips) 
Seat 2: avstero ($212.32 in chips) 
Seat 3: Evelexy1 ($101.76 in chips) 
Seat 4: ChuckNorrisQ ($109 in chips) 
Seat 5: nastja336 ($101.70 in chips) 
Seat 6: Freebet1 ($90.34 in chips) 
Freebet1: posts small blind $0.50
kvcsszblcs: posts big blind $1
*** HOLE CARDS ***
avstero: folds 
Evelexy1: folds 
ChuckNorrisQ: folds 
nastja336: folds 
Freebet1: folds 
Uncalled bet ($0.50) returned to kvcsszblcs
Freebet1 leaves the table
kvcsszblcs collected $1 from pot
kvcsszblcs: doesn't show hand 
*** SUMMARY ***
Total pot $1 | Rake $0 
Seat 1: kvcsszblcs (big blind) collected ($1)
Seat 2: avstero folded before Flop (didn't bet)
Seat 3: Evelexy1 folded before Flop (didn't bet)
Seat 4: ChuckNorrisQ folded before Flop (didn't bet)
Seat 5: nastja336 (button) folded before Flop (didn't bet)
Seat 6: Freebet1 (small blind) folded before Flop



PokerStars Hand #254397176931:  Hold'em No Limit ($0.50/$1.00 USD) - 2025/01/16 13:03:50 WET [2025/01/16 8:03:50 ET]
Table 'Stereoskopia III' 6-max Seat #1 is the button
Seat 3: Evelexy1 ($101.76 in chips) is sitting out
Seat 1: kvcsszblcs ($106.97 in chips) 
Seat 2: avstero ($212.32 in chips) 
Seat 4: ChuckNorrisQ ($109 in chips) 
Seat 5: nastja336 ($101.70 in chips) 
avstero: posts small blind $0.50
ChuckNorrisQ: posts big blind $1
*** HOLE CARDS ***
Evelexy1 leaves the table
nastja336: raises $1.50 to $2.50
kvcsszblcs: folds 
avstero: folds 
ChuckNorrisQ: calls $1.50
*** FLOP *** [8c Kc 5d]
ChuckNorrisQ: checks 
nastja336: bets $2.61
ChuckNorrisQ: raises $6.39 to $9
nastja336: folds 
Uncalled bet ($6.39) returned to ChuckNorrisQ
ChuckNorrisQ collected $10.18 from pot
ChuckNorrisQ: doesn't show hand 
*** SUMMARY ***
Total pot $10.72 | Rake $0.54 
Board [8c Kc 5d]
Seat 3: Evelexy1
Seat 1: kvcsszblcs (button) folded before Flop (didn't bet)
Seat 2: avstero (small blind) folded before Flop
Seat 4: ChuckNorrisQ (big blind) collected ($10.18)
Seat 5: nastja336 folded on the Flop



