PokerStars Hand #254670023199:  Hold'em No Limit ($0.50/$1.00 USD) - 2025/02/02 15:18:55 WET [2025/02/02 10:18:55 ET]
Table 'Auva II' 6-max Seat #5 is the button
Seat 1: Laiyl@ ($49.35 in chips) 
Seat 2: poker_soul11 ($100 in chips) 
Seat 3: EasyGamerrr ($101.50 in chips) 
Seat 4: IREQO ($100 in chips) 
Seat 5: alkingst ($32.62 in chips) 
Seat 6: Oli3579 ($101.97 in chips) 
Oli3579: posts small blind $0.50
Laiyl@: posts big blind $1
*** HOLE CARDS ***
poker_soul11: folds 
EasyGamerrr: folds 
IREQO: folds 
alkingst: folds 
Oli3579: folds 
Uncalled bet ($0.50) returned to Laiyl@
Laiyl@ collected $1 from pot
*** SUMMARY ***
Total pot $1 | Rake $0 
Seat 1: Laiyl@ (big blind) collected ($1)
Seat 2: poker_soul11 folded before Flop (didn't bet)
Seat 3: EasyGamerrr folded before Flop (didn't bet)
Seat 4: IREQO folded before Flop (didn't bet)
Seat 5: alkingst (button) folded before Flop (didn't bet)
Seat 6: Oli3579 (small blind) folded before Flop



PokerStars Hand #254670027115:  Hold'em No Limit ($0.50/$1.00 USD) - 2025/02/02 15:19:11 WET [2025/02/02 10:19:11 ET]
Table 'Auva II' 6-max Seat #6 is the button
Seat 1: Laiyl@ ($49.85 in chips) 
Seat 2: poker_soul11 ($100 in chips) 
Seat 3: EasyGamerrr ($101.50 in chips) 
Seat 4: IREQO ($100 in chips) 
Seat 5: alkingst ($32.62 in chips) 
Seat 6: Oli3579 ($101.47 in chips) 
Laiyl@: posts small blind $0.50
poker_soul11: posts big blind $1
*** HOLE CARDS ***
EasyGamerrr: folds 
IREQO: folds 
alkingst: folds 
Oli3579: raises $1.25 to $2.25
Laiyl@: calls $1.75
poker_soul11: folds 
*** FLOP *** [Qd Qh Ks]
Laiyl@: checks 
Oli3579: bets $1.72
Laiyl@: calls $1.72
*** TURN *** [Qd Qh Ks] [5s]
Laiyl@: checks 
Oli3579: bets $5.60
Laiyl@: folds 
Uncalled bet ($5.60) returned to Oli3579
Oli3579 collected $8.49 from pot
Oli3579: doesn't show hand 
*** SUMMARY ***
Total pot $8.94 | Rake $0.45 
Board [Qd Qh Ks 5s]
Seat 1: Laiyl@ (small blind) folded on the Turn
Seat 2: poker_soul11 (big blind) folded before Flop
Seat 3: EasyGamerrr folded before Flop (didn't bet)
Seat 4: IREQO folded before Flop (didn't bet)
Seat 5: alkingst folded before Flop (didn't bet)
Seat 6: Oli3579 (button) collected ($8.49)



PokerStars Hand #254670038264:  Hold'em No Limit ($0.50/$1.00 USD) - 2025/02/02 15:19:56 WET [2025/02/02 10:19:56 ET]
Table 'Auva II' 6-max Seat #1 is the button
Seat 1: Laiyl@ ($45.88 in chips) 
Seat 2: poker_soul11 ($100 in chips) 
Seat 3: EasyGamerrr ($101.50 in chips) 
Seat 4: IREQO ($100 in chips) 
Seat 5: alkingst ($32.62 in chips) 
Seat 6: Oli3579 ($105.99 in chips) 
poker_soul11: posts small blind $0.50
EasyGamerrr: posts big blind $1
*** HOLE CARDS ***
IREQO: folds 
alkingst: folds 
Oli3579: folds 
Laiyl@: folds 
poker_soul11: folds 
Uncalled bet ($0.50) returned to EasyGamerrr
EasyGamerrr collected $1 from pot
EasyGamerrr: doesn't show hand 
*** SUMMARY ***
Total pot $1 | Rake $0 
Seat 1: Laiyl@ (button) folded before Flop (didn't bet)
Seat 2: poker_soul11 (small blind) folded before Flop
Seat 3: EasyGamerrr (big blind) collected ($1)
Seat 4: IREQO folded before Flop (didn't bet)
Seat 5: alkingst folded before Flop (didn't bet)
Seat 6: Oli3579 folded before Flop (didn't bet)



PokerStars Hand #254670042090:  Hold'em No Limit ($0.50/$1.00 USD) - 2025/02/02 15:20:12 WET [2025/02/02 10:20:12 ET]
Table 'Auva II' 6-max Seat #2 is the button
Seat 1: Laiyl@ ($45.88 in chips) 
Seat 2: poker_soul11 ($100 in chips) 
Seat 3: EasyGamerrr ($102 in chips) 
Seat 4: IREQO ($100 in chips) 
Seat 5: alkingst ($32.62 in chips) 
Seat 6: Oli3579 ($105.99 in chips) 
EasyGamerrr: posts small blind $0.50
IREQO: posts big blind $1
*** HOLE CARDS ***
alkingst: folds 
Oli3579: raises $1.25 to $2.25
alkingst leaves the table
sta$igk joins the table at seat #5 
Laiyl@: folds 
poker_soul11: folds 
EasyGamerrr: folds 
IREQO: folds 
Uncalled bet ($1.25) returned to Oli3579
Oli3579 collected $2.50 from pot
Oli3579: doesn't show hand 
*** SUMMARY ***
Total pot $2.50 | Rake $0 
Seat 1: Laiyl@ folded before Flop (didn't bet)
Seat 2: poker_soul11 (button) folded before Flop (didn't bet)
Seat 3: EasyGamerrr (small blind) folded before Flop
Seat 4: IREQO (big blind) folded before Flop
Seat 5: alkingst folded before Flop (didn't bet)
Seat 6: Oli3579 collected ($2.50)



PokerStars Hand #254670052229:  Hold'em No Limit ($0.50/$1.00 USD) - 2025/02/02 15:20:53 WET [2025/02/02 10:20:53 ET]
Table 'Auva II' 6-max Seat #3 is the button
Seat 1: Laiyl@ ($45.88 in chips) 
Seat 2: poker_soul11 ($100 in chips) 
Seat 3: EasyGamerrr ($101.50 in chips) 
Seat 4: IREQO ($100 in chips) 
Seat 5: sta$igk ($100 in chips) 
Seat 6: Oli3579 ($107.49 in chips) 
IREQO: posts small blind $0.50
sta$igk: posts big blind $1
*** HOLE CARDS ***
Oli3579: folds 
Laiyl@: folds 
poker_soul11: raises $1.20 to $2.20
EasyGamerrr: folds 
IREQO: folds 
sta$igk: raises $9.80 to $12
poker_soul11: folds 
Uncalled bet ($9.80) returned to sta$igk
sta$igk collected $4.90 from pot
sta$igk: doesn't show hand 
*** SUMMARY ***
Total pot $4.90 | Rake $0 
Seat 1: Laiyl@ folded before Flop (didn't bet)
Seat 2: poker_soul11 folded before Flop
Seat 3: EasyGamerrr (button) folded before Flop (didn't bet)
Seat 4: IREQO (small blind) folded before Flop
Seat 5: sta$igk (big blind) collected ($4.90)
Seat 6: Oli3579 folded before Flop (didn't bet)



PokerStars Hand #254670060306:  Hold'em No Limit ($0.50/$1.00 USD) - 2025/02/02 15:21:26 WET [2025/02/02 10:21:26 ET]
Table 'Auva II' 6-max Seat #4 is the button
Seat 1: Laiyl@ ($45.88 in chips) 
Seat 2: poker_soul11 ($100 in chips) 
Seat 3: EasyGamerrr ($101.50 in chips) 
Seat 4: IREQO ($100 in chips) 
Seat 5: sta$igk ($102.70 in chips) 
Seat 6: Oli3579 ($107.49 in chips) 
sta$igk: posts small blind $0.50
Oli3579: posts big blind $1
*** HOLE CARDS ***
Laiyl@: folds 
poker_soul11: folds 
EasyGamerrr: folds 
IREQO: raises $1.50 to $2.50
sta$igk: folds 
Oli3579: folds 
Uncalled bet ($1.50) returned to IREQO
IREQO collected $2.50 from pot
IREQO: doesn't show hand 
*** SUMMARY ***
Total pot $2.50 | Rake $0 
Seat 1: Laiyl@ folded before Flop (didn't bet)
Seat 2: poker_soul11 folded before Flop (didn't bet)
Seat 3: EasyGamerrr folded before Flop (didn't bet)
Seat 4: IREQO (button) collected ($2.50)
Seat 5: sta$igk (small blind) folded before Flop
Seat 6: Oli3579 (big blind) folded before Flop



PokerStars Hand #254670068126:  Hold'em No Limit ($0.50/$1.00 USD) - 2025/02/02 15:21:58 WET [2025/02/02 10:21:58 ET]
Table 'Auva II' 6-max Seat #5 is the button
Seat 1: Laiyl@ ($45.88 in chips) 
Seat 2: poker_soul11 ($100 in chips) 
Seat 3: EasyGamerrr ($101.50 in chips) 
Seat 4: IREQO ($101.50 in chips) 
Seat 5: sta$igk ($102.20 in chips) 
Seat 6: Oli3579 ($106.49 in chips) 
Oli3579: posts small blind $0.50
Laiyl@: posts big blind $1
*** HOLE CARDS ***
poker_soul11: raises $1.20 to $2.20
EasyGamerrr: folds 
IREQO: raises $4.80 to $7
sta$igk: folds 
Oli3579: folds 
Laiyl@ has timed out
Laiyl@: folds 
poker_soul11: calls $4.80
*** FLOP *** [6h 8c 3h]
poker_soul11: checks 
IREQO: bets $7.36
poker_soul11: folds 
Uncalled bet ($7.36) returned to IREQO
IREQO collected $14.72 from pot
IREQO: doesn't show hand 
*** SUMMARY ***
Total pot $15.50 | Rake $0.78 
Board [6h 8c 3h]
Seat 1: Laiyl@ (big blind) folded before Flop
Seat 2: poker_soul11 folded on the Flop
Seat 3: EasyGamerrr folded before Flop (didn't bet)
Seat 4: IREQO collected ($14.72)
Seat 5: sta$igk (button) folded before Flop (didn't bet)
Seat 6: Oli3579 (small blind) folded before Flop



PokerStars Hand #254670090280:  Hold'em No Limit ($0.50/$1.00 USD) - 2025/02/02 15:23:27 WET [2025/02/02 10:23:27 ET]
Table 'Auva II' 6-max Seat #6 is the button
Seat 1: Laiyl@ ($44.88 in chips) 
Seat 2: poker_soul11 ($100 in chips) 
Seat 3: EasyGamerrr ($101.50 in chips) 
Seat 4: IREQO ($109.22 in chips) 
Seat 5: sta$igk ($102.20 in chips) 
Seat 6: Oli3579 ($105.99 in chips) 
Laiyl@: posts small blind $0.50
poker_soul11: posts big blind $1
*** HOLE CARDS ***
EasyGamerrr: folds 
IREQO: folds 
sta$igk: folds 
Oli3579: raises $1.25 to $2.25
Laiyl@: calls $1.75
poker_soul11: folds 
*** FLOP *** [Ah Js 5d]
Laiyl@: checks 
Oli3579: bets $3.92
Laiyl@: folds 
Uncalled bet ($3.92) returned to Oli3579
Oli3579 collected $5.22 from pot
Oli3579: doesn't show hand 
*** SUMMARY ***
Total pot $5.50 | Rake $0.28 
Board [Ah Js 5d]
Seat 1: Laiyl@ (small blind) folded on the Flop
Seat 2: poker_soul11 (big blind) folded before Flop
Seat 3: EasyGamerrr folded before Flop (didn't bet)
Seat 4: IREQO folded before Flop (didn't bet)
Seat 5: sta$igk folded before Flop (didn't bet)
Seat 6: Oli3579 (button) collected ($5.22)



PokerStars Hand #254670100703:  Hold'em No Limit ($0.50/$1.00 USD) - 2025/02/02 15:24:09 WET [2025/02/02 10:24:09 ET]
Table 'Auva II' 6-max Seat #1 is the button
Seat 1: Laiyl@ ($42.63 in chips) 
Seat 2: poker_soul11 ($100 in chips) 
Seat 3: EasyGamerrr ($101.50 in chips) 
Seat 4: IREQO ($109.22 in chips) 
Seat 5: sta$igk ($102.20 in chips) 
Seat 6: Oli3579 ($108.96 in chips) 
poker_soul11: posts small blind $0.50
EasyGamerrr: posts big blind $1
*** HOLE CARDS ***
IREQO: folds 
sta$igk: folds 
Oli3579: folds 
Laiyl@ has timed out
Laiyl@: folds 
Oli3579 leaves the table
poker_soul11: folds 
Uncalled bet ($0.50) returned to EasyGamerrr
EasyGamerrr collected $1 from pot
EasyGamerrr: doesn't show hand 
*** SUMMARY ***
Total pot $1 | Rake $0 
Seat 1: Laiyl@ (button) folded before Flop (didn't bet)
Seat 2: poker_soul11 (small blind) folded before Flop
Seat 3: EasyGamerrr (big blind) collected ($1)
Seat 4: IREQO folded before Flop (didn't bet)
Seat 5: sta$igk folded before Flop (didn't bet)
Seat 6: Oli3579 folded before Flop (didn't bet)



PokerStars Hand #254670106795:  Hold'em No Limit ($0.50/$1.00 USD) - 2025/02/02 15:24:33 WET [2025/02/02 10:24:33 ET]
Table 'Auva II' 6-max Seat #2 is the button
Seat 1: Laiyl@ ($42.63 in chips) is sitting out
Seat 2: poker_soul11 ($100 in chips) 
Seat 3: EasyGamerrr ($102 in chips) 
Seat 4: IREQO ($109.22 in chips) 
Seat 5: sta$igk ($102.20 in chips) 
EasyGamerrr: posts small blind $0.50
IREQO: posts big blind $1
*** HOLE CARDS ***
sta$igk: folds 
poker_soul11: folds 
BGS013 joins the table at seat #6 
EasyGamerrr: folds 
Uncalled bet ($0.50) returned to IREQO
IREQO collected $1 from pot
IREQO: doesn't show hand 
*** SUMMARY ***
Total pot $1 | Rake $0 
Seat 1: Laiyl@
Seat 2: poker_soul11 (button) folded before Flop (didn't bet)
Seat 3: EasyGamerrr (small blind) folded before Flop
Seat 4: IREQO (big blind) collected ($1)
Seat 5: sta$igk folded before Flop (didn't bet)



PokerStars Hand #254670110040:  Hold'em No Limit ($0.50/$1.00 USD) - 2025/02/02 15:24:46 WET [2025/02/02 10:24:46 ET]
Table 'Auva II' 6-max Seat #3 is the button
Seat 6: BGS013 ($100 in chips) is sitting out
Seat 1: Laiyl@ ($42.63 in chips) 
Seat 2: poker_soul11 ($100 in chips) 
Seat 3: EasyGamerrr ($101.50 in chips) 
Seat 4: IREQO ($109.72 in chips) 
Seat 5: sta$igk ($102.20 in chips) 
IREQO: posts small blind $0.50
sta$igk: posts big blind $1
BGS013: sits out 
*** HOLE CARDS ***
Laiyl@: folds 
poker_soul11: folds 
EasyGamerrr: folds 
IREQO: raises $1.50 to $2.50
sta$igk: raises $6.50 to $9
IREQO: folds 
Uncalled bet ($6.50) returned to sta$igk
sta$igk collected $5 from pot
sta$igk: doesn't show hand 
*** SUMMARY ***
Total pot $5 | Rake $0 
Seat 6: BGS013
Seat 1: Laiyl@ folded before Flop (didn't bet)
Seat 2: poker_soul11 folded before Flop (didn't bet)
Seat 3: EasyGamerrr (button) folded before Flop (didn't bet)
Seat 4: IREQO (small blind) folded before Flop
Seat 5: sta$igk (big blind) collected ($5)



PokerStars Hand #254670119305:  Hold'em No Limit ($0.50/$1.00 USD) - 2025/02/02 15:25:23 WET [2025/02/02 10:25:23 ET]
Table 'Auva II' 6-max Seat #4 is the button
Seat 1: Laiyl@ ($42.63 in chips) 
Seat 2: poker_soul11 ($100 in chips) 
Seat 3: EasyGamerrr ($101.50 in chips) 
Seat 4: IREQO ($107.22 in chips) 
Seat 5: sta$igk ($104.70 in chips) 
Seat 6: BGS013 ($100 in chips) 
sta$igk: posts small blind $0.50
BGS013: posts big blind $1
*** HOLE CARDS ***
Laiyl@: folds 
poker_soul11: folds 
EasyGamerrr: folds 
IREQO: raises $1.50 to $2.50
sta$igk: folds 
BGS013: folds 
Uncalled bet ($1.50) returned to IREQO
IREQO collected $2.50 from pot
IREQO: doesn't show hand 
*** SUMMARY ***
Total pot $2.50 | Rake $0 
Seat 1: Laiyl@ folded before Flop (didn't bet)
Seat 2: poker_soul11 folded before Flop (didn't bet)
Seat 3: EasyGamerrr folded before Flop (didn't bet)
Seat 4: IREQO (button) collected ($2.50)
Seat 5: sta$igk (small blind) folded before Flop
Seat 6: BGS013 (big blind) folded before Flop



PokerStars Hand #254670126207:  Hold'em No Limit ($0.50/$1.00 USD) - 2025/02/02 15:25:50 WET [2025/02/02 10:25:50 ET]
Table 'Auva II' 6-max Seat #5 is the button
Seat 1: Laiyl@ ($42.63 in chips) 
Seat 2: poker_soul11 ($100 in chips) 
Seat 3: EasyGamerrr ($101.50 in chips) 
Seat 4: IREQO ($108.72 in chips) 
Seat 5: sta$igk ($104.20 in chips) 
Seat 6: BGS013 ($100 in chips) 
BGS013: posts small blind $0.50
Laiyl@: posts big blind $1
*** HOLE CARDS ***
poker_soul11: folds 
EasyGamerrr: folds 
IREQO: folds 
sta$igk: raises $1.50 to $2.50
BGS013: folds 
Laiyl@: calls $1.50
*** FLOP *** [9c Ts 3d]
Laiyl@: checks 
sta$igk: bets $1.72
Laiyl@: folds 
Uncalled bet ($1.72) returned to sta$igk
sta$igk collected $5.22 from pot
sta$igk: doesn't show hand 
*** SUMMARY ***
Total pot $5.50 | Rake $0.28 
Board [9c Ts 3d]
Seat 1: Laiyl@ (big blind) folded on the Flop
Seat 2: poker_soul11 folded before Flop (didn't bet)
Seat 3: EasyGamerrr folded before Flop (didn't bet)
Seat 4: IREQO folded before Flop (didn't bet)
Seat 5: sta$igk (button) collected ($5.22)
Seat 6: BGS013 (small blind) folded before Flop



PokerStars Hand #254670135927:  Hold'em No Limit ($0.50/$1.00 USD) - 2025/02/02 15:26:29 WET [2025/02/02 10:26:29 ET]
Table 'Auva II' 6-max Seat #6 is the button
Seat 1: Laiyl@ ($40.13 in chips) 
Seat 2: poker_soul11 ($100 in chips) 
Seat 3: EasyGamerrr ($101.50 in chips) 
Seat 4: IREQO ($108.72 in chips) 
Seat 5: sta$igk ($106.92 in chips) 
Seat 6: BGS013 ($100 in chips) 
Laiyl@: posts small blind $0.50
poker_soul11: posts big blind $1
*** HOLE CARDS ***
EasyGamerrr: folds 
IREQO: folds 
sta$igk: raises $1.50 to $2.50
BGS013: folds 
Laiyl@: folds 
poker_soul11: folds 
Uncalled bet ($1.50) returned to sta$igk
sta$igk collected $2.50 from pot
sta$igk: doesn't show hand 
*** SUMMARY ***
Total pot $2.50 | Rake $0 
Seat 1: Laiyl@ (small blind) folded before Flop
Seat 2: poker_soul11 (big blind) folded before Flop
Seat 3: EasyGamerrr folded before Flop (didn't bet)
Seat 4: IREQO folded before Flop (didn't bet)
Seat 5: sta$igk collected ($2.50)
Seat 6: BGS013 (button) folded before Flop (didn't bet)



PokerStars Hand #254670146780:  Hold'em No Limit ($0.50/$1.00 USD) - 2025/02/02 15:27:13 WET [2025/02/02 10:27:13 ET]
Table 'Auva II' 6-max Seat #1 is the button
Seat 1: Laiyl@ ($39.63 in chips) 
Seat 2: poker_soul11 ($100 in chips) 
Seat 3: EasyGamerrr ($101.50 in chips) 
Seat 4: IREQO ($108.72 in chips) 
Seat 5: sta$igk ($108.42 in chips) 
Seat 6: BGS013 ($100 in chips) 
poker_soul11: posts small blind $0.50
EasyGamerrr: posts big blind $1
*** HOLE CARDS ***
IREQO: folds 
sta$igk: folds 
BGS013: raises $1.50 to $2.50
Laiyl@: calls $2.50
poker_soul11: folds 
EasyGamerrr: folds 
*** FLOP *** [6s 6d Th]
BGS013: checks 
Laiyl@: bets $4
BGS013: calls $4
*** TURN *** [6s 6d Th] [Qc]
BGS013: checks 
Laiyl@: checks 
*** RIVER *** [6s 6d Th Qc] [2c]
BGS013: checks 
Laiyl@: checks 
*** SHOW DOWN ***
BGS013: shows [As 9s] (a pair of Sixes)
Laiyl@: shows [9h Ac] (a pair of Sixes)
BGS013 collected $6.89 from pot
Laiyl@ collected $6.89 from pot
*** SUMMARY ***
Total pot $14.50 | Rake $0.72 
Board [6s 6d Th Qc 2c]
Seat 1: Laiyl@ (button) showed [9h Ac] and won ($6.89) with a pair of Sixes
Seat 2: poker_soul11 (small blind) folded before Flop
Seat 3: EasyGamerrr (big blind) folded before Flop
Seat 4: IREQO folded before Flop (didn't bet)
Seat 5: sta$igk folded before Flop (didn't bet)
Seat 6: BGS013 showed [As 9s] and won ($6.89) with a pair of Sixes



PokerStars Hand #254670155108:  Hold'em No Limit ($0.50/$1.00 USD) - 2025/02/02 15:27:46 WET [2025/02/02 10:27:46 ET]
Table 'Auva II' 6-max Seat #2 is the button
Seat 1: Laiyl@ ($40.02 in chips) 
Seat 2: poker_soul11 ($100 in chips) 
Seat 3: EasyGamerrr ($100.50 in chips) 
Seat 4: IREQO ($108.72 in chips) 
Seat 5: sta$igk ($108.42 in chips) 
Seat 6: BGS013 ($100.39 in chips) 
EasyGamerrr: posts small blind $0.50
IREQO: posts big blind $1
*** HOLE CARDS ***
sta$igk: folds 
BGS013: folds 
Laiyl@: folds 
poker_soul11: raises $1.20 to $2.20
EasyGamerrr: folds 
IREQO: folds 
Uncalled bet ($1.20) returned to poker_soul11
poker_soul11 collected $2.50 from pot
poker_soul11: doesn't show hand 
*** SUMMARY ***
Total pot $2.50 | Rake $0 
Seat 1: Laiyl@ folded before Flop (didn't bet)
Seat 2: poker_soul11 (button) collected ($2.50)
Seat 3: EasyGamerrr (small blind) folded before Flop
Seat 4: IREQO (big blind) folded before Flop
Seat 5: sta$igk folded before Flop (didn't bet)
Seat 6: BGS013 folded before Flop (didn't bet)



PokerStars Hand #254670160305:  Hold'em No Limit ($0.50/$1.00 USD) - 2025/02/02 15:28:07 WET [2025/02/02 10:28:07 ET]
Table 'Auva II' 6-max Seat #3 is the button
Seat 1: Laiyl@ ($40.02 in chips) 
Seat 2: poker_soul11 ($101.50 in chips) 
Seat 3: EasyGamerrr ($100 in chips) 
Seat 4: IREQO ($107.72 in chips) 
Seat 5: sta$igk ($108.42 in chips) 
Seat 6: BGS013 ($100.39 in chips) 
IREQO: posts small blind $0.50
sta$igk: posts big blind $1
*** HOLE CARDS ***
BGS013: raises $1 to $2
Laiyl@: folds 
poker_soul11: folds 
EasyGamerrr: folds 
IREQO: folds 
sta$igk: folds 
Uncalled bet ($1) returned to BGS013
BGS013 collected $2.50 from pot
BGS013: doesn't show hand 
*** SUMMARY ***
Total pot $2.50 | Rake $0 
Seat 1: Laiyl@ folded before Flop (didn't bet)
Seat 2: poker_soul11 folded before Flop (didn't bet)
Seat 3: EasyGamerrr (button) folded before Flop (didn't bet)
Seat 4: IREQO (small blind) folded before Flop
Seat 5: sta$igk (big blind) folded before Flop
Seat 6: BGS013 collected ($2.50)



PokerStars Hand #254670165052:  Hold'em No Limit ($0.50/$1.00 USD) - 2025/02/02 15:28:27 WET [2025/02/02 10:28:27 ET]
Table 'Auva II' 6-max Seat #4 is the button
Seat 1: Laiyl@ ($40.02 in chips) 
Seat 2: poker_soul11 ($101.50 in chips) 
Seat 3: EasyGamerrr ($100 in chips) 
Seat 4: IREQO ($107.22 in chips) 
Seat 5: sta$igk ($107.42 in chips) 
Seat 6: BGS013 ($101.89 in chips) 
sta$igk: posts small blind $0.50
BGS013: posts big blind $1
*** HOLE CARDS ***
Laiyl@: folds 
poker_soul11: folds 
EasyGamerrr: folds 
IREQO: raises $1.50 to $2.50
sta$igk: folds 
BGS013: raises $9 to $11.50
IREQO: folds 
Uncalled bet ($9) returned to BGS013
BGS013 collected $5.50 from pot
BGS013: doesn't show hand 
*** SUMMARY ***
Total pot $5.50 | Rake $0 
Seat 1: Laiyl@ folded before Flop (didn't bet)
Seat 2: poker_soul11 folded before Flop (didn't bet)
Seat 3: EasyGamerrr folded before Flop (didn't bet)
Seat 4: IREQO (button) folded before Flop
Seat 5: sta$igk (small blind) folded before Flop
Seat 6: BGS013 (big blind) collected ($5.50)



PokerStars Hand #254670179296:  Hold'em No Limit ($0.50/$1.00 USD) - 2025/02/02 15:29:24 WET [2025/02/02 10:29:24 ET]
Table 'Auva II' 6-max Seat #5 is the button
Seat 1: Laiyl@ ($40.02 in chips) 
Seat 2: poker_soul11 ($101.50 in chips) 
Seat 3: EasyGamerrr ($100 in chips) 
Seat 4: IREQO ($104.72 in chips) 
Seat 5: sta$igk ($106.92 in chips) 
Seat 6: BGS013 ($104.89 in chips) 
BGS013: posts small blind $0.50
Laiyl@: posts big blind $1
*** HOLE CARDS ***
poker_soul11: folds 
EasyGamerrr: folds 
IREQO: folds 
sta$igk: folds 
BGS013: raises $2 to $3
Laiyl@: calls $2
*** FLOP *** [2s Jd 7d]
BGS013: checks 
Laiyl@: checks 
*** TURN *** [2s Jd 7d] [Qs]
BGS013: checks 
Laiyl@: bets $2.85
BGS013: folds 
Uncalled bet ($2.85) returned to Laiyl@
Laiyl@ collected $5.70 from pot
*** SUMMARY ***
Total pot $6 | Rake $0.30 
Board [2s Jd 7d Qs]
Seat 1: Laiyl@ (big blind) collected ($5.70)
Seat 2: poker_soul11 folded before Flop (didn't bet)
Seat 3: EasyGamerrr folded before Flop (didn't bet)
Seat 4: IREQO folded before Flop (didn't bet)
Seat 5: sta$igk (button) folded before Flop (didn't bet)
Seat 6: BGS013 (small blind) folded on the Turn



PokerStars Hand #254670195010:  Hold'em No Limit ($0.50/$1.00 USD) - 2025/02/02 15:30:26 WET [2025/02/02 10:30:26 ET]
Table 'Auva II' 6-max Seat #6 is the button
Seat 1: Laiyl@ ($42.72 in chips) 
Seat 2: poker_soul11 ($101.50 in chips) 
Seat 3: EasyGamerrr ($100 in chips) 
Seat 4: IREQO ($104.72 in chips) 
Seat 5: sta$igk ($106.92 in chips) 
Seat 6: BGS013 ($101.89 in chips) 
Laiyl@: posts small blind $0.50
poker_soul11: posts big blind $1
*** HOLE CARDS ***
EasyGamerrr: folds 
IREQO: folds 
sta$igk: raises $1.50 to $2.50
BGS013: folds 
Laiyl@: folds 
poker_soul11: folds 
Uncalled bet ($1.50) returned to sta$igk
sta$igk collected $2.50 from pot
sta$igk: doesn't show hand 
*** SUMMARY ***
Total pot $2.50 | Rake $0 
Seat 1: Laiyl@ (small blind) folded before Flop
Seat 2: poker_soul11 (big blind) folded before Flop
Seat 3: EasyGamerrr folded before Flop (didn't bet)
Seat 4: IREQO folded before Flop (didn't bet)
Seat 5: sta$igk collected ($2.50)
Seat 6: BGS013 (button) folded before Flop (didn't bet)



PokerStars Hand #254670200421:  Hold'em No Limit ($0.50/$1.00 USD) - 2025/02/02 15:30:48 WET [2025/02/02 10:30:48 ET]
Table 'Auva II' 6-max Seat #1 is the button
Seat 1: Laiyl@ ($42.22 in chips) 
Seat 2: poker_soul11 ($100.50 in chips) 
Seat 3: EasyGamerrr ($100 in chips) 
Seat 4: IREQO ($104.72 in chips) 
Seat 5: sta$igk ($108.42 in chips) 
Seat 6: BGS013 ($101.89 in chips) 
poker_soul11: posts small blind $0.50
EasyGamerrr: posts big blind $1
*** HOLE CARDS ***
IREQO: raises $1.50 to $2.50
sta$igk: folds 
BGS013: folds 
Laiyl@: folds 
poker_soul11: folds 
EasyGamerrr: folds 
Uncalled bet ($1.50) returned to IREQO
IREQO collected $2.50 from pot
IREQO: doesn't show hand 
*** SUMMARY ***
Total pot $2.50 | Rake $0 
Seat 1: Laiyl@ (button) folded before Flop (didn't bet)
Seat 2: poker_soul11 (small blind) folded before Flop
Seat 3: EasyGamerrr (big blind) folded before Flop
Seat 4: IREQO collected ($2.50)
Seat 5: sta$igk folded before Flop (didn't bet)
Seat 6: BGS013 folded before Flop (didn't bet)



PokerStars Hand #254670206074:  Hold'em No Limit ($0.50/$1.00 USD) - 2025/02/02 15:31:10 WET [2025/02/02 10:31:10 ET]
Table 'Auva II' 6-max Seat #2 is the button
Seat 1: Laiyl@ ($42.22 in chips) 
Seat 2: poker_soul11 ($100 in chips) 
Seat 3: EasyGamerrr ($100 in chips) 
Seat 4: IREQO ($106.22 in chips) 
Seat 5: sta$igk ($108.42 in chips) 
Seat 6: BGS013 ($101.89 in chips) 
EasyGamerrr: posts small blind $0.50
IREQO: posts big blind $1
*** HOLE CARDS ***
sta$igk: folds 
BGS013: folds 
Laiyl@: calls $1
poker_soul11: folds 
EasyGamerrr: folds 
IREQO: checks 
*** FLOP *** [Ac 9s 8c]
IREQO: checks 
Laiyl@: bets $1.19
IREQO: folds 
Uncalled bet ($1.19) returned to Laiyl@
Laiyl@ collected $2.38 from pot
*** SUMMARY ***
Total pot $2.50 | Rake $0.12 
Board [Ac 9s 8c]
Seat 1: Laiyl@ collected ($2.38)
Seat 2: poker_soul11 (button) folded before Flop (didn't bet)
Seat 3: EasyGamerrr (small blind) folded before Flop
Seat 4: IREQO (big blind) folded on the Flop
Seat 5: sta$igk folded before Flop (didn't bet)
Seat 6: BGS013 folded before Flop (didn't bet)



PokerStars Hand #254670218110:  Hold'em No Limit ($0.50/$1.00 USD) - 2025/02/02 15:31:57 WET [2025/02/02 10:31:57 ET]
Table 'Auva II' 6-max Seat #3 is the button
Seat 1: Laiyl@ ($43.60 in chips) 
Seat 2: poker_soul11 ($100 in chips) 
Seat 3: EasyGamerrr ($100 in chips) 
Seat 4: IREQO ($105.22 in chips) 
Seat 5: sta$igk ($108.42 in chips) 
Seat 6: BGS013 ($101.89 in chips) 
IREQO: posts small blind $0.50
sta$igk: posts big blind $1
*** HOLE CARDS ***
BGS013 has timed out
BGS013: folds 
Laiyl@: raises $2.50 to $3.50
poker_soul11: folds 
EasyGamerrr: folds 
IREQO: folds 
sta$igk: folds 
Uncalled bet ($2.50) returned to Laiyl@
Laiyl@ collected $2.50 from pot
*** SUMMARY ***
Total pot $2.50 | Rake $0 
Seat 1: Laiyl@ collected ($2.50)
Seat 2: poker_soul11 folded before Flop (didn't bet)
Seat 3: EasyGamerrr (button) folded before Flop (didn't bet)
Seat 4: IREQO (small blind) folded before Flop
Seat 5: sta$igk (big blind) folded before Flop
Seat 6: BGS013 folded before Flop (didn't bet)



PokerStars Hand #254670227779:  Hold'em No Limit ($0.50/$1.00 USD) - 2025/02/02 15:32:36 WET [2025/02/02 10:32:36 ET]
Table 'Auva II' 6-max Seat #4 is the button
Seat 1: Laiyl@ ($45.10 in chips) 
Seat 2: poker_soul11 ($100 in chips) 
Seat 3: EasyGamerrr ($100 in chips) 
Seat 4: IREQO ($104.72 in chips) 
Seat 5: sta$igk ($107.42 in chips) 
Seat 6: BGS013 ($101.89 in chips) 
sta$igk: posts small blind $0.50
BGS013: posts big blind $1
*** HOLE CARDS ***
Laiyl@: folds 
poker_soul11: folds 
EasyGamerrr: folds 
IREQO: folds 
sta$igk: folds 
Uncalled bet ($0.50) returned to BGS013
BGS013 collected $1 from pot
BGS013: doesn't show hand 
*** SUMMARY ***
Total pot $1 | Rake $0 
Seat 1: Laiyl@ folded before Flop (didn't bet)
Seat 2: poker_soul11 folded before Flop (didn't bet)
Seat 3: EasyGamerrr folded before Flop (didn't bet)
Seat 4: IREQO (button) folded before Flop (didn't bet)
Seat 5: sta$igk (small blind) folded before Flop
Seat 6: BGS013 (big blind) collected ($1)



PokerStars Hand #254670231946:  Hold'em No Limit ($0.50/$1.00 USD) - 2025/02/02 15:32:52 WET [2025/02/02 10:32:52 ET]
Table 'Auva II' 6-max Seat #5 is the button
Seat 1: Laiyl@ ($45.10 in chips) 
Seat 2: poker_soul11 ($100 in chips) 
Seat 3: EasyGamerrr ($100 in chips) 
Seat 4: IREQO ($104.72 in chips) 
Seat 5: sta$igk ($106.92 in chips) 
Seat 6: BGS013 ($102.39 in chips) 
BGS013: posts small blind $0.50
Laiyl@: posts big blind $1
*** HOLE CARDS ***
poker_soul11: folds 
EasyGamerrr: folds 
IREQO: folds 
sta$igk: folds 
BGS013: raises $2 to $3
Laiyl@: calls $2
*** FLOP *** [Ks 9s 6s]
BGS013: checks 
Laiyl@: checks 
*** TURN *** [Ks 9s 6s] [Ad]
BGS013: bets $1.48
Laiyl@: calls $1.48
*** RIVER *** [Ks 9s 6s Ad] [9c]
BGS013: checks 
Laiyl@: bets $4.26
BGS013: calls $4.26
*** SHOW DOWN ***
Laiyl@: shows [Ac 5c] (two pair, Aces and Nines)
BGS013: shows [Ah Ts] (two pair, Aces and Nines)
BGS013 collected $8.31 from pot
Laiyl@ collected $8.30 from pot
*** SUMMARY ***
Total pot $17.48 | Rake $0.87 
Board [Ks 9s 6s Ad 9c]
Seat 1: Laiyl@ (big blind) showed [Ac 5c] and won ($8.30) with two pair, Aces and Nines
Seat 2: poker_soul11 folded before Flop (didn't bet)
Seat 3: EasyGamerrr folded before Flop (didn't bet)
Seat 4: IREQO folded before Flop (didn't bet)
Seat 5: sta$igk (button) folded before Flop (didn't bet)
Seat 6: BGS013 (small blind) showed [Ah Ts] and won ($8.31) with two pair, Aces and Nines



PokerStars Hand #254670246970:  Hold'em No Limit ($0.50/$1.00 USD) - 2025/02/02 15:33:51 WET [2025/02/02 10:33:51 ET]
Table 'Auva II' 6-max Seat #6 is the button
Seat 1: Laiyl@ ($44.66 in chips) 
Seat 2: poker_soul11 ($100 in chips) 
Seat 3: EasyGamerrr ($100 in chips) 
Seat 4: IREQO ($104.72 in chips) 
Seat 5: sta$igk ($106.92 in chips) 
Seat 6: BGS013 ($101.96 in chips) 
Laiyl@: posts small blind $0.50
poker_soul11: posts big blind $1
*** HOLE CARDS ***
EasyGamerrr: folds 
IREQO: folds 
sta$igk: raises $1.50 to $2.50
BGS013: folds 
Laiyl@: folds 
poker_soul11: folds 
Uncalled bet ($1.50) returned to sta$igk
sta$igk collected $2.50 from pot
sta$igk: doesn't show hand 
*** SUMMARY ***
Total pot $2.50 | Rake $0 
Seat 1: Laiyl@ (small blind) folded before Flop
Seat 2: poker_soul11 (big blind) folded before Flop
Seat 3: EasyGamerrr folded before Flop (didn't bet)
Seat 4: IREQO folded before Flop (didn't bet)
Seat 5: sta$igk collected ($2.50)
Seat 6: BGS013 (button) folded before Flop (didn't bet)



PokerStars Hand #254670254222:  Hold'em No Limit ($0.50/$1.00 USD) - 2025/02/02 15:34:20 WET [2025/02/02 10:34:20 ET]
Table 'Auva II' 6-max Seat #1 is the button
Seat 1: Laiyl@ ($44.16 in chips) 
Seat 2: poker_soul11 ($100 in chips) 
Seat 3: EasyGamerrr ($100 in chips) 
Seat 4: IREQO ($104.72 in chips) 
Seat 5: sta$igk ($108.42 in chips) 
Seat 6: BGS013 ($101.96 in chips) 
poker_soul11: posts small blind $0.50
EasyGamerrr: posts big blind $1
*** HOLE CARDS ***
IREQO: folds 
sta$igk: folds 
BGS013: folds 
Laiyl@: raises $2 to $3
poker_soul11: folds 
EasyGamerrr: folds 
Uncalled bet ($2) returned to Laiyl@
Laiyl@ collected $2.50 from pot
*** SUMMARY ***
Total pot $2.50 | Rake $0 
Seat 1: Laiyl@ (button) collected ($2.50)
Seat 2: poker_soul11 (small blind) folded before Flop
Seat 3: EasyGamerrr (big blind) folded before Flop
Seat 4: IREQO folded before Flop (didn't bet)
Seat 5: sta$igk folded before Flop (didn't bet)
Seat 6: BGS013 folded before Flop (didn't bet)



PokerStars Hand #254670256890:  Hold'em No Limit ($0.50/$1.00 USD) - 2025/02/02 15:34:30 WET [2025/02/02 10:34:30 ET]
Table 'Auva II' 6-max Seat #2 is the button
Seat 4: IREQO ($104.72 in chips) is sitting out
Seat 1: Laiyl@ ($45.66 in chips) 
Seat 2: poker_soul11 ($100 in chips) 
Seat 3: EasyGamerrr ($100 in chips) 
Seat 5: sta$igk ($108.42 in chips) 
Seat 6: BGS013 ($101.96 in chips) 
EasyGamerrr: posts small blind $0.50
IREQO: is sitting out 
sta$igk: posts big blind $1
*** HOLE CARDS ***
BGS013: raises $1 to $2
Laiyl@: folds 
poker_soul11: folds 
EasyGamerrr: folds 
sta$igk: folds 
Uncalled bet ($1) returned to BGS013
BGS013 collected $2.50 from pot
BGS013: doesn't show hand 
*** SUMMARY ***
Total pot $2.50 | Rake $0 
Seat 4: IREQO
Seat 1: Laiyl@ folded before Flop (didn't bet)
Seat 2: poker_soul11 (button) folded before Flop (didn't bet)
Seat 3: EasyGamerrr (small blind) folded before Flop
Seat 5: sta$igk (big blind) folded before Flop
Seat 6: BGS013 collected ($2.50)



PokerStars Hand #254670259750:  Hold'em No Limit ($0.50/$1.00 USD) - 2025/02/02 15:34:42 WET [2025/02/02 10:34:42 ET]
Table 'Auva II' 6-max Seat #3 is the button
Seat 4: IREQO ($104.72 in chips) is sitting out
Seat 1: Laiyl@ ($45.66 in chips) 
Seat 2: poker_soul11 ($100 in chips) 
Seat 3: EasyGamerrr ($100 in chips) 
Seat 5: sta$igk ($107.42 in chips) 
Seat 6: BGS013 ($103.46 in chips) 
sta$igk: posts small blind $0.50
BGS013: posts big blind $1
*** HOLE CARDS ***
Laiyl@ has timed out
Laiyl@: folds 
poker_soul11: folds 
EasyGamerrr: folds 
sta$igk: raises $2 to $3
BGS013: calls $2
*** FLOP *** [2h Kc Js]
sta$igk: bets $1.88
BGS013: calls $1.88
*** TURN *** [2h Kc Js] [Ah]
sta$igk: checks 
BGS013: checks 
*** RIVER *** [2h Kc Js Ah] [4c]
sta$igk: bets $3.06
BGS013: raises $9.94 to $13
sta$igk: folds 
Uncalled bet ($9.94) returned to BGS013
BGS013 collected $15.09 from pot
BGS013: doesn't show hand 
*** SUMMARY ***
Total pot $15.88 | Rake $0.79 
Board [2h Kc Js Ah 4c]
Seat 4: IREQO
Seat 1: Laiyl@ folded before Flop (didn't bet)
Seat 2: poker_soul11 folded before Flop (didn't bet)
Seat 3: EasyGamerrr (button) folded before Flop (didn't bet)
Seat 5: sta$igk (small blind) folded on the River
Seat 6: BGS013 (big blind) collected ($15.09)



PokerStars Hand #254670279539:  Hold'em No Limit ($0.50/$1.00 USD) - 2025/02/02 15:36:00 WET [2025/02/02 10:36:00 ET]
Table 'Auva II' 6-max Seat #5 is the button
Seat 4: IREQO ($104.72 in chips) is sitting out
Seat 1: Laiyl@ ($45.66 in chips) 
Seat 2: poker_soul11 ($100 in chips) 
Seat 3: EasyGamerrr ($100 in chips) 
Seat 5: sta$igk ($100 in chips) 
Seat 6: BGS013 ($110.61 in chips) 
BGS013: posts small blind $0.50
Laiyl@: posts big blind $1
IREQO: sits out 
*** HOLE CARDS ***
poker_soul11: folds 
EasyGamerrr: folds 
sta$igk: raises $1.50 to $2.50
BGS013: calls $2
Laiyl@: folds 
*** FLOP *** [Jd 3h 4h]
BGS013: checks 
sta$igk: bets $4.28
BGS013: folds 
Uncalled bet ($4.28) returned to sta$igk
sta$igk collected $5.70 from pot
sta$igk: doesn't show hand 
*** SUMMARY ***
Total pot $6 | Rake $0.30 
Board [Jd 3h 4h]
Seat 4: IREQO
Seat 1: Laiyl@ (big blind) folded before Flop
Seat 2: poker_soul11 folded before Flop (didn't bet)
Seat 3: EasyGamerrr folded before Flop (didn't bet)
Seat 5: sta$igk (button) collected ($5.70)
Seat 6: BGS013 (small blind) folded on the Flop



PokerStars Hand #254670290696:  Hold'em No Limit ($0.50/$1.00 USD) - 2025/02/02 15:36:44 WET [2025/02/02 10:36:44 ET]
Table 'Auva II' 6-max Seat #6 is the button
Seat 4: IREQO ($104.72 in chips) is sitting out
Seat 1: Laiyl@ ($44.66 in chips) 
Seat 2: poker_soul11 ($100 in chips) 
Seat 3: EasyGamerrr ($100 in chips) 
Seat 5: sta$igk ($103.20 in chips) 
Seat 6: BGS013 ($108.11 in chips) 
Laiyl@: posts small blind $0.50
poker_soul11: posts big blind $1
IREQO: sits out 
*** HOLE CARDS ***
EasyGamerrr: folds 
sta$igk: folds 
BGS013: raises $1.50 to $2.50
IREQO leaves the table
Laiyl@: calls $2
poker_soul11: calls $1.50
*** FLOP *** [4d 6s Td]
Laiyl@: checks 
poker_soul11: checks 
BGS013: checks 
*** TURN *** [4d 6s Td] [Js]
Laiyl@: bets $3.56
poker_soul11: folds 
BGS013: calls $3.56
*** RIVER *** [4d 6s Td Js] [2c]
Laiyl@: bets $6.95
BGS013: folds 
Uncalled bet ($6.95) returned to Laiyl@
socito joins the table at seat #4 
Laiyl@ collected $13.89 from pot
*** SUMMARY ***
Total pot $14.62 | Rake $0.73 
Board [4d 6s Td Js 2c]
Seat 4: IREQO
Seat 1: Laiyl@ (small blind) collected ($13.89)
Seat 2: poker_soul11 (big blind) folded on the Turn
Seat 3: EasyGamerrr folded before Flop (didn't bet)
Seat 5: sta$igk folded before Flop (didn't bet)
Seat 6: BGS013 (button) folded on the River



PokerStars Hand #254670304412:  Hold'em No Limit ($0.50/$1.00 USD) - 2025/02/02 15:37:38 WET [2025/02/02 10:37:38 ET]
Table 'Auva II' 6-max Seat #1 is the button
Seat 4: socito ($100 in chips) is sitting out
Seat 1: Laiyl@ ($52.49 in chips) 
Seat 2: poker_soul11 ($100 in chips) 
Seat 3: EasyGamerrr ($100 in chips) 
Seat 5: sta$igk ($103.20 in chips) 
Seat 6: BGS013 ($102.05 in chips) 
poker_soul11: posts small blind $0.50
EasyGamerrr: posts big blind $1
socito: sits out 
*** HOLE CARDS ***
sta$igk: folds 
BGS013: folds 
Laiyl@: folds 
poker_soul11: raises $2 to $3
EasyGamerrr: folds 
Uncalled bet ($2) returned to poker_soul11
poker_soul11 collected $2 from pot
poker_soul11: doesn't show hand 
*** SUMMARY ***
Total pot $2 | Rake $0 
Seat 4: socito
Seat 1: Laiyl@ (button) folded before Flop (didn't bet)
Seat 2: poker_soul11 (small blind) collected ($2)
Seat 3: EasyGamerrr (big blind) folded before Flop
Seat 5: sta$igk folded before Flop (didn't bet)
Seat 6: BGS013 folded before Flop (didn't bet)



PokerStars Hand #254670424962:  Hold'em No Limit ($0.50/$1.00 USD) - 2025/02/02 15:45:28 WET [2025/02/02 10:45:28 ET]
Table 'Auva II' 6-max Seat #3 is the button
Seat 1: Laiyl@ ($92.44 in chips) 
Seat 2: poker_soul11 ($101.50 in chips) 
Seat 3: EasyGamerrr ($100 in chips) 
Seat 4: socito ($100.50 in chips) 
Seat 5: sta$igk ($100 in chips) 
Seat 6: BGS013 ($109.25 in chips) 
socito: posts small blind $0.50
sta$igk: posts big blind $1
*** HOLE CARDS ***
BGS013: folds 
Laiyl@: folds 
poker_soul11: folds 
BGS013 leaves the table
EasyGamerrr: folds 
socito: raises $2 to $3
sta$igk: raises $6 to $9
socito: folds 
Uncalled bet ($6) returned to sta$igk
sta$igk collected $6 from pot
sta$igk: doesn't show hand 
*** SUMMARY ***
Total pot $6 | Rake $0 
Seat 1: Laiyl@ folded before Flop (didn't bet)
Seat 2: poker_soul11 folded before Flop (didn't bet)
Seat 3: EasyGamerrr (button) folded before Flop (didn't bet)
Seat 4: socito (small blind) folded before Flop
Seat 5: sta$igk (big blind) collected ($6)
Seat 6: BGS013 folded before Flop (didn't bet)



PokerStars Hand #254670431672:  Hold'em No Limit ($0.50/$1.00 USD) - 2025/02/02 15:45:54 WET [2025/02/02 10:45:54 ET]
Table 'Auva II' 6-max Seat #4 is the button
Seat 1: Laiyl@ ($92.44 in chips) 
Seat 2: poker_soul11 ($101.50 in chips) 
Seat 3: EasyGamerrr ($100 in chips) 
Seat 4: socito ($100 in chips) 
Seat 5: sta$igk ($103 in chips) 
sta$igk: posts small blind $0.50
Laiyl@: posts big blind $1
*** HOLE CARDS ***
yzuk joins the table at seat #6 
poker_soul11: folds 
EasyGamerrr: folds 
socito: folds 
sta$igk: raises $2 to $3
Laiyl@: calls $2
*** FLOP *** [9s Jd 5c]
sta$igk: bets $1.88
Laiyl@: calls $1.88
*** TURN *** [9s Jd 5c] [7h]
sta$igk: bets $6.21
Laiyl@: calls $6.21
*** RIVER *** [9s Jd 5c 7h] [Qh]
sta$igk: bets $14.12
Laiyl@: folds 
Uncalled bet ($14.12) returned to sta$igk
sta$igk collected $21.07 from pot
sta$igk: doesn't show hand 
*** SUMMARY ***
Total pot $22.18 | Rake $1.11 
Board [9s Jd 5c 7h Qh]
Seat 1: Laiyl@ (big blind) folded on the River
Seat 2: poker_soul11 folded before Flop (didn't bet)
Seat 3: EasyGamerrr folded before Flop (didn't bet)
Seat 4: socito (button) folded before Flop (didn't bet)
Seat 5: sta$igk (small blind) collected ($21.07)



PokerStars Hand #254670445023:  Hold'em No Limit ($0.50/$1.00 USD) - 2025/02/02 15:46:46 WET [2025/02/02 10:46:46 ET]
Table 'Auva II' 6-max Seat #5 is the button
Seat 6: yzuk ($100 in chips) is sitting out
Seat 1: Laiyl@ ($81.35 in chips) 
Seat 2: poker_soul11 ($101.50 in chips) 
Seat 3: EasyGamerrr ($100 in chips) 
Seat 4: socito ($100 in chips) 
Seat 5: sta$igk ($112.98 in chips) 
Laiyl@: posts small blind $0.50
poker_soul11: posts big blind $1
*** HOLE CARDS ***
EasyGamerrr: folds 
socito: folds 
sta$igk: folds 
Laiyl@: calls $0.50
poker_soul11: checks 
*** FLOP *** [Qd 3c 2d]
Laiyl@: bets $1
poker_soul11: folds 
Uncalled bet ($1) returned to Laiyl@
Laiyl@ collected $1.90 from pot
*** SUMMARY ***
Total pot $2 | Rake $0.10 
Board [Qd 3c 2d]
Seat 6: yzuk
Seat 1: Laiyl@ (small blind) collected ($1.90)
Seat 2: poker_soul11 (big blind) folded on the Flop
Seat 3: EasyGamerrr folded before Flop (didn't bet)
Seat 4: socito folded before Flop (didn't bet)
Seat 5: sta$igk (button) folded before Flop (didn't bet)



PokerStars Hand #254670454419:  Hold'em No Limit ($0.50/$1.00 USD) - 2025/02/02 15:47:22 WET [2025/02/02 10:47:22 ET]
Table 'Auva II' 6-max Seat #1 is the button
Seat 6: yzuk ($100 in chips) is sitting out
Seat 1: Laiyl@ ($82.25 in chips) 
Seat 2: poker_soul11 ($100.50 in chips) 
Seat 3: EasyGamerrr ($100 in chips) 
Seat 4: socito ($100 in chips) 
Seat 5: sta$igk ($112.98 in chips) 
poker_soul11: posts small blind $0.50
EasyGamerrr: posts big blind $1
yzuk: sits out 
*** HOLE CARDS ***
socito: folds 
sta$igk: folds 
Laiyl@: calls $1
poker_soul11: folds 
EasyGamerrr: checks 
*** FLOP *** [6d 5d Kc]
EasyGamerrr: checks 
Laiyl@: checks 
*** TURN *** [6d 5d Kc] [Kh]
EasyGamerrr: checks 
Laiyl@: checks 
*** RIVER *** [6d 5d Kc Kh] [As]
EasyGamerrr: checks 
Laiyl@: bets $1.19
EasyGamerrr: folds 
Uncalled bet ($1.19) returned to Laiyl@
Laiyl@ collected $2.38 from pot
*** SUMMARY ***
Total pot $2.50 | Rake $0.12 
Board [6d 5d Kc Kh As]
Seat 6: yzuk
Seat 1: Laiyl@ (button) collected ($2.38)
Seat 2: poker_soul11 (small blind) folded before Flop
Seat 3: EasyGamerrr (big blind) folded on the River
Seat 4: socito folded before Flop (didn't bet)
Seat 5: sta$igk folded before Flop (didn't bet)



PokerStars Hand #254670464810:  Hold'em No Limit ($0.50/$1.00 USD) - 2025/02/02 15:48:02 WET [2025/02/02 10:48:02 ET]
Table 'Auva II' 6-max Seat #2 is the button
Seat 6: yzuk ($100 in chips) is sitting out
Seat 1: Laiyl@ ($83.63 in chips) 
Seat 2: poker_soul11 ($100 in chips) 
Seat 3: EasyGamerrr ($100 in chips) 
Seat 4: socito ($100 in chips) 
Seat 5: sta$igk ($112.98 in chips) 
EasyGamerrr: posts small blind $0.50
socito: posts big blind $1
yzuk: sits out 
*** HOLE CARDS ***
sta$igk: folds 
Laiyl@: calls $1
poker_soul11: folds 
EasyGamerrr: raises $3.50 to $4.50
socito: folds 
Laiyl@: calls $3.50
*** FLOP *** [6h 2c Th]
EasyGamerrr: bets $6.37
Laiyl@: folds 
Uncalled bet ($6.37) returned to EasyGamerrr
EasyGamerrr collected $9.50 from pot
EasyGamerrr: doesn't show hand 
*** SUMMARY ***
Total pot $10 | Rake $0.50 
Board [6h 2c Th]
Seat 6: yzuk
Seat 1: Laiyl@ folded on the Flop
Seat 2: poker_soul11 (button) folded before Flop (didn't bet)
Seat 3: EasyGamerrr (small blind) collected ($9.50)
Seat 4: socito (big blind) folded before Flop
Seat 5: sta$igk folded before Flop (didn't bet)



PokerStars Hand #254670472387:  Hold'em No Limit ($0.50/$1.00 USD) - 2025/02/02 15:48:31 WET [2025/02/02 10:48:31 ET]
Table 'Auva II' 6-max Seat #3 is the button
Seat 6: yzuk ($100 in chips) is sitting out
Seat 1: Laiyl@ ($79.13 in chips) 
Seat 2: poker_soul11 ($100 in chips) 
Seat 3: EasyGamerrr ($105 in chips) 
Seat 4: socito ($100 in chips) 
Seat 5: sta$igk ($112.98 in chips) 
socito: posts small blind $0.50
sta$igk: posts big blind $1
yzuk: sits out 
*** HOLE CARDS ***
Laiyl@: calls $1
poker_soul11: raises $2.50 to $3.50
EasyGamerrr: raises $7 to $10.50
socito: folds 
sta$igk: folds 
Laiyl@: calls $9.50
poker_soul11: calls $7
*** FLOP *** [5s Kh 6h]
Laiyl@: checks 
poker_soul11: checks 
EasyGamerrr: bets $10.35
Laiyl@: calls $10.35
poker_soul11: raises $14.65 to $25
EasyGamerrr: folds 
Laiyl@: calls $14.65
*** TURN *** [5s Kh 6h] [6d]
Laiyl@: checks 
poker_soul11: bets $64.50 and is all-in
Laiyl@: folds [Kd]
Uncalled bet ($64.50) returned to poker_soul11
poker_soul11 collected $90.85 from pot
poker_soul11: doesn't show hand 
*** SUMMARY ***
Total pot $93.35 | Rake $2.50 
Board [5s Kh 6h 6d]
Seat 6: yzuk
Seat 1: Laiyl@ folded on the Turn
Seat 2: poker_soul11 collected ($90.85)
Seat 3: EasyGamerrr (button) folded on the Flop
Seat 4: socito (small blind) folded before Flop
Seat 5: sta$igk (big blind) folded before Flop



PokerStars Hand #254670492578:  Hold'em No Limit ($0.50/$1.00 USD) - 2025/02/02 15:49:49 WET [2025/02/02 10:49:49 ET]
Table 'Auva II' 6-max Seat #4 is the button
Seat 1: Laiyl@ ($43.63 in chips) 
Seat 2: poker_soul11 ($155.35 in chips) 
Seat 3: EasyGamerrr ($100 in chips) 
Seat 4: socito ($100 in chips) 
Seat 5: sta$igk ($111.98 in chips) 
Seat 6: yzuk ($100 in chips) 
sta$igk: posts small blind $0.50
yzuk: posts big blind $1
*** HOLE CARDS ***
Laiyl@: folds 
poker_soul11: folds 
EasyGamerrr: folds 
socito: raises $1.50 to $2.50
sta$igk: folds 
yzuk: raises $10 to $12.50
socito: calls $10
*** FLOP *** [8h 2c Kc]
yzuk: checks 
socito: checks 
*** TURN *** [8h 2c Kc] [2s]
yzuk: bets $18.65
socito: folds 
Uncalled bet ($18.65) returned to yzuk
yzuk collected $24.22 from pot
yzuk: doesn't show hand 
*** SUMMARY ***
Total pot $25.50 | Rake $1.28 
Board [8h 2c Kc 2s]
Seat 1: Laiyl@ folded before Flop (didn't bet)
Seat 2: poker_soul11 folded before Flop (didn't bet)
Seat 3: EasyGamerrr folded before Flop (didn't bet)
Seat 4: socito (button) folded on the Turn
Seat 5: sta$igk (small blind) folded before Flop
Seat 6: yzuk (big blind) collected ($24.22)



PokerStars Hand #254670516938:  Hold'em No Limit ($0.50/$1.00 USD) - 2025/02/02 15:51:22 WET [2025/02/02 10:51:22 ET]
Table 'Auva II' 6-max Seat #5 is the button
Seat 1: Laiyl@ ($43.63 in chips) 
Seat 2: poker_soul11 ($155.35 in chips) 
Seat 3: EasyGamerrr ($100 in chips) 
Seat 4: socito ($100 in chips) 
Seat 5: sta$igk ($111.48 in chips) 
Seat 6: yzuk ($111.72 in chips) 
yzuk: posts small blind $0.50
Laiyl@: posts big blind $1
*** HOLE CARDS ***
poker_soul11: raises $1.20 to $2.20
EasyGamerrr: folds 
socito: folds 
sta$igk: folds 
yzuk: folds 
Laiyl@: calls $1.20
*** FLOP *** [8c 4d Ts]
Laiyl@: checks 
poker_soul11: checks 
*** TURN *** [8c 4d Ts] [5d]
Laiyl@: checks 
poker_soul11: checks 
*** RIVER *** [8c 4d Ts 5d] [3h]
Laiyl@: checks 
poker_soul11: checks 
*** SHOW DOWN ***
Laiyl@: shows [2h Kh] (high card King)
poker_soul11: shows [Ac Js] (high card Ace)
poker_soul11 collected $4.66 from pot
*** SUMMARY ***
Total pot $4.90 | Rake $0.24 
Board [8c 4d Ts 5d 3h]
Seat 1: Laiyl@ (big blind) showed [2h Kh] and lost with high card King
Seat 2: poker_soul11 showed [Ac Js] and won ($4.66) with high card Ace
Seat 3: EasyGamerrr folded before Flop (didn't bet)
Seat 4: socito folded before Flop (didn't bet)
Seat 5: sta$igk (button) folded before Flop (didn't bet)
Seat 6: yzuk (small blind) folded before Flop



PokerStars Hand #254670529679:  Hold'em No Limit ($0.50/$1.00 USD) - 2025/02/02 15:52:11 WET [2025/02/02 10:52:11 ET]
Table 'Auva II' 6-max Seat #6 is the button
Seat 1: Laiyl@ ($41.43 in chips) 
Seat 2: poker_soul11 ($157.81 in chips) 
Seat 3: EasyGamerrr ($100 in chips) 
Seat 4: socito ($100 in chips) 
Seat 5: sta$igk ($111.48 in chips) 
Seat 6: yzuk ($111.22 in chips) 
Laiyl@: posts small blind $0.50
poker_soul11: posts big blind $1
*** HOLE CARDS ***
EasyGamerrr: folds 
socito: raises $1.50 to $2.50
sta$igk: folds 
yzuk: folds 
Laiyl@: folds 
poker_soul11: raises $9.50 to $12
socito: raises $12 to $24
poker_soul11: folds 
Uncalled bet ($12) returned to socito
socito collected $24.50 from pot
socito: doesn't show hand 
*** SUMMARY ***
Total pot $24.50 | Rake $0 
Seat 1: Laiyl@ (small blind) folded before Flop
Seat 2: poker_soul11 (big blind) folded before Flop
Seat 3: EasyGamerrr folded before Flop (didn't bet)
Seat 4: socito collected ($24.50)
Seat 5: sta$igk folded before Flop (didn't bet)
Seat 6: yzuk (button) folded before Flop (didn't bet)



PokerStars Hand #254670545830:  Hold'em No Limit ($0.50/$1.00 USD) - 2025/02/02 15:53:14 WET [2025/02/02 10:53:14 ET]
Table 'Auva II' 6-max Seat #1 is the button
Seat 1: Laiyl@ ($40.93 in chips) 
Seat 2: poker_soul11 ($145.81 in chips) 
Seat 3: EasyGamerrr ($100 in chips) 
Seat 4: socito ($112.50 in chips) 
Seat 5: sta$igk ($111.48 in chips) 
Seat 6: yzuk ($111.22 in chips) 
poker_soul11: posts small blind $0.50
EasyGamerrr: posts big blind $1
*** HOLE CARDS ***
socito: folds 
sta$igk: folds 
yzuk: folds 
Laiyl@: calls $1
poker_soul11: folds 
EasyGamerrr: checks 
*** FLOP *** [5s 2c Kc]
EasyGamerrr: checks 
Laiyl@: checks 
*** TURN *** [5s 2c Kc] [8s]
EasyGamerrr: checks 
Laiyl@: bets $2
EasyGamerrr: folds 
Uncalled bet ($2) returned to Laiyl@
Laiyl@ collected $2.38 from pot
*** SUMMARY ***
Total pot $2.50 | Rake $0.12 
Board [5s 2c Kc 8s]
Seat 1: Laiyl@ (button) collected ($2.38)
Seat 2: poker_soul11 (small blind) folded before Flop
Seat 3: EasyGamerrr (big blind) folded on the Turn
Seat 4: socito folded before Flop (didn't bet)
Seat 5: sta$igk folded before Flop (didn't bet)
Seat 6: yzuk folded before Flop (didn't bet)



PokerStars Hand #254670553152:  Hold'em No Limit ($0.50/$1.00 USD) - 2025/02/02 15:53:42 WET [2025/02/02 10:53:42 ET]
Table 'Auva II' 6-max Seat #2 is the button
Seat 1: Laiyl@ ($42.31 in chips) 
Seat 2: poker_soul11 ($145.31 in chips) 
Seat 3: EasyGamerrr ($100 in chips) 
Seat 4: socito ($112.50 in chips) 
Seat 5: sta$igk ($111.48 in chips) 
Seat 6: yzuk ($111.22 in chips) 
EasyGamerrr: posts small blind $0.50
socito: posts big blind $1
*** HOLE CARDS ***
sta$igk: raises $1.50 to $2.50
yzuk: folds 
Laiyl@: folds 
poker_soul11: folds 
EasyGamerrr: folds 
socito: folds 
Uncalled bet ($1.50) returned to sta$igk
sta$igk collected $2.50 from pot
sta$igk: doesn't show hand 
*** SUMMARY ***
Total pot $2.50 | Rake $0 
Seat 1: Laiyl@ folded before Flop (didn't bet)
Seat 2: poker_soul11 (button) folded before Flop (didn't bet)
Seat 3: EasyGamerrr (small blind) folded before Flop
Seat 4: socito (big blind) folded before Flop
Seat 5: sta$igk collected ($2.50)
Seat 6: yzuk folded before Flop (didn't bet)



PokerStars Hand #254670557800:  Hold'em No Limit ($0.50/$1.00 USD) - 2025/02/02 15:54:00 WET [2025/02/02 10:54:00 ET]
Table 'Auva II' 6-max Seat #3 is the button
Seat 1: Laiyl@ ($42.31 in chips) 
Seat 2: poker_soul11 ($145.31 in chips) 
Seat 3: EasyGamerrr ($100 in chips) 
Seat 4: socito ($111.50 in chips) 
Seat 5: sta$igk ($112.98 in chips) 
Seat 6: yzuk ($111.22 in chips) 
socito: posts small blind $0.50
sta$igk: posts big blind $1
*** HOLE CARDS ***
yzuk: folds 
Laiyl@: calls $1
poker_soul11: raises $1.50 to $2.50
EasyGamerrr: folds 
socito: folds 
sta$igk: folds 
Laiyl@: calls $1.50
*** FLOP *** [4c 5c Qs]
Laiyl@: checks 
poker_soul11: bets $2.04
Laiyl@: calls $2.04
*** TURN *** [4c 5c Qs] [Qh]
Laiyl@: checks 
poker_soul11: bets $3.32
Laiyl@: folds 
Uncalled bet ($3.32) returned to poker_soul11
poker_soul11 collected $10.05 from pot
poker_soul11: doesn't show hand 
*** SUMMARY ***
Total pot $10.58 | Rake $0.53 
Board [4c 5c Qs Qh]
Seat 1: Laiyl@ folded on the Turn
Seat 2: poker_soul11 collected ($10.05)
Seat 3: EasyGamerrr (button) folded before Flop (didn't bet)
Seat 4: socito (small blind) folded before Flop
Seat 5: sta$igk (big blind) folded before Flop
Seat 6: yzuk folded before Flop (didn't bet)



PokerStars Hand #254670566314:  Hold'em No Limit ($0.50/$1.00 USD) - 2025/02/02 15:54:33 WET [2025/02/02 10:54:33 ET]
Table 'Auva II' 6-max Seat #4 is the button
Seat 1: Laiyl@ ($37.77 in chips) 
Seat 2: poker_soul11 ($150.82 in chips) 
Seat 3: EasyGamerrr ($100 in chips) 
Seat 4: socito ($111 in chips) 
Seat 5: sta$igk ($111.98 in chips) 
Seat 6: yzuk ($111.22 in chips) 
sta$igk: posts small blind $0.50
yzuk: posts big blind $1
*** HOLE CARDS ***
Laiyl@: folds 
poker_soul11: folds 
EasyGamerrr: folds 
socito: folds 
sta$igk: raises $2 to $3
yzuk: calls $2
*** FLOP *** [Qs Js 5d]
sta$igk: checks 
yzuk: checks 
*** TURN *** [Qs Js 5d] [4c]
sta$igk: bets $8.55
yzuk: calls $8.55
*** RIVER *** [Qs Js 5d 4c] [7d]
sta$igk: checks 
yzuk: checks 
*** SHOW DOWN ***
sta$igk: shows [2d 2s] (a pair of Deuces)
yzuk: shows [As 5c] (a pair of Fives)
yzuk collected $21.94 from pot
*** SUMMARY ***
Total pot $23.10 | Rake $1.16 
Board [Qs Js 5d 4c 7d]
Seat 1: Laiyl@ folded before Flop (didn't bet)
Seat 2: poker_soul11 folded before Flop (didn't bet)
Seat 3: EasyGamerrr folded before Flop (didn't bet)
Seat 4: socito (button) folded before Flop (didn't bet)
Seat 5: sta$igk (small blind) showed [2d 2s] and lost with a pair of Deuces
Seat 6: yzuk (big blind) showed [As 5c] and won ($21.94) with a pair of Fives



PokerStars Hand #254670582130:  Hold'em No Limit ($0.50/$1.00 USD) - 2025/02/02 15:55:46 WET [2025/02/02 10:55:46 ET]
Table 'Auva II' 6-max Seat #5 is the button
Seat 1: Laiyl@ ($37.77 in chips) 
Seat 2: poker_soul11 ($150.82 in chips) 
Seat 3: EasyGamerrr ($100 in chips) 
Seat 4: socito ($111 in chips) 
Seat 5: sta$igk ($100.43 in chips) 
Seat 6: yzuk ($121.61 in chips) 
yzuk: posts small blind $0.50
Laiyl@: posts big blind $1
*** HOLE CARDS ***
poker_soul11: folds 
EasyGamerrr: folds 
socito: raises $1.50 to $2.50
sta$igk: folds 
yzuk: folds 
Laiyl@: calls $1.50
*** FLOP *** [3s Qs Qh]
Laiyl@: checks 
socito: bets $1.31
Laiyl@: calls $1.31
*** TURN *** [3s Qs Qh] [Jc]
Laiyl@: checks 
socito: checks 
*** RIVER *** [3s Qs Qh Jc] [4c]
Laiyl@: bets $3.86
socito: raises $6.74 to $10.60
Laiyl@: calls $6.74
*** SHOW DOWN ***
socito: shows [Jh Ah] (two pair, Queens and Jacks)
Laiyl@: mucks hand 
socito collected $27.85 from pot
*** SUMMARY ***
Total pot $29.32 | Rake $1.47 
Board [3s Qs Qh Jc 4c]
Seat 1: Laiyl@ (big blind) mucked
Seat 2: poker_soul11 folded before Flop (didn't bet)
Seat 3: EasyGamerrr folded before Flop (didn't bet)
Seat 4: socito showed [Jh Ah] and won ($27.85) with two pair, Queens and Jacks
Seat 5: sta$igk (button) folded before Flop (didn't bet)
Seat 6: yzuk (small blind) folded before Flop



PokerStars Hand #254670590101:  Hold'em No Limit ($0.50/$1.00 USD) - 2025/02/02 15:56:31 WET [2025/02/02 10:56:31 ET]
Table 'Auva II' 6-max Seat #6 is the button
Seat 1: Laiyl@ ($23.36 in chips) 
Seat 2: poker_soul11 ($150.82 in chips) 
Seat 3: EasyGamerrr ($100 in chips) 
Seat 4: socito ($124.44 in chips) 
Seat 5: sta$igk ($100.43 in chips) 
Seat 6: yzuk ($121.11 in chips) 
Laiyl@: posts small blind $0.50
poker_soul11: posts big blind $1
*** HOLE CARDS ***
EasyGamerrr: raises $1.50 to $2.50
socito: folds 
sta$igk: folds 
yzuk: folds 
Laiyl@: calls $2
poker_soul11: folds 
*** FLOP *** [Ah 9d 2c]
Laiyl@: checks 
EasyGamerrr: bets $1.88
Laiyl@: calls $1.88
*** TURN *** [Ah 9d 2c] [Kc]
Laiyl@: checks 
EasyGamerrr: checks 
*** RIVER *** [Ah 9d 2c Kc] [9s]
Laiyl@: bets $4.64
EasyGamerrr: calls $4.64
*** SHOW DOWN ***
Laiyl@: shows [4h 4d] (two pair, Nines and Fours)
EasyGamerrr: shows [Th Ad] (two pair, Aces and Nines)
EasyGamerrr collected $18.09 from pot
*** SUMMARY ***
Total pot $19.04 | Rake $0.95 
Board [Ah 9d 2c Kc 9s]
Seat 1: Laiyl@ (small blind) showed [4h 4d] and lost with two pair, Nines and Fours
Seat 2: poker_soul11 (big blind) folded before Flop
Seat 3: EasyGamerrr showed [Th Ad] and won ($18.09) with two pair, Aces and Nines
Seat 4: socito folded before Flop (didn't bet)
Seat 5: sta$igk folded before Flop (didn't bet)
Seat 6: yzuk (button) folded before Flop (didn't bet)



PokerStars Hand #254670597778:  Hold'em No Limit ($0.50/$1.00 USD) - 2025/02/02 15:57:15 WET [2025/02/02 10:57:15 ET]
Table 'Auva II' 6-max Seat #1 is the button
Seat 1: Laiyl@ ($14.34 in chips) 
Seat 2: poker_soul11 ($149.82 in chips) 
Seat 3: EasyGamerrr ($109.07 in chips) 
Seat 4: socito ($124.44 in chips) 
Seat 5: sta$igk ($100.43 in chips) 
Seat 6: yzuk ($121.11 in chips) 
poker_soul11: posts small blind $0.50
EasyGamerrr: posts big blind $1
*** HOLE CARDS ***
socito: folds 
sta$igk: raises $1 to $2
yzuk: folds 
Laiyl@: folds 
poker_soul11: raises $9 to $11
EasyGamerrr: folds 
sta$igk: calls $9
*** FLOP *** [8c 2c Js]
Laiyl@ leaves the table
poker_soul11: bets $10.93
sta$igk: calls $10.93
*** TURN *** [8c 2c Js] [7d]
poker_soul11: checks 
sta$igk: checks 
*** RIVER *** [8c 2c Js 7d] [3h]
poker_soul11: bets $14.06
hag111 joins the table at seat #1 
hag111 is disconnected 
sta$igk: folds 
Uncalled bet ($14.06) returned to poker_soul11
EasyGamerrr leaves the table
poker_soul11 collected $42.62 from pot
poker_soul11: doesn't show hand 
*** SUMMARY ***
Total pot $44.86 | Rake $2.24 
Board [8c 2c Js 7d 3h]
Seat 1: Laiyl@ (button) folded before Flop (didn't bet)
Seat 2: poker_soul11 (small blind) collected ($42.62)
Seat 3: EasyGamerrr (big blind) folded before Flop
Seat 4: socito folded before Flop (didn't bet)
Seat 5: sta$igk folded on the River
Seat 6: yzuk folded before Flop (didn't bet)



PokerStars Hand #254670616830:  Hold'em No Limit ($0.50/$1.00 USD) - 2025/02/02 15:59:04 WET [2025/02/02 10:59:04 ET]
Table 'Auva II' 6-max Seat #2 is the button
Seat 5: sta$igk ($100 in chips) is sitting out
Seat 1: hag111 ($100 in chips) 
Seat 2: poker_soul11 ($170.51 in chips) 
Seat 4: socito ($124.44 in chips) 
Seat 6: yzuk ($121.11 in chips) 
socito: posts small blind $0.50
sta$igk: is sitting out 
yzuk: posts big blind $1
hag111: posts big blind $1
*** HOLE CARDS ***
hag111: checks 
poker_soul11: folds 
sta$igk leaves the table
socito: calls $0.50
yzuk: checks 
*** FLOP *** [Th Ks 7c]
socito: checks 
yzuk: checks 
hag111: checks 
*** TURN *** [Th Ks 7c] [Kc]
socito: checks 
yzuk: checks 
hag111: checks 
*** RIVER *** [Th Ks 7c Kc] [2c]
socito: checks 
yzuk: checks 
hag111: checks 
*** SHOW DOWN ***
socito: shows [9s 7h] (two pair, Kings and Sevens)
yzuk: mucks hand 
hag111: mucks hand 
socito collected $2.85 from pot
*** SUMMARY ***
Total pot $3 | Rake $0.15 
Board [Th Ks 7c Kc 2c]
Seat 5: sta$igk
Seat 1: hag111 mucked
Seat 2: poker_soul11 (button) folded before Flop (didn't bet)
Seat 4: socito (small blind) showed [9s 7h] and won ($2.85) with two pair, Kings and Sevens
Seat 6: yzuk (big blind) mucked



PokerStars Hand #254670628275:  Hold'em No Limit ($0.50/$1.00 USD) - 2025/02/02 16:00:02 WET [2025/02/02 11:00:02 ET]
Table 'Auva II' 6-max Seat #4 is the button
Seat 1: hag111 ($100 in chips) 
Seat 2: poker_soul11 ($170.51 in chips) 
Seat 4: socito ($126.29 in chips) 
Seat 6: yzuk ($120.11 in chips) 
yzuk: posts small blind $0.50
hag111: posts big blind $1
*** HOLE CARDS ***
poker_soul11: folds 
socito: folds 
yzuk: folds 
Uncalled bet ($0.50) returned to hag111
hag111 collected $1 from pot
hag111: doesn't show hand 
*** SUMMARY ***
Total pot $1 | Rake $0 
Seat 1: hag111 (big blind) collected ($1)
Seat 2: poker_soul11 folded before Flop (didn't bet)
Seat 4: socito (button) folded before Flop (didn't bet)
Seat 6: yzuk (small blind) folded before Flop



PokerStars Hand #254670630303:  Hold'em No Limit ($0.50/$1.00 USD) - 2025/02/02 16:00:13 WET [2025/02/02 11:00:13 ET]
Table 'Auva II' 6-max Seat #6 is the button
Seat 2: poker_soul11 ($170.51 in chips) is sitting out
Seat 1: hag111 ($100.50 in chips) 
Seat 4: socito ($126.29 in chips) 
Seat 6: yzuk ($119.61 in chips) 
hag111: posts small blind $0.50
poker_soul11: is sitting out 
socito: posts big blind $1
*** HOLE CARDS ***
yzuk: folds 
yzuk leaves the table
poker_soul11 leaves the table
hag111: folds 
Uncalled bet ($0.50) returned to socito
socito collected $1 from pot
socito: doesn't show hand 
*** SUMMARY ***
Total pot $1 | Rake $0 
Seat 2: poker_soul11
Seat 1: hag111 (small blind) folded before Flop
Seat 4: socito (big blind) collected ($1)
Seat 6: yzuk (button) folded before Flop (didn't bet)



PokerStars Hand #254670632167:  Hold'em No Limit ($0.50/$1.00 USD) - 2025/02/02 16:00:24 WET [2025/02/02 11:00:24 ET]
Table 'Auva II' 6-max Seat #4 is the button
Seat 1: hag111 ($100 in chips) 
Seat 4: socito ($126.79 in chips) 
socito: posts small blind $0.50
hag111: posts big blind $1
*** HOLE CARDS ***
socito: folds 
Uncalled bet ($0.50) returned to hag111
hag111 collected $1 from pot
hag111: doesn't show hand 
socito leaves the table
*** SUMMARY ***
Total pot $1 | Rake $0 
Seat 1: hag111 (big blind) collected ($1)
Seat 4: socito (button) (small blind) folded before Flop



