PokerStars Hand #254319822879:  Hold'em No Limit ($0.50/$1.00 USD) - 2025/01/11 21:00:03 WET [2025/01/11 16:00:03 ET]
Table 'Sigune III' 6-max Seat #4 is the button
Seat 1: tukeiron ($100 in chips) is sitting out
Seat 3: kars0n ($100 in chips) 
Seat 4: Unipoker11 ($100 in chips) 
Unipoker11: posts small blind $0.50
kars0n: posts big blind $1
*** HOLE CARDS ***
Unipoker11: raises $1.50 to $2.50
kars0n: calls $1.50
*** FLOP *** [Tc Kd 6s]
tukeiron leaves the table
kars0n: checks 
Unipoker11: bets $1.19
kars0n: calls $1.19
*** TURN *** [Tc Kd 6s] [As]
kars0n: checks 
Unipoker11: bets $7.01
kars0n: calls $7.01
*** RIVER *** [Tc Kd 6s As] [Qs]
kars0n: checks 
Unipoker11: bets $20.40
kars0n: folds 
Uncalled bet ($20.40) returned to Unipoker11
Unipoker11 collected $20.40 from pot
Unipoker11: doesn't show hand 
*** SUMMARY ***
Total pot $21.40 | Rake $1 
Board [Tc Kd 6s As Qs]
Seat 1: tukeiron
Seat 3: kars0n (big blind) folded on the River
Seat 4: Unipoker11 (button) (small blind) collected ($20.40)



PokerStars Hand #254319892778:  Hold'em No Limit ($0.50/$1.00 USD) - 2025/01/11 21:03:55 WET [2025/01/11 16:03:55 ET]
Table 'Sigune III' 6-max Seat #6 is the button
Seat 1: Unipoker11 ($109.70 in chips) 
Seat 2: Zvst ($100 in chips) 
Seat 3: kars0n ($100 in chips) 
Seat 6: Manifestorr ($100 in chips) 
Unipoker11: posts small blind $0.50
Zvst: posts big blind $1
*** HOLE CARDS ***
kars0n: folds 
Manifestorr: raises $1.20 to $2.20
Unipoker11: raises $8.80 to $11
Zvst: folds 
Manifestorr: folds 
Uncalled bet ($8.80) returned to Unipoker11
Unipoker11 collected $5.40 from pot
Unipoker11: doesn't show hand 
*** SUMMARY ***
Total pot $5.40 | Rake $0 
Seat 1: Unipoker11 (small blind) collected ($5.40)
Seat 2: Zvst (big blind) folded before Flop
Seat 3: kars0n folded before Flop (didn't bet)
Seat 6: Manifestorr (button) folded before Flop



PokerStars Hand #254319898367:  Hold'em No Limit ($0.50/$1.00 USD) - 2025/01/11 21:04:12 WET [2025/01/11 16:04:12 ET]
Table 'Sigune III' 6-max Seat #1 is the button
Seat 1: Unipoker11 ($112.90 in chips) 
Seat 2: Zvst ($100 in chips) 
Seat 3: kars0n ($100 in chips) 
Seat 6: Manifestorr ($100 in chips) 
Zvst: posts small blind $0.50
kars0n: posts big blind $1
*** HOLE CARDS ***
Manifestorr: folds 
Unipoker11: folds 
Zvst: folds 
Uncalled bet ($0.50) returned to kars0n
kars0n collected $1 from pot
kars0n: doesn't show hand 
*** SUMMARY ***
Total pot $1 | Rake $0 
Seat 1: Unipoker11 (button) folded before Flop (didn't bet)
Seat 2: Zvst (small blind) folded before Flop
Seat 3: kars0n (big blind) collected ($1)
Seat 6: Manifestorr folded before Flop (didn't bet)



PokerStars Hand #254319901624:  Hold'em No Limit ($0.50/$1.00 USD) - 2025/01/11 21:04:22 WET [2025/01/11 16:04:22 ET]
Table 'Sigune III' 6-max Seat #2 is the button
Seat 1: Unipoker11 ($112.90 in chips) 
Seat 2: Zvst ($100 in chips) 
Seat 3: kars0n ($100.50 in chips) 
Seat 6: Manifestorr ($100 in chips) 
kars0n: posts small blind $0.50
Manifestorr: posts big blind $1
*** HOLE CARDS ***
Unipoker11: folds 
Zvst: raises $1.50 to $2.50
Unipoker11 leaves the table
kars0n: folds 
AIien Hand joins the table at seat #5 
Manifestorr: calls $1.50
*** FLOP *** [Jc 4d Ad]
Manifestorr: checks 
Paddyjoe24 joins the table at seat #4 
kars0n leaves the table
Paddyjoe24 is disconnected 
Zvst: bets $5.78
Manifestorr: folds 
Uncalled bet ($5.78) returned to Zvst
Zvst collected $5.22 from pot
Zvst: doesn't show hand 
*** SUMMARY ***
Total pot $5.50 | Rake $0.28 
Board [Jc 4d Ad]
Seat 1: Unipoker11 folded before Flop (didn't bet)
Seat 2: Zvst (button) collected ($5.22)
Seat 3: kars0n (small blind) folded before Flop
Seat 6: Manifestorr (big blind) folded on the Flop



PokerStars Hand #254319915329:  Hold'em No Limit ($0.50/$1.00 USD) - 2025/01/11 21:05:02 WET [2025/01/11 16:05:02 ET]
Table 'Sigune III' 6-max Seat #6 is the button
Seat 5: AIien Hand ($100 in chips) is sitting out
Seat 2: Zvst ($102.72 in chips) 
Seat 4: Paddyjoe24 ($99.56 in chips) 
Seat 6: Manifestorr ($100 in chips) 
worker0k joins the table at seat #1 
Zvst: posts small blind $0.50
Paddyjoe24: posts big blind $1
AIien Hand: sits out 
*** HOLE CARDS ***
Manifestorr: folds 
Zvst: raises $2 to $3
Paddyjoe24: calls $2
*** FLOP *** [7h 4d Kd]
Zvst: checks 
Paddyjoe24: checks 
*** TURN *** [7h 4d Kd] [Jh]
Zvst: bets $10.80
Paddyjoe24: calls $10.80
*** RIVER *** [7h 4d Kd Jh] [3h]
Zvst: bets $32.73
Paddyjoe24: calls $32.73
*** SHOW DOWN ***
Zvst: shows [Ah Td] (high card Ace)
Paddyjoe24: shows [Ks 7s] (two pair, Kings and Sevens)
Paddyjoe24 collected $92.06 from pot
*** SUMMARY ***
Total pot $93.06 | Rake $1 
Board [7h 4d Kd Jh 3h]
Seat 5: AIien Hand
Seat 2: Zvst (small blind) showed [Ah Td] and lost with high card Ace
Seat 4: Paddyjoe24 (big blind) showed [Ks 7s] and won ($92.06) with two pair, Kings and Sevens
Seat 6: Manifestorr (button) folded before Flop (didn't bet)



PokerStars Hand #254319930419:  Hold'em No Limit ($0.50/$1.00 USD) - 2025/01/11 21:05:46 WET [2025/01/11 16:05:46 ET]
Table 'Sigune III' 6-max Seat #2 is the button
Seat 1: worker0k ($100 in chips) is sitting out
Seat 2: Zvst ($100 in chips) 
Seat 4: Paddyjoe24 ($145.09 in chips) 
Seat 5: AIien Hand ($100 in chips) 
Seat 6: Manifestorr ($100 in chips) 
Paddyjoe24: posts small blind $0.50
AIien Hand: posts big blind $1
worker0k: sits out 
*** HOLE CARDS ***
Manifestorr: raises $1.20 to $2.20
Zvst: folds 
Paddyjoe24: folds 
BGS013 joins the table at seat #3 
AIien Hand: calls $1.20
*** FLOP *** [Kd Qc 5c]
AIien Hand: checks 
Manifestorr: checks 
*** TURN *** [Kd Qc 5c] [3d]
AIien Hand: checks 
Manifestorr: checks 
*** RIVER *** [Kd Qc 5c 3d] [7h]
worker0k leaves the table
AIien Hand: bets $3.36
Manifestorr: calls $3.36
*** SHOW DOWN ***
AIien Hand: shows [Ac 9d] (high card Ace)
Manifestorr: shows [Js Jc] (a pair of Jacks)
Manifestorr collected $11.04 from pot
*** SUMMARY ***
Total pot $11.62 | Rake $0.58 
Board [Kd Qc 5c 3d 7h]
Seat 1: worker0k
Seat 2: Zvst (button) folded before Flop (didn't bet)
Seat 4: Paddyjoe24 (small blind) folded before Flop
Seat 5: AIien Hand (big blind) showed [Ac 9d] and lost with high card Ace
Seat 6: Manifestorr showed [Js Jc] and won ($11.04) with a pair of Jacks



PokerStars Hand #254319958385:  Hold'em No Limit ($0.50/$1.00 USD) - 2025/01/11 21:07:08 WET [2025/01/11 16:07:08 ET]
Table 'Sigune III' 6-max Seat #4 is the button
Seat 2: Zvst ($100 in chips) is sitting out
Seat 6: Manifestorr ($105.48 in chips) is sitting out
Seat 3: BGS013 ($100 in chips) 
Seat 4: Paddyjoe24 ($144.59 in chips) 
Seat 5: AIien Hand ($100 in chips) 
AIien Hand: posts small blind $0.50
Manifestorr: is sitting out 
Zvst: is sitting out 
BGS013: posts big blind $1
*** HOLE CARDS ***
Manifestorr leaves the table
Zvst leaves the table
Paddyjoe24: raises $2 to $3
AIien Hand: calls $2.50
BGS013: folds 
*** FLOP *** [Tc 3c Qc]
AIien Hand: checks 
Paddyjoe24: bets $3.33
AIien Hand: folds 
Uncalled bet ($3.33) returned to Paddyjoe24
Paddyjoe24 collected $6.65 from pot
*** SUMMARY ***
Total pot $7 | Rake $0.35 
Board [Tc 3c Qc]
Seat 2: Zvst
Seat 6: Manifestorr
Seat 3: BGS013 (big blind) folded before Flop
Seat 4: Paddyjoe24 (button) collected ($6.65)
Seat 5: AIien Hand (small blind) folded on the Flop



PokerStars Hand #254319972324:  Hold'em No Limit ($0.50/$1.00 USD) - 2025/01/11 21:07:49 WET [2025/01/11 16:07:49 ET]
Table 'Sigune III' 6-max Seat #5 is the button
Seat 3: BGS013 ($100 in chips) 
Seat 4: Paddyjoe24 ($148.24 in chips) 
Seat 5: AIien Hand ($100 in chips) 
BGS013: posts small blind $0.50
Paddyjoe24: posts big blind $1
*** HOLE CARDS ***
AIien Hand: raises $1.50 to $2.50
BGS013: folds 
Paddyjoe24: folds 
Uncalled bet ($1.50) returned to AIien Hand
AIien Hand collected $2.50 from pot
AIien Hand: doesn't show hand 
*** SUMMARY ***
Total pot $2.50 | Rake $0 
Seat 3: BGS013 (small blind) folded before Flop
Seat 4: Paddyjoe24 (big blind) folded before Flop
Seat 5: AIien Hand (button) collected ($2.50)



PokerStars Hand #254319975953:  Hold'em No Limit ($0.50/$1.00 USD) - 2025/01/11 21:07:59 WET [2025/01/11 16:07:59 ET]
Table 'Sigune III' 6-max Seat #3 is the button
Seat 3: BGS013 ($100 in chips) 
Seat 4: Paddyjoe24 ($147.24 in chips) 
Seat 5: AIien Hand ($101.50 in chips) 
Paddyjoe24: posts small blind $0.50
AIien Hand: posts big blind $1
*** HOLE CARDS ***
BGS013: raises $1.50 to $2.50
Paddyjoe24: folds 
AIien Hand: raises $10 to $12.50
BGS013: folds 
Uncalled bet ($10) returned to AIien Hand
AIien Hand collected $5.50 from pot
AIien Hand: doesn't show hand 
*** SUMMARY ***
Total pot $5.50 | Rake $0 
Seat 3: BGS013 (button) folded before Flop
Seat 4: Paddyjoe24 (small blind) folded before Flop
Seat 5: AIien Hand (big blind) collected ($5.50)



PokerStars Hand #254319981321:  Hold'em No Limit ($0.50/$1.00 USD) - 2025/01/11 21:08:16 WET [2025/01/11 16:08:16 ET]
Table 'Sigune III' 6-max Seat #4 is the button
Seat 3: BGS013 ($100 in chips) 
Seat 4: Paddyjoe24 ($146.74 in chips) 
Seat 5: AIien Hand ($104.50 in chips) 
AIien Hand: posts small blind $0.50
BGS013: posts big blind $1
*** HOLE CARDS ***
Paddyjoe24: raises $2 to $3
AIien Hand: folds 
BGS013: folds 
Uncalled bet ($2) returned to Paddyjoe24
Paddyjoe24 collected $2.50 from pot
*** SUMMARY ***
Total pot $2.50 | Rake $0 
Seat 3: BGS013 (big blind) folded before Flop
Seat 4: Paddyjoe24 (button) collected ($2.50)
Seat 5: AIien Hand (small blind) folded before Flop



PokerStars Hand #254319986663:  Hold'em No Limit ($0.50/$1.00 USD) - 2025/01/11 21:08:31 WET [2025/01/11 16:08:31 ET]
Table 'Sigune III' 6-max Seat #5 is the button
Seat 3: BGS013 ($100 in chips) 
Seat 4: Paddyjoe24 ($148.24 in chips) 
Seat 5: AIien Hand ($104 in chips) 
BGS013: posts small blind $0.50
Paddyjoe24: posts big blind $1
*** HOLE CARDS ***
AIien Hand: folds 
BGS013: folds 
Uncalled bet ($0.50) returned to Paddyjoe24
Paddyjoe24 collected $1 from pot
*** SUMMARY ***
Total pot $1 | Rake $0 
Seat 3: BGS013 (small blind) folded before Flop
Seat 4: Paddyjoe24 (big blind) collected ($1)
Seat 5: AIien Hand (button) folded before Flop (didn't bet)



PokerStars Hand #254319988737:  Hold'em No Limit ($0.50/$1.00 USD) - 2025/01/11 21:08:38 WET [2025/01/11 16:08:38 ET]
Table 'Sigune III' 6-max Seat #3 is the button
Seat 3: BGS013 ($100 in chips) 
Seat 4: Paddyjoe24 ($148.74 in chips) 
Seat 5: AIien Hand ($104 in chips) 
Paddyjoe24: posts small blind $0.50
AIien Hand: posts big blind $1
*** HOLE CARDS ***
BGS013: raises $1.50 to $2.50
Paddyjoe24: raises $5.50 to $8
AIien Hand: folds 
BGS013: calls $5.50
*** FLOP *** [2h Ad Th]
Paddyjoe24: bets $9
BGS013: folds 
Uncalled bet ($9) returned to Paddyjoe24
Paddyjoe24 collected $16.15 from pot
*** SUMMARY ***
Total pot $17 | Rake $0.85 
Board [2h Ad Th]
Seat 3: BGS013 (button) folded on the Flop
Seat 4: Paddyjoe24 (small blind) collected ($16.15)
Seat 5: AIien Hand (big blind) folded before Flop



PokerStars Hand #254319999309:  Hold'em No Limit ($0.50/$1.00 USD) - 2025/01/11 21:09:09 WET [2025/01/11 16:09:09 ET]
Table 'Sigune III' 6-max Seat #5 is the button
Seat 3: BGS013 ($100 in chips) is sitting out
Seat 4: Paddyjoe24 ($156.89 in chips) 
Seat 5: AIien Hand ($103 in chips) 
AIien Hand: posts small blind $0.50
BGS013: is sitting out 
Paddyjoe24: posts big blind $1
*** HOLE CARDS ***
AIien Hand: raises $1.50 to $2.50
Paddyjoe24: folds 
Uncalled bet ($1.50) returned to AIien Hand
BGS013 leaves the table
AIien Hand collected $2 from pot
AIien Hand: doesn't show hand 
*** SUMMARY ***
Total pot $2 | Rake $0 
Seat 3: BGS013
Seat 4: Paddyjoe24 (big blind) folded before Flop
Seat 5: AIien Hand (button) (small blind) collected ($2)



PokerStars Hand #254320001957:  Hold'em No Limit ($0.50/$1.00 USD) - 2025/01/11 21:09:16 WET [2025/01/11 16:09:16 ET]
Table 'Sigune III' 6-max Seat #4 is the button
Seat 4: Paddyjoe24 ($155.89 in chips) 
Seat 5: AIien Hand ($104 in chips) 
Paddyjoe24: posts small blind $0.50
AIien Hand: posts big blind $1
*** HOLE CARDS ***
Paddyjoe24: raises $2 to $3
AIien Hand: folds 
Uncalled bet ($2) returned to Paddyjoe24
Paddyjoe24 collected $2 from pot
*** SUMMARY ***
Total pot $2 | Rake $0 
Seat 4: Paddyjoe24 (button) (small blind) collected ($2)
Seat 5: AIien Hand (big blind) folded before Flop



PokerStars Hand #254320005729:  Hold'em No Limit ($0.50/$1.00 USD) - 2025/01/11 21:09:28 WET [2025/01/11 16:09:28 ET]
Table 'Sigune III' 6-max Seat #5 is the button
Seat 4: Paddyjoe24 ($156.89 in chips) 
Seat 5: AIien Hand ($103 in chips) 
AIien Hand: posts small blind $0.50
Paddyjoe24: posts big blind $1
*** HOLE CARDS ***
AIien Hand: folds 
Uncalled bet ($0.50) returned to Paddyjoe24
Paddyjoe24 collected $1 from pot
*** SUMMARY ***
Total pot $1 | Rake $0 
Seat 4: Paddyjoe24 (big blind) collected ($1)
Seat 5: AIien Hand (button) (small blind) folded before Flop



PokerStars Hand #254320008087:  Hold'em No Limit ($0.50/$1.00 USD) - 2025/01/11 21:09:35 WET [2025/01/11 16:09:35 ET]
Table 'Sigune III' 6-max Seat #4 is the button
Seat 4: Paddyjoe24 ($157.39 in chips) 
Seat 5: AIien Hand ($102.50 in chips) 
Paddyjoe24: posts small blind $0.50
AIien Hand: posts big blind $1
*** HOLE CARDS ***
Paddyjoe24: folds 
Uncalled bet ($0.50) returned to AIien Hand
AIien Hand collected $1 from pot
AIien Hand: doesn't show hand 
*** SUMMARY ***
Total pot $1 | Rake $0 
Seat 4: Paddyjoe24 (button) (small blind) folded before Flop
Seat 5: AIien Hand (big blind) collected ($1)



PokerStars Hand #254320010552:  Hold'em No Limit ($0.50/$1.00 USD) - 2025/01/11 21:09:42 WET [2025/01/11 16:09:42 ET]
Table 'Sigune III' 6-max Seat #5 is the button
Seat 4: Paddyjoe24 ($156.89 in chips) 
Seat 5: AIien Hand ($103 in chips) 
AIien Hand: posts small blind $0.50
Paddyjoe24: posts big blind $1
*** HOLE CARDS ***
AIien Hand: folds 
Uncalled bet ($0.50) returned to Paddyjoe24
Paddyjoe24 collected $1 from pot
*** SUMMARY ***
Total pot $1 | Rake $0 
Seat 4: Paddyjoe24 (big blind) collected ($1)
Seat 5: AIien Hand (button) (small blind) folded before Flop



PokerStars Hand #254320013276:  Hold'em No Limit ($0.50/$1.00 USD) - 2025/01/11 21:09:50 WET [2025/01/11 16:09:50 ET]
Table 'Sigune III' 6-max Seat #4 is the button
Seat 4: Paddyjoe24 ($157.39 in chips) 
Seat 5: AIien Hand ($102.50 in chips) 
Paddyjoe24: posts small blind $0.50
AIien Hand: posts big blind $1
*** HOLE CARDS ***
Paddyjoe24: folds 
Uncalled bet ($0.50) returned to AIien Hand
AIien Hand collected $1 from pot
AIien Hand: doesn't show hand 
*** SUMMARY ***
Total pot $1 | Rake $0 
Seat 4: Paddyjoe24 (button) (small blind) folded before Flop
Seat 5: AIien Hand (big blind) collected ($1)



PokerStars Hand #254320015758:  Hold'em No Limit ($0.50/$1.00 USD) - 2025/01/11 21:09:57 WET [2025/01/11 16:09:57 ET]
Table 'Sigune III' 6-max Seat #5 is the button
Seat 4: Paddyjoe24 ($156.89 in chips) 
Seat 5: AIien Hand ($103 in chips) 
AIien Hand: posts small blind $0.50
Paddyjoe24: posts big blind $1
*** HOLE CARDS ***
AlexPinsk1 joins the table at seat #6 
AIien Hand: raises $1.50 to $2.50
Paddyjoe24: raises $5.50 to $8
AIien Hand: folds 
Uncalled bet ($5.50) returned to Paddyjoe24
Paddyjoe24 collected $5 from pot
*** SUMMARY ***
Total pot $5 | Rake $0 
Seat 4: Paddyjoe24 (big blind) collected ($5)
Seat 5: AIien Hand (button) (small blind) folded before Flop



PokerStars Hand #254320021532:  Hold'em No Limit ($0.50/$1.00 USD) - 2025/01/11 21:10:14 WET [2025/01/11 16:10:14 ET]
Table 'Sigune III' 6-max Seat #4 is the button
Seat 4: Paddyjoe24 ($159.39 in chips) 
Seat 5: AIien Hand ($100.50 in chips) 
Seat 6: AlexPinsk1 ($100 in chips) 
AIien Hand: posts small blind $0.50
AlexPinsk1: posts big blind $1
*** HOLE CARDS ***
Paddyjoe24: raises $1 to $2
AIien Hand: folds 
AlexPinsk1: folds 
Uncalled bet ($1) returned to Paddyjoe24
Paddyjoe24 collected $2.50 from pot
*** SUMMARY ***
Total pot $2.50 | Rake $0 
Seat 4: Paddyjoe24 (button) collected ($2.50)
Seat 5: AIien Hand (small blind) folded before Flop
Seat 6: AlexPinsk1 (big blind) folded before Flop



PokerStars Hand #254320026886:  Hold'em No Limit ($0.50/$1.00 USD) - 2025/01/11 21:10:29 WET [2025/01/11 16:10:29 ET]
Table 'Sigune III' 6-max Seat #5 is the button
Seat 4: Paddyjoe24 ($160.89 in chips) 
Seat 5: AIien Hand ($100 in chips) 
Seat 6: AlexPinsk1 ($100 in chips) 
AlexPinsk1: posts small blind $0.50
Paddyjoe24: posts big blind $1
*** HOLE CARDS ***
AIien Hand: raises $1.50 to $2.50
AlexPinsk1: folds 
Paddyjoe24: raises $5.50 to $8
AIien Hand: calls $5.50
*** FLOP *** [9c Jh 6c]
Paddyjoe24: checks 
AIien Hand: checks 
*** TURN *** [9c Jh 6c] [3s]
nikalas22 joins the table at seat #1 
Paddyjoe24: bets $9
AIien Hand: raises $18 to $27
Paddyjoe24: folds 
Uncalled bet ($18) returned to AIien Hand
AIien Hand collected $33.50 from pot
AIien Hand: doesn't show hand 
*** SUMMARY ***
Total pot $34.50 | Rake $1 
Board [9c Jh 6c 3s]
Seat 4: Paddyjoe24 (big blind) folded on the Turn
Seat 5: AIien Hand (button) collected ($33.50)
Seat 6: AlexPinsk1 (small blind) folded before Flop



PokerStars Hand #254320049078:  Hold'em No Limit ($0.50/$1.00 USD) - 2025/01/11 21:11:34 WET [2025/01/11 16:11:34 ET]
Table 'Sigune III' 6-max Seat #6 is the button
Seat 1: nikalas22 ($100 in chips) is sitting out
Seat 4: Paddyjoe24 ($143.89 in chips) 
Seat 5: AIien Hand ($116.50 in chips) 
Seat 6: AlexPinsk1 ($100 in chips) 
Paddyjoe24: posts small blind $0.50
AIien Hand: posts big blind $1
*** HOLE CARDS ***
AlexPinsk1: folds 
Paddyjoe24: raises $2 to $3
AIien Hand: folds 
Uncalled bet ($2) returned to Paddyjoe24
Paddyjoe24 collected $2 from pot
*** SUMMARY ***
Total pot $2 | Rake $0 
Seat 1: nikalas22
Seat 4: Paddyjoe24 (small blind) collected ($2)
Seat 5: AIien Hand (big blind) folded before Flop
Seat 6: AlexPinsk1 (button) folded before Flop (didn't bet)



PokerStars Hand #254320053366:  Hold'em No Limit ($0.50/$1.00 USD) - 2025/01/11 21:11:46 WET [2025/01/11 16:11:46 ET]
Table 'Sigune III' 6-max Seat #4 is the button
Seat 1: nikalas22 ($100 in chips) is sitting out
Seat 4: Paddyjoe24 ($144.89 in chips) 
Seat 5: AIien Hand ($115.50 in chips) 
Seat 6: AlexPinsk1 ($100 in chips) 
AIien Hand: posts small blind $0.50
AlexPinsk1: posts big blind $1
nikalas22: sits out 
*** HOLE CARDS ***
Paddyjoe24: folds 
AIien Hand: raises $2 to $3
AlexPinsk1: folds 
Uncalled bet ($2) returned to AIien Hand
Pippa83 joins the table at seat #3 
AIien Hand collected $2 from pot
AIien Hand: doesn't show hand 
*** SUMMARY ***
Total pot $2 | Rake $0 
Seat 1: nikalas22
Seat 4: Paddyjoe24 (button) folded before Flop (didn't bet)
Seat 5: AIien Hand (small blind) collected ($2)
Seat 6: AlexPinsk1 (big blind) folded before Flop



PokerStars Hand #254320059563:  Hold'em No Limit ($0.50/$1.00 USD) - 2025/01/11 21:12:04 WET [2025/01/11 16:12:04 ET]
Table 'Sigune III' 6-max Seat #5 is the button
Seat 3: Pippa83 ($100 in chips) is sitting out
Seat 1: nikalas22 ($100 in chips) 
Seat 4: Paddyjoe24 ($144.89 in chips) 
Seat 5: AIien Hand ($116.50 in chips) 
Seat 6: AlexPinsk1 ($100 in chips) 
AlexPinsk1: posts small blind $0.50
nikalas22: posts big blind $1
Pippa83: sits out 
*** HOLE CARDS ***
Paddyjoe24: folds 
AIien Hand: raises $1.50 to $2.50
AlexPinsk1: folds 
nikalas22: folds 
Uncalled bet ($1.50) returned to AIien Hand
AIien Hand collected $2.50 from pot
AIien Hand: doesn't show hand 
*** SUMMARY ***
Total pot $2.50 | Rake $0 
Seat 3: Pippa83
Seat 1: nikalas22 (big blind) folded before Flop
Seat 4: Paddyjoe24 folded before Flop (didn't bet)
Seat 5: AIien Hand (button) collected ($2.50)
Seat 6: AlexPinsk1 (small blind) folded before Flop



PokerStars Hand #254320067782:  Hold'em No Limit ($0.50/$1.00 USD) - 2025/01/11 21:12:28 WET [2025/01/11 16:12:28 ET]
Table 'Sigune III' 6-max Seat #6 is the button
Seat 1: nikalas22 ($100 in chips) 
Seat 3: Pippa83 ($100 in chips) 
Seat 4: Paddyjoe24 ($144.89 in chips) 
Seat 5: AIien Hand ($118 in chips) 
Seat 6: AlexPinsk1 ($100 in chips) 
nikalas22: posts small blind $0.50
Pippa83: posts big blind $1
*** HOLE CARDS ***
Paddyjoe24: folds 
AIien Hand: folds 
AlexPinsk1: folds 
nikalas22: folds 
Uncalled bet ($0.50) returned to Pippa83
Pippa83 collected $1 from pot
Pippa83: doesn't show hand 
*** SUMMARY ***
Total pot $1 | Rake $0 
Seat 1: nikalas22 (small blind) folded before Flop
Seat 3: Pippa83 (big blind) collected ($1)
Seat 4: Paddyjoe24 folded before Flop (didn't bet)
Seat 5: AIien Hand folded before Flop (didn't bet)
Seat 6: AlexPinsk1 (button) folded before Flop (didn't bet)



PokerStars Hand #254320071349:  Hold'em No Limit ($0.50/$1.00 USD) - 2025/01/11 21:12:38 WET [2025/01/11 16:12:38 ET]
Table 'Sigune III' 6-max Seat #1 is the button
Seat 1: nikalas22 ($100 in chips) 
Seat 3: Pippa83 ($100.50 in chips) 
Seat 4: Paddyjoe24 ($144.89 in chips) 
Seat 5: AIien Hand ($118 in chips) 
Seat 6: AlexPinsk1 ($100 in chips) 
Pippa83: posts small blind $0.50
Paddyjoe24: posts big blind $1
*** HOLE CARDS ***
AIien Hand: folds 
AlexPinsk1: folds 
nikalas22: raises $1.50 to $2.50
Pippa83: raises $9 to $11.50
Paddyjoe24: folds 
nikalas22: folds 
Uncalled bet ($9) returned to Pippa83
Pippa83 collected $6 from pot
Pippa83: doesn't show hand 
*** SUMMARY ***
Total pot $6 | Rake $0 
Seat 1: nikalas22 (button) folded before Flop
Seat 3: Pippa83 (small blind) collected ($6)
Seat 4: Paddyjoe24 (big blind) folded before Flop
Seat 5: AIien Hand folded before Flop (didn't bet)
Seat 6: AlexPinsk1 folded before Flop (didn't bet)



PokerStars Hand #254320081148:  Hold'em No Limit ($0.50/$1.00 USD) - 2025/01/11 21:13:06 WET [2025/01/11 16:13:06 ET]
Table 'Sigune III' 6-max Seat #3 is the button
Seat 1: nikalas22 ($100 in chips) 
Seat 3: Pippa83 ($104 in chips) 
Seat 4: Paddyjoe24 ($143.89 in chips) 
Seat 5: AIien Hand ($118 in chips) 
Seat 6: AlexPinsk1 ($100 in chips) 
Paddyjoe24: posts small blind $0.50
AIien Hand: posts big blind $1
*** HOLE CARDS ***
AlexPinsk1: folds 
nikalas22: folds 
Pippa83: folds 
MaRKiToScoK joins the table at seat #2 
Paddyjoe24: raises $1 to $2
AIien Hand: calls $1
*** FLOP *** [3s Qs 4d]
Paddyjoe24: bets $2
AIien Hand: folds 
Uncalled bet ($2) returned to Paddyjoe24
Paddyjoe24 collected $3.80 from pot
*** SUMMARY ***
Total pot $4 | Rake $0.20 
Board [3s Qs 4d]
Seat 1: nikalas22 folded before Flop (didn't bet)
Seat 3: Pippa83 (button) folded before Flop (didn't bet)
Seat 4: Paddyjoe24 (small blind) collected ($3.80)
Seat 5: AIien Hand (big blind) folded on the Flop
Seat 6: AlexPinsk1 folded before Flop (didn't bet)



