PokerStars Hand #254637532992:  Hold'em No Limit ($0.50/$1.00 USD) - 2025/01/31 15:33:27 WET [2025/01/31 10:33:27 ET]
Table 'Adria' 6-max Seat #1 is the button
Seat 4: TheAveiro ($10 in chips) is sitting out
Seat 1: Glauberwouny ($39.78 in chips) 
Seat 2: CichiChanMarian ($100.50 in chips) 
Seat 3: Poker9803 ($100 in chips) 
CichiChanMarian: posts small blind $0.50
Poker9803: posts big blind $1
TheAveiro: sits out 
*** HOLE CARDS ***
Glauberwouny: folds 
CichiChanMarian: raises $2 to $3
Poker9803: raises $6 to $9
CichiChanMarian: calls $6
*** FLOP *** [4c 3s 4h]
CichiChanMarian: checks 
Poker9803: bets $5.64
CichiChanMarian: folds 
Uncalled bet ($5.64) returned to Poker9803
Poker9803 collected $17.10 from pot
Poker9803: doesn't show hand 
*** SUMMARY ***
Total pot $18 | Rake $0.90 
Board [4c 3s 4h]
Seat 4: TheAveiro
Seat 1: Glauberwouny (button) folded before Flop (didn't bet)
Seat 2: CichiChanMarian (small blind) folded on the Flop
Seat 3: Poker9803 (big blind) collected ($17.10)



PokerStars Hand #254637544742:  Hold'em No Limit ($0.50/$1.00 USD) - 2025/01/31 15:34:23 WET [2025/01/31 10:34:23 ET]
Table 'Adria' 6-max Seat #2 is the button
Seat 1: Glauberwouny ($39.78 in chips) 
Seat 2: CichiChanMarian ($100 in chips) 
Seat 3: Poker9803 ($108.10 in chips) 
Seat 4: TheAveiro ($10 in chips) 
Poker9803: posts small blind $0.50
TheAveiro: posts big blind $1
*** HOLE CARDS ***
Glauberwouny: raises $2 to $3
CichiChanMarian: folds 
Poker9803: raises $8 to $11
TheAveiro: folds 
Glauberwouny: folds 
Uncalled bet ($8) returned to Poker9803
Poker9803 collected $7 from pot
Poker9803: doesn't show hand 
*** SUMMARY ***
Total pot $7 | Rake $0 
Seat 1: Glauberwouny folded before Flop
Seat 2: CichiChanMarian (button) folded before Flop (didn't bet)
Seat 3: Poker9803 (small blind) collected ($7)
Seat 4: TheAveiro (big blind) folded before Flop



PokerStars Hand #254637553523:  Hold'em No Limit ($0.50/$1.00 USD) - 2025/01/31 15:35:05 WET [2025/01/31 10:35:05 ET]
Table 'Adria' 6-max Seat #3 is the button
Seat 1: Glauberwouny ($36.78 in chips) 
Seat 2: CichiChanMarian ($100 in chips) 
Seat 3: Poker9803 ($112.10 in chips) 
Seat 4: TheAveiro ($10 in chips) 
TheAveiro: posts small blind $0.50
Glauberwouny: posts big blind $1
*** HOLE CARDS ***
CichiChanMarian: folds 
Poker9803: raises $1 to $2
TheAveiro: folds 
Glauberwouny: folds 
Uncalled bet ($1) returned to Poker9803
Poker9803 collected $2.50 from pot
Poker9803: doesn't show hand 
*** SUMMARY ***
Total pot $2.50 | Rake $0 
Seat 1: Glauberwouny (big blind) folded before Flop
Seat 2: CichiChanMarian folded before Flop (didn't bet)
Seat 3: Poker9803 (button) collected ($2.50)
Seat 4: TheAveiro (small blind) folded before Flop



PokerStars Hand #254637557309:  Hold'em No Limit ($0.50/$1.00 USD) - 2025/01/31 15:35:23 WET [2025/01/31 10:35:23 ET]
Table 'Adria' 6-max Seat #4 is the button
Seat 1: Glauberwouny ($35.78 in chips) 
Seat 2: CichiChanMarian ($100 in chips) 
Seat 3: Poker9803 ($113.60 in chips) 
Seat 4: TheAveiro ($10 in chips) 
Glauberwouny: posts small blind $0.50
CichiChanMarian: posts big blind $1
*** HOLE CARDS ***
Poker9803: folds 
TheAveiro: folds 
Glauberwouny: raises $1 to $2
CichiChanMarian: folds 
Uncalled bet ($1) returned to Glauberwouny
Glauberwouny collected $2 from pot
*** SUMMARY ***
Total pot $2 | Rake $0 
Seat 1: Glauberwouny (small blind) collected ($2)
Seat 2: CichiChanMarian (big blind) folded before Flop
Seat 3: Poker9803 folded before Flop (didn't bet)
Seat 4: TheAveiro (button) folded before Flop (didn't bet)



PokerStars Hand #254637560536:  Hold'em No Limit ($0.50/$1.00 USD) - 2025/01/31 15:35:39 WET [2025/01/31 10:35:39 ET]
Table 'Adria' 6-max Seat #1 is the button
Seat 1: Glauberwouny ($36.78 in chips) 
Seat 2: CichiChanMarian ($100 in chips) 
Seat 3: Poker9803 ($113.60 in chips) 
Seat 4: TheAveiro ($10 in chips) 
CichiChanMarian: posts small blind $0.50
Poker9803: posts big blind $1
*** HOLE CARDS ***
TheAveiro: folds 
Glauberwouny: folds 
CichiChanMarian: folds 
Uncalled bet ($0.50) returned to Poker9803
Poker9803 collected $1 from pot
Poker9803: doesn't show hand 
*** SUMMARY ***
Total pot $1 | Rake $0 
Seat 1: Glauberwouny (button) folded before Flop (didn't bet)
Seat 2: CichiChanMarian (small blind) folded before Flop
Seat 3: Poker9803 (big blind) collected ($1)
Seat 4: TheAveiro folded before Flop (didn't bet)



PokerStars Hand #254637562570:  Hold'em No Limit ($0.50/$1.00 USD) - 2025/01/31 15:35:49 WET [2025/01/31 10:35:49 ET]
Table 'Adria' 6-max Seat #2 is the button
Seat 1: Glauberwouny ($36.78 in chips) 
Seat 2: CichiChanMarian ($100 in chips) 
Seat 3: Poker9803 ($114.10 in chips) 
Seat 4: TheAveiro ($10 in chips) 
Poker9803: posts small blind $0.50
TheAveiro: posts big blind $1
*** HOLE CARDS ***
Glauberwouny: folds 
Pon4uk.ua joins the table at seat #5 
CichiChanMarian: folds 
Poker9803: folds 
Uncalled bet ($0.50) returned to TheAveiro
TheAveiro collected $1 from pot
TheAveiro: doesn't show hand 
*** SUMMARY ***
Total pot $1 | Rake $0 
Seat 1: Glauberwouny folded before Flop (didn't bet)
Seat 2: CichiChanMarian (button) folded before Flop (didn't bet)
Seat 3: Poker9803 (small blind) folded before Flop
Seat 4: TheAveiro (big blind) collected ($1)



PokerStars Hand #254637564374:  Hold'em No Limit ($0.50/$1.00 USD) - 2025/01/31 15:35:57 WET [2025/01/31 10:35:57 ET]
Table 'Adria' 6-max Seat #3 is the button
Seat 1: Glauberwouny ($36.78 in chips) 
Seat 2: CichiChanMarian ($100 in chips) 
Seat 3: Poker9803 ($113.60 in chips) 
Seat 4: TheAveiro ($10.50 in chips) 
Seat 5: Pon4uk.ua ($100 in chips) 
TheAveiro: posts small blind $0.50
Pon4uk.ua: posts big blind $1
*** HOLE CARDS ***
Glauberwouny: folds 
CichiChanMarian: raises $1.50 to $2.50
Poker9803: folds 
TheAveiro: folds 
Pon4uk.ua: folds 
Uncalled bet ($1.50) returned to CichiChanMarian
CichiChanMarian collected $2.50 from pot
CichiChanMarian: doesn't show hand 
*** SUMMARY ***
Total pot $2.50 | Rake $0 
Seat 1: Glauberwouny folded before Flop (didn't bet)
Seat 2: CichiChanMarian collected ($2.50)
Seat 3: Poker9803 (button) folded before Flop (didn't bet)
Seat 4: TheAveiro (small blind) folded before Flop
Seat 5: Pon4uk.ua (big blind) folded before Flop



PokerStars Hand #254637568509:  Hold'em No Limit ($0.50/$1.00 USD) - 2025/01/31 15:36:17 WET [2025/01/31 10:36:17 ET]
Table 'Adria' 6-max Seat #4 is the button
Seat 1: Glauberwouny ($36.78 in chips) 
Seat 2: CichiChanMarian ($101.50 in chips) 
Seat 3: Poker9803 ($113.60 in chips) 
Seat 4: TheAveiro ($10 in chips) 
Seat 5: Pon4uk.ua ($100 in chips) 
Pon4uk.ua: posts small blind $0.50
Glauberwouny: posts big blind $1
*** HOLE CARDS ***
CichiChanMarian: folds 
Poker9803: folds 
TheAveiro: folds 
Pon4uk.ua: raises $1.75 to $2.75
Glauberwouny: folds 
Uncalled bet ($1.75) returned to Pon4uk.ua
Pon4uk.ua collected $2 from pot
Pon4uk.ua: doesn't show hand 
*** SUMMARY ***
Total pot $2 | Rake $0 
Seat 1: Glauberwouny (big blind) folded before Flop
Seat 2: CichiChanMarian folded before Flop (didn't bet)
Seat 3: Poker9803 folded before Flop (didn't bet)
Seat 4: TheAveiro (button) folded before Flop (didn't bet)
Seat 5: Pon4uk.ua (small blind) collected ($2)



PokerStars Hand #254637571151:  Hold'em No Limit ($0.50/$1.00 USD) - 2025/01/31 15:36:30 WET [2025/01/31 10:36:30 ET]
Table 'Adria' 6-max Seat #5 is the button
Seat 1: Glauberwouny ($35.78 in chips) 
Seat 2: CichiChanMarian ($101.50 in chips) 
Seat 3: Poker9803 ($113.60 in chips) 
Seat 4: TheAveiro ($10 in chips) 
Seat 5: Pon4uk.ua ($101 in chips) 
Glauberwouny: posts small blind $0.50
CichiChanMarian: posts big blind $1
*** HOLE CARDS ***
Poker9803: folds 
TheAveiro: raises $1.50 to $2.50
Pon4uk.ua: folds 
Glauberwouny: folds 
CichiChanMarian: folds 
Uncalled bet ($1.50) returned to TheAveiro
TheAveiro collected $2.50 from pot
TheAveiro: doesn't show hand 
*** SUMMARY ***
Total pot $2.50 | Rake $0 
Seat 1: Glauberwouny (small blind) folded before Flop
Seat 2: CichiChanMarian (big blind) folded before Flop
Seat 3: Poker9803 folded before Flop (didn't bet)
Seat 4: TheAveiro collected ($2.50)
Seat 5: Pon4uk.ua (button) folded before Flop (didn't bet)



PokerStars Hand #254637578168:  Hold'em No Limit ($0.50/$1.00 USD) - 2025/01/31 15:37:04 WET [2025/01/31 10:37:04 ET]
Table 'Adria' 6-max Seat #1 is the button
Seat 1: Glauberwouny ($35.28 in chips) 
Seat 2: CichiChanMarian ($100.50 in chips) 
Seat 3: Poker9803 ($113.60 in chips) 
Seat 4: TheAveiro ($11.50 in chips) 
Seat 5: Pon4uk.ua ($101 in chips) 
CichiChanMarian: posts small blind $0.50
Poker9803: posts big blind $1
*** HOLE CARDS ***
TheAveiro: folds 
Pon4uk.ua: folds 
Glauberwouny: folds 
CichiChanMarian: raises $2 to $3
Poker9803: folds 
Uncalled bet ($2) returned to CichiChanMarian
CichiChanMarian collected $2 from pot
CichiChanMarian: doesn't show hand 
*** SUMMARY ***
Total pot $2 | Rake $0 
Seat 1: Glauberwouny (button) folded before Flop (didn't bet)
Seat 2: CichiChanMarian (small blind) collected ($2)
Seat 3: Poker9803 (big blind) folded before Flop
Seat 4: TheAveiro folded before Flop (didn't bet)
Seat 5: Pon4uk.ua folded before Flop (didn't bet)



PokerStars Hand #254637581517:  Hold'em No Limit ($0.50/$1.00 USD) - 2025/01/31 15:37:21 WET [2025/01/31 10:37:21 ET]
Table 'Adria' 6-max Seat #2 is the button
Seat 1: Glauberwouny ($35.28 in chips) 
Seat 2: CichiChanMarian ($101.50 in chips) 
Seat 3: Poker9803 ($112.60 in chips) 
Seat 4: TheAveiro ($11.50 in chips) 
Seat 5: Pon4uk.ua ($101 in chips) 
Poker9803: posts small blind $0.50
nico1980595 joins the table at seat #6 
TheAveiro: posts big blind $1
*** HOLE CARDS ***
Pon4uk.ua: folds 
Glauberwouny: folds 
CichiChanMarian: raises $1.50 to $2.50
Poker9803: raises $9 to $11.50
TheAveiro: calls $10.50 and is all-in
CichiChanMarian: folds 
*** FLOP *** [8d Kd 6c]
*** TURN *** [8d Kd 6c] [6h]
*** RIVER *** [8d Kd 6c 6h] [Td]
*** SHOW DOWN ***
Poker9803: shows [7c 7d] (two pair, Sevens and Sixes)
TheAveiro: shows [Ad Qc] (a pair of Sixes)
Poker9803 collected $24.22 from pot
TheAveiro cashed out the hand for $10.89 | Cash Out Fee $0.22
*** SUMMARY ***
Total pot $25.50 | Rake $1.28 
Board [8d Kd 6c 6h Td]
Seat 1: Glauberwouny folded before Flop (didn't bet)
Seat 2: CichiChanMarian (button) folded before Flop
Seat 3: Poker9803 (small blind) showed [7c 7d] and won ($24.22) with two pair, Sevens and Sixes
Seat 4: TheAveiro (big blind) showed [Ad Qc] and lost with a pair of Sixes (cashed out).
Seat 5: Pon4uk.ua folded before Flop (didn't bet)



PokerStars Hand #254637587613:  Hold'em No Limit ($0.50/$1.00 USD) - 2025/01/31 15:37:50 WET [2025/01/31 10:37:50 ET]
Table 'Adria' 6-max Seat #3 is the button
Seat 6: nico1980595 ($100 in chips) is sitting out
Seat 1: Glauberwouny ($35.28 in chips) 
Seat 2: CichiChanMarian ($100 in chips) 
Seat 3: Poker9803 ($125.32 in chips) 
Seat 4: TheAveiro ($10.89 in chips) 
Seat 5: Pon4uk.ua ($101 in chips) 
TheAveiro: posts small blind $0.50
Pon4uk.ua: posts big blind $1
nico1980595: sits out 
*** HOLE CARDS ***
Glauberwouny: folds 
CichiChanMarian: folds 
Poker9803: raises $1 to $2
TheAveiro: raises $8.89 to $10.89 and is all-in
Pon4uk.ua: folds 
Poker9803: calls $8.89
*** FLOP *** [As 6d 5c]
*** TURN *** [As 6d 5c] [Kh]
*** RIVER *** [As 6d 5c Kh] [Kc]
*** SHOW DOWN ***
TheAveiro: shows [Ah 6c] (two pair, Aces and Kings)
Poker9803: shows [8d Kd] (three of a kind, Kings)
Poker9803 collected $21.64 from pot
*** SUMMARY ***
Total pot $22.78 | Rake $1.14 
Board [As 6d 5c Kh Kc]
Seat 6: nico1980595
Seat 1: Glauberwouny folded before Flop (didn't bet)
Seat 2: CichiChanMarian folded before Flop (didn't bet)
Seat 3: Poker9803 (button) showed [8d Kd] and won ($21.64) with three of a kind, Kings
Seat 4: TheAveiro (small blind) showed [Ah 6c] and lost with two pair, Aces and Kings
Seat 5: Pon4uk.ua (big blind) folded before Flop



PokerStars Hand #254637593628:  Hold'em No Limit ($0.50/$1.00 USD) - 2025/01/31 15:38:19 WET [2025/01/31 10:38:19 ET]
Table 'Adria' 6-max Seat #4 is the button
Seat 1: Glauberwouny ($35.28 in chips) 
Seat 2: CichiChanMarian ($100 in chips) 
Seat 3: Poker9803 ($136.07 in chips) 
Seat 4: TheAveiro ($10 in chips) 
Seat 5: Pon4uk.ua ($100 in chips) 
Seat 6: nico1980595 ($100 in chips) 
Pon4uk.ua: posts small blind $0.50
nico1980595: posts big blind $1
*** HOLE CARDS ***
Glauberwouny: folds 
CichiChanMarian: folds 
Poker9803: folds 
TheAveiro: raises $9 to $10 and is all-in
Pon4uk.ua: folds 
nico1980595: folds 
Uncalled bet ($9) returned to TheAveiro
TheAveiro collected $2.50 from pot
TheAveiro: doesn't show hand 
*** SUMMARY ***
Total pot $2.50 | Rake $0 
Seat 1: Glauberwouny folded before Flop (didn't bet)
Seat 2: CichiChanMarian folded before Flop (didn't bet)
Seat 3: Poker9803 folded before Flop (didn't bet)
Seat 4: TheAveiro (button) collected ($2.50)
Seat 5: Pon4uk.ua (small blind) folded before Flop
Seat 6: nico1980595 (big blind) folded before Flop



PokerStars Hand #254637597399:  Hold'em No Limit ($0.50/$1.00 USD) - 2025/01/31 15:38:37 WET [2025/01/31 10:38:37 ET]
Table 'Adria' 6-max Seat #5 is the button
Seat 1: Glauberwouny ($35.28 in chips) 
Seat 2: CichiChanMarian ($100 in chips) 
Seat 3: Poker9803 ($136.07 in chips) 
Seat 4: TheAveiro ($11.50 in chips) 
Seat 5: Pon4uk.ua ($100 in chips) 
Seat 6: nico1980595 ($99 in chips) 
nico1980595: posts small blind $0.50
Glauberwouny: posts big blind $1
*** HOLE CARDS ***
CichiChanMarian: folds 
Poker9803: folds 
TheAveiro: folds 
Pon4uk.ua: folds 
nico1980595: raises $1 to $2
Glauberwouny: calls $1
*** FLOP *** [6h 2d 8d]
nico1980595: bets $2.53
Glauberwouny: raises $3.53 to $6.06
nico1980595: calls $3.53
*** TURN *** [6h 2d 8d] [5s]
nico1980595: checks 
Glauberwouny: bets $27.22 and is all-in
nico1980595: calls $27.22
Glauberwouny has timed out
*** RIVER *** [6h 2d 8d 5s] [9h]
*** SHOW DOWN ***
nico1980595: shows [Qd 8h] (a pair of Eights)
Glauberwouny: shows [Jh 8s] (a pair of Eights - lower kicker)
nico1980595 collected $68.06 from pot
*** SUMMARY ***
Total pot $70.56 | Rake $2.50 
Board [6h 2d 8d 5s 9h]
Seat 1: Glauberwouny (big blind) showed [Jh 8s] and lost with a pair of Eights
Seat 2: CichiChanMarian folded before Flop (didn't bet)
Seat 3: Poker9803 folded before Flop (didn't bet)
Seat 4: TheAveiro folded before Flop (didn't bet)
Seat 5: Pon4uk.ua (button) folded before Flop (didn't bet)
Seat 6: nico1980595 (small blind) showed [Qd 8h] and won ($68.06) with a pair of Eights



PokerStars Hand #254637607721:  Hold'em No Limit ($0.50/$1.00 USD) - 2025/01/31 15:39:27 WET [2025/01/31 10:39:27 ET]
Table 'Adria' 6-max Seat #6 is the button
Seat 1: Glauberwouny ($0 in chips) is sitting out
Seat 2: CichiChanMarian ($100 in chips) 
Seat 3: Poker9803 ($136.07 in chips) 
Seat 4: TheAveiro ($11.50 in chips) 
Seat 5: Pon4uk.ua ($100 in chips) 
Seat 6: nico1980595 ($131.78 in chips) 
CichiChanMarian: posts small blind $0.50
Poker9803: posts big blind $1
*** HOLE CARDS ***
TheAveiro: folds 
Pon4uk.ua: raises $1.50 to $2.50
nico1980595: folds 
Glauberwouny leaves the table
CichiChanMarian: folds 
Poker9803: raises $10.50 to $13
LuckyShikari joins the table at seat #1 
Pon4uk.ua: folds 
Uncalled bet ($10.50) returned to Poker9803
Poker9803 collected $5.50 from pot
Poker9803: doesn't show hand 
*** SUMMARY ***
Total pot $5.50 | Rake $0 
Seat 1: Glauberwouny
Seat 2: CichiChanMarian (small blind) folded before Flop
Seat 3: Poker9803 (big blind) collected ($5.50)
Seat 4: TheAveiro folded before Flop (didn't bet)
Seat 5: Pon4uk.ua folded before Flop
Seat 6: nico1980595 (button) folded before Flop (didn't bet)



PokerStars Hand #254637613466:  Hold'em No Limit ($0.50/$1.00 USD) - 2025/01/31 15:39:54 WET [2025/01/31 10:39:54 ET]
Table 'Adria' 6-max Seat #2 is the button
Seat 1: LuckyShikari ($100 in chips) is sitting out
Seat 2: CichiChanMarian ($100 in chips) 
Seat 3: Poker9803 ($139.07 in chips) 
Seat 4: TheAveiro ($11.50 in chips) 
Seat 5: Pon4uk.ua ($100 in chips) 
Seat 6: nico1980595 ($131.78 in chips) 
Poker9803: posts small blind $0.50
TheAveiro: posts big blind $1
LuckyShikari: sits out 
*** HOLE CARDS ***
Pon4uk.ua: folds 
nico1980595: folds 
CichiChanMarian: raises $1.50 to $2.50
Poker9803: raises $9 to $11.50
TheAveiro: folds 
CichiChanMarian: folds 
Uncalled bet ($9) returned to Poker9803
Poker9803 collected $6 from pot
Poker9803: doesn't show hand 
*** SUMMARY ***
Total pot $6 | Rake $0 
Seat 1: LuckyShikari
Seat 2: CichiChanMarian (button) folded before Flop
Seat 3: Poker9803 (small blind) collected ($6)
Seat 4: TheAveiro (big blind) folded before Flop
Seat 5: Pon4uk.ua folded before Flop (didn't bet)
Seat 6: nico1980595 folded before Flop (didn't bet)



PokerStars Hand #254637618400:  Hold'em No Limit ($0.50/$1.00 USD) - 2025/01/31 15:40:18 WET [2025/01/31 10:40:18 ET]
Table 'Adria' 6-max Seat #3 is the button
Seat 1: LuckyShikari ($100 in chips) is sitting out
Seat 2: CichiChanMarian ($100 in chips) 
Seat 3: Poker9803 ($142.57 in chips) 
Seat 4: TheAveiro ($10.50 in chips) 
Seat 5: Pon4uk.ua ($100 in chips) 
Seat 6: nico1980595 ($131.78 in chips) 
TheAveiro: posts small blind $0.50
Pon4uk.ua: posts big blind $1
LuckyShikari: sits out 
*** HOLE CARDS ***
nico1980595: raises $1 to $2
CichiChanMarian: folds 
Poker9803: folds 
TheAveiro: folds 
Pon4uk.ua: folds 
Uncalled bet ($1) returned to nico1980595
nico1980595 collected $2.50 from pot
nico1980595: doesn't show hand 
*** SUMMARY ***
Total pot $2.50 | Rake $0 
Seat 1: LuckyShikari
Seat 2: CichiChanMarian folded before Flop (didn't bet)
Seat 3: Poker9803 (button) folded before Flop (didn't bet)
Seat 4: TheAveiro (small blind) folded before Flop
Seat 5: Pon4uk.ua (big blind) folded before Flop
Seat 6: nico1980595 collected ($2.50)



PokerStars Hand #254637621717:  Hold'em No Limit ($0.50/$1.00 USD) - 2025/01/31 15:40:34 WET [2025/01/31 10:40:34 ET]
Table 'Adria' 6-max Seat #4 is the button
Seat 1: LuckyShikari ($100 in chips) is sitting out
Seat 2: CichiChanMarian ($100 in chips) 
Seat 3: Poker9803 ($142.57 in chips) 
Seat 4: TheAveiro ($10 in chips) 
Seat 5: Pon4uk.ua ($100 in chips) 
Seat 6: nico1980595 ($133.28 in chips) 
Pon4uk.ua: posts small blind $0.50
nico1980595: posts big blind $1
LuckyShikari: sits out 
*** HOLE CARDS ***
CichiChanMarian: folds 
Poker9803: raises $1 to $2
TheAveiro: raises $8 to $10 and is all-in
Pon4uk.ua: folds 
nico1980595: folds 
Poker9803: folds 
Uncalled bet ($8) returned to TheAveiro
TheAveiro collected $5.50 from pot
TheAveiro: doesn't show hand 
*** SUMMARY ***
Total pot $5.50 | Rake $0 
Seat 1: LuckyShikari
Seat 2: CichiChanMarian folded before Flop (didn't bet)
Seat 3: Poker9803 folded before Flop
Seat 4: TheAveiro (button) collected ($5.50)
Seat 5: Pon4uk.ua (small blind) folded before Flop
Seat 6: nico1980595 (big blind) folded before Flop



PokerStars Hand #254637625839:  Hold'em No Limit ($0.50/$1.00 USD) - 2025/01/31 15:40:54 WET [2025/01/31 10:40:54 ET]
Table 'Adria' 6-max Seat #5 is the button
Seat 1: LuckyShikari ($100 in chips) 
Seat 2: CichiChanMarian ($100 in chips) 
Seat 3: Poker9803 ($140.57 in chips) 
Seat 4: TheAveiro ($13.50 in chips) 
Seat 5: Pon4uk.ua ($100 in chips) 
Seat 6: nico1980595 ($132.28 in chips) 
nico1980595: posts small blind $0.50
LuckyShikari: posts big blind $1
*** HOLE CARDS ***
CichiChanMarian: folds 
Poker9803: raises $1 to $2
TheAveiro: folds 
Pon4uk.ua: folds 
nico1980595: folds 
LuckyShikari: folds 
Uncalled bet ($1) returned to Poker9803
Poker9803 collected $2.50 from pot
Poker9803: doesn't show hand 
*** SUMMARY ***
Total pot $2.50 | Rake $0 
Seat 1: LuckyShikari (big blind) folded before Flop
Seat 2: CichiChanMarian folded before Flop (didn't bet)
Seat 3: Poker9803 collected ($2.50)
Seat 4: TheAveiro folded before Flop (didn't bet)
Seat 5: Pon4uk.ua (button) folded before Flop (didn't bet)
Seat 6: nico1980595 (small blind) folded before Flop



PokerStars Hand #254637630654:  Hold'em No Limit ($0.50/$1.00 USD) - 2025/01/31 15:41:17 WET [2025/01/31 10:41:17 ET]
Table 'Adria' 6-max Seat #6 is the button
Seat 1: LuckyShikari ($100 in chips) 
Seat 2: CichiChanMarian ($100 in chips) 
Seat 3: Poker9803 ($142.07 in chips) 
Seat 4: TheAveiro ($13.50 in chips) 
Seat 5: Pon4uk.ua ($100 in chips) 
Seat 6: nico1980595 ($131.78 in chips) 
LuckyShikari: posts small blind $0.50
CichiChanMarian: posts big blind $1
*** HOLE CARDS ***
Poker9803: folds 
TheAveiro: folds 
Pon4uk.ua: raises $1.50 to $2.50
nico1980595: folds 
LuckyShikari: folds 
CichiChanMarian: calls $1.50
*** FLOP *** [5s 7h 4c]
CichiChanMarian: checks 
Pon4uk.ua: bets $2.61
CichiChanMarian: calls $2.61
*** TURN *** [5s 7h 4c] [Jd]
CichiChanMarian: checks 
Pon4uk.ua: checks 
*** RIVER *** [5s 7h 4c Jd] [Jh]
CichiChanMarian: checks 
Pon4uk.ua: checks 
*** SHOW DOWN ***
CichiChanMarian: shows [5c Kc] (two pair, Jacks and Fives)
Pon4uk.ua: mucks hand 
CichiChanMarian collected $10.18 from pot
*** SUMMARY ***
Total pot $10.72 | Rake $0.54 
Board [5s 7h 4c Jd Jh]
Seat 1: LuckyShikari (small blind) folded before Flop
Seat 2: CichiChanMarian (big blind) showed [5c Kc] and won ($10.18) with two pair, Jacks and Fives
Seat 3: Poker9803 folded before Flop (didn't bet)
Seat 4: TheAveiro folded before Flop (didn't bet)
Seat 5: Pon4uk.ua mucked
Seat 6: nico1980595 (button) folded before Flop (didn't bet)



PokerStars Hand #254637641693:  Hold'em No Limit ($0.50/$1.00 USD) - 2025/01/31 15:42:10 WET [2025/01/31 10:42:10 ET]
Table 'Adria' 6-max Seat #1 is the button
Seat 1: LuckyShikari ($100 in chips) 
Seat 2: CichiChanMarian ($105.07 in chips) 
Seat 3: Poker9803 ($142.07 in chips) 
Seat 4: TheAveiro ($13.50 in chips) 
Seat 5: Pon4uk.ua ($100 in chips) 
Seat 6: nico1980595 ($131.78 in chips) 
CichiChanMarian: posts small blind $0.50
Poker9803: posts big blind $1
*** HOLE CARDS ***
TheAveiro has timed out
TheAveiro: folds 
Pon4uk.ua: folds 
nico1980595: raises $1 to $2
LuckyShikari: folds 
CichiChanMarian: folds 
Poker9803: calls $1
*** FLOP *** [Ts Qh Td]
Poker9803: checks 
nico1980595: bets $2.85
Poker9803: raises $9.15 to $12
nico1980595: calls $9.15
*** TURN *** [Ts Qh Td] [3s]
Poker9803: bets $27.08
nico1980595: calls $27.08
*** RIVER *** [Ts Qh Td 3s] [Qs]
Poker9803: checks 
nico1980595: checks 
*** SHOW DOWN ***
Poker9803: shows [As Tc] (a full house, Tens full of Queens)
nico1980595: shows [8d Th] (a full house, Tens full of Queens)
Poker9803 collected $40.08 from pot
nico1980595 collected $40.08 from pot
*** SUMMARY ***
Total pot $82.66 | Rake $2.50 
Board [Ts Qh Td 3s Qs]
Seat 1: LuckyShikari (button) folded before Flop (didn't bet)
Seat 2: CichiChanMarian (small blind) folded before Flop
Seat 3: Poker9803 (big blind) showed [As Tc] and won ($40.08) with a full house, Tens full of Queens
Seat 4: TheAveiro folded before Flop (didn't bet)
Seat 5: Pon4uk.ua folded before Flop (didn't bet)
Seat 6: nico1980595 showed [8d Th] and won ($40.08) with a full house, Tens full of Queens



PokerStars Hand #254637656281:  Hold'em No Limit ($0.50/$1.00 USD) - 2025/01/31 15:43:21 WET [2025/01/31 10:43:21 ET]
Table 'Adria' 6-max Seat #2 is the button
Seat 1: LuckyShikari ($100 in chips) 
Seat 2: CichiChanMarian ($104.57 in chips) 
Seat 3: Poker9803 ($141.07 in chips) 
Seat 4: TheAveiro ($13.50 in chips) 
Seat 5: Pon4uk.ua ($100 in chips) 
Seat 6: nico1980595 ($130.78 in chips) 
Poker9803: posts small blind $0.50
TheAveiro: posts big blind $1
*** HOLE CARDS ***
Pon4uk.ua: raises $1 to $2
nico1980595: folds 
LuckyShikari: folds 
CichiChanMarian: raises $5 to $7
Poker9803: folds 
TheAveiro: folds 
Pon4uk.ua: folds 
Uncalled bet ($5) returned to CichiChanMarian
CichiChanMarian collected $5.50 from pot
CichiChanMarian: doesn't show hand 
*** SUMMARY ***
Total pot $5.50 | Rake $0 
Seat 1: LuckyShikari folded before Flop (didn't bet)
Seat 2: CichiChanMarian (button) collected ($5.50)
Seat 3: Poker9803 (small blind) folded before Flop
Seat 4: TheAveiro (big blind) folded before Flop
Seat 5: Pon4uk.ua folded before Flop
Seat 6: nico1980595 folded before Flop (didn't bet)



PokerStars Hand #254637661258:  Hold'em No Limit ($0.50/$1.00 USD) - 2025/01/31 15:43:45 WET [2025/01/31 10:43:45 ET]
Table 'Adria' 6-max Seat #3 is the button
Seat 1: LuckyShikari ($100 in chips) 
Seat 2: CichiChanMarian ($108.07 in chips) 
Seat 3: Poker9803 ($140.57 in chips) 
Seat 4: TheAveiro ($12.50 in chips) 
Seat 5: Pon4uk.ua ($100 in chips) 
Seat 6: nico1980595 ($130.78 in chips) 
TheAveiro: posts small blind $0.50
Pon4uk.ua: posts big blind $1
*** HOLE CARDS ***
nico1980595: raises $1 to $2
LuckyShikari: folds 
CichiChanMarian: folds 
Poker9803: folds 
TheAveiro: folds 
Pon4uk.ua: calls $1
*** FLOP *** [5c 8s Jh]
Pon4uk.ua: checks 
nico1980595: bets $2.85
Pon4uk.ua: folds 
Uncalled bet ($2.85) returned to nico1980595
nico1980595 collected $4.28 from pot
nico1980595: doesn't show hand 
*** SUMMARY ***
Total pot $4.50 | Rake $0.22 
Board [5c 8s Jh]
Seat 1: LuckyShikari folded before Flop (didn't bet)
Seat 2: CichiChanMarian folded before Flop (didn't bet)
Seat 3: Poker9803 (button) folded before Flop (didn't bet)
Seat 4: TheAveiro (small blind) folded before Flop
Seat 5: Pon4uk.ua (big blind) folded on the Flop
Seat 6: nico1980595 collected ($4.28)



PokerStars Hand #254637668208:  Hold'em No Limit ($0.50/$1.00 USD) - 2025/01/31 15:44:18 WET [2025/01/31 10:44:18 ET]
Table 'Adria' 6-max Seat #4 is the button
Seat 1: LuckyShikari ($100 in chips) 
Seat 2: CichiChanMarian ($108.07 in chips) 
Seat 3: Poker9803 ($140.57 in chips) 
Seat 4: TheAveiro ($12 in chips) 
Seat 5: Pon4uk.ua ($100 in chips) 
Seat 6: nico1980595 ($133.06 in chips) 
Pon4uk.ua: posts small blind $0.50
nico1980595: posts big blind $1
*** HOLE CARDS ***
LuckyShikari: folds 
CichiChanMarian: folds 
Poker9803: folds 
TheAveiro: raises $11 to $12 and is all-in
Pon4uk.ua: calls $11.50
nico1980595: raises $20 to $32
Pon4uk.ua: folds 
Uncalled bet ($20) returned to nico1980595
*** FLOP *** [7s 3d Ts]
*** TURN *** [7s 3d Ts] [Ad]
*** RIVER *** [7s 3d Ts Ad] [Jh]
*** SHOW DOWN ***
nico1980595: shows [Ks Qh] (a straight, Ten to Ace)
TheAveiro: shows [9h Kc] (high card Ace)
nico1980595 collected $34.20 from pot
TheAveiro cashed out the hand for $8.70 | Cash Out Fee $0.18
*** SUMMARY ***
Total pot $36 | Rake $1.80 
Board [7s 3d Ts Ad Jh]
Seat 1: LuckyShikari folded before Flop (didn't bet)
Seat 2: CichiChanMarian folded before Flop (didn't bet)
Seat 3: Poker9803 folded before Flop (didn't bet)
Seat 4: TheAveiro (button) showed [9h Kc] and lost with high card Ace (cashed out).
Seat 5: Pon4uk.ua (small blind) folded before Flop
Seat 6: nico1980595 (big blind) showed [Ks Qh] and won ($34.20) with a straight, Ten to Ace



PokerStars Hand #254637679457:  Hold'em No Limit ($0.50/$1.00 USD) - 2025/01/31 15:45:11 WET [2025/01/31 10:45:11 ET]
Table 'Adria' 6-max Seat #5 is the button
Seat 1: LuckyShikari ($100 in chips) 
Seat 2: CichiChanMarian ($108.07 in chips) 
Seat 3: Poker9803 ($140.57 in chips) 
Seat 4: TheAveiro ($10 in chips) 
Seat 5: Pon4uk.ua ($100 in chips) 
Seat 6: nico1980595 ($155.26 in chips) 
nico1980595: posts small blind $0.50
LuckyShikari: posts big blind $1
*** HOLE CARDS ***
CichiChanMarian: folds 
Poker9803: folds 
TheAveiro: folds 
Pon4uk.ua: raises $1.50 to $2.50
nico1980595: folds 
LuckyShikari: folds 
Uncalled bet ($1.50) returned to Pon4uk.ua
Pon4uk.ua collected $2.50 from pot
Pon4uk.ua: doesn't show hand 
*** SUMMARY ***
Total pot $2.50 | Rake $0 
Seat 1: LuckyShikari (big blind) folded before Flop
Seat 2: CichiChanMarian folded before Flop (didn't bet)
Seat 3: Poker9803 folded before Flop (didn't bet)
Seat 4: TheAveiro folded before Flop (didn't bet)
Seat 5: Pon4uk.ua (button) collected ($2.50)
Seat 6: nico1980595 (small blind) folded before Flop



PokerStars Hand #254637685420:  Hold'em No Limit ($0.50/$1.00 USD) - 2025/01/31 15:45:40 WET [2025/01/31 10:45:40 ET]
Table 'Adria' 6-max Seat #6 is the button
Seat 1: LuckyShikari ($100 in chips) 
Seat 2: CichiChanMarian ($108.07 in chips) 
Seat 3: Poker9803 ($140.57 in chips) 
Seat 4: TheAveiro ($10 in chips) 
Seat 5: Pon4uk.ua ($101.50 in chips) 
Seat 6: nico1980595 ($154.76 in chips) 
LuckyShikari: posts small blind $0.50
CichiChanMarian: posts big blind $1
*** HOLE CARDS ***
Poker9803: raises $1 to $2
TheAveiro has timed out
TheAveiro: folds 
Pon4uk.ua: folds 
nico1980595: calls $2
LuckyShikari: folds 
CichiChanMarian: folds 
*** FLOP *** [2h Kc 8h]
Poker9803: bets $1.72
nico1980595: calls $1.72
*** TURN *** [2h Kc 8h] [4c]
Poker9803: bets $12.74
nico1980595: folds 
Uncalled bet ($12.74) returned to Poker9803
Poker9803 collected $8.49 from pot
Poker9803: doesn't show hand 
*** SUMMARY ***
Total pot $8.94 | Rake $0.45 
Board [2h Kc 8h 4c]
Seat 1: LuckyShikari (small blind) folded before Flop
Seat 2: CichiChanMarian (big blind) folded before Flop
Seat 3: Poker9803 collected ($8.49)
Seat 4: TheAveiro folded before Flop (didn't bet)
Seat 5: Pon4uk.ua folded before Flop (didn't bet)
Seat 6: nico1980595 (button) folded on the Turn



PokerStars Hand #254637699635:  Hold'em No Limit ($0.50/$1.00 USD) - 2025/01/31 15:46:46 WET [2025/01/31 10:46:46 ET]
Table 'Adria' 6-max Seat #1 is the button
Seat 1: LuckyShikari ($100 in chips) 
Seat 2: CichiChanMarian ($107.07 in chips) 
Seat 3: Poker9803 ($145.34 in chips) 
Seat 4: TheAveiro ($10 in chips) 
Seat 5: Pon4uk.ua ($101.50 in chips) 
Seat 6: nico1980595 ($151.04 in chips) 
CichiChanMarian: posts small blind $0.50
Poker9803: posts big blind $1
*** HOLE CARDS ***
TheAveiro: raises $9 to $10 and is all-in
Pon4uk.ua: folds 
nico1980595: folds 
LuckyShikari: folds 
CichiChanMarian: folds 
Poker9803: folds 
Uncalled bet ($9) returned to TheAveiro
TheAveiro collected $2.50 from pot
TheAveiro: doesn't show hand 
*** SUMMARY ***
Total pot $2.50 | Rake $0 
Seat 1: LuckyShikari (button) folded before Flop (didn't bet)
Seat 2: CichiChanMarian (small blind) folded before Flop
Seat 3: Poker9803 (big blind) folded before Flop
Seat 4: TheAveiro collected ($2.50)
Seat 5: Pon4uk.ua folded before Flop (didn't bet)
Seat 6: nico1980595 folded before Flop (didn't bet)



PokerStars Hand #254637705591:  Hold'em No Limit ($0.50/$1.00 USD) - 2025/01/31 15:47:14 WET [2025/01/31 10:47:14 ET]
Table 'Adria' 6-max Seat #2 is the button
Seat 4: TheAveiro ($11.50 in chips) is sitting out
Seat 1: LuckyShikari ($100 in chips) 
Seat 2: CichiChanMarian ($106.57 in chips) 
Seat 3: Poker9803 ($144.34 in chips) 
Seat 5: Pon4uk.ua ($101.50 in chips) 
Seat 6: nico1980595 ($151.04 in chips) 
Poker9803: posts small blind $0.50
Pon4uk.ua: posts big blind $1
*** HOLE CARDS ***
nico1980595: raises $1 to $2
LuckyShikari: folds 
CichiChanMarian: raises $5 to $7
Poker9803: folds 
Pon4uk.ua: folds 
nico1980595: calls $5
*** FLOP *** [4d 3h Jh]
nico1980595: checks 
CichiChanMarian: bets $4.86
nico1980595: calls $4.86
*** TURN *** [4d 3h Jh] [3d]
nico1980595: checks 
CichiChanMarian: bets $17.97
nico1980595: folds 
Uncalled bet ($17.97) returned to CichiChanMarian
CichiChanMarian collected $23.96 from pot
CichiChanMarian: doesn't show hand 
TheAveiro leaves the table
*** SUMMARY ***
Total pot $25.22 | Rake $1.26 
Board [4d 3h Jh 3d]
Seat 4: TheAveiro
Seat 1: LuckyShikari folded before Flop (didn't bet)
Seat 2: CichiChanMarian (button) collected ($23.96)
Seat 3: Poker9803 (small blind) folded before Flop
Seat 5: Pon4uk.ua (big blind) folded before Flop
Seat 6: nico1980595 folded on the Turn



PokerStars Hand #254637722483:  Hold'em No Limit ($0.50/$1.00 USD) - 2025/01/31 15:48:34 WET [2025/01/31 10:48:34 ET]
Table 'Adria' 6-max Seat #3 is the button
Seat 1: LuckyShikari ($100 in chips) 
Seat 2: CichiChanMarian ($118.67 in chips) 
Seat 3: Poker9803 ($143.84 in chips) 
Seat 5: Pon4uk.ua ($100.50 in chips) 
Seat 6: nico1980595 ($139.18 in chips) 
Pon4uk.ua: posts small blind $0.50
nico1980595: posts big blind $1
*** HOLE CARDS ***
fedor0f joins the table at seat #4 
LuckyShikari: folds 
CichiChanMarian: folds 
Poker9803: folds 
Pon4uk.ua: folds 
Uncalled bet ($0.50) returned to nico1980595
nico1980595 collected $1 from pot
nico1980595: doesn't show hand 
*** SUMMARY ***
Total pot $1 | Rake $0 
Seat 1: LuckyShikari folded before Flop (didn't bet)
Seat 2: CichiChanMarian folded before Flop (didn't bet)
Seat 3: Poker9803 (button) folded before Flop (didn't bet)
Seat 5: Pon4uk.ua (small blind) folded before Flop
Seat 6: nico1980595 (big blind) collected ($1)



PokerStars Hand #254637728637:  Hold'em No Limit ($0.50/$1.00 USD) - 2025/01/31 15:49:03 WET [2025/01/31 10:49:03 ET]
Table 'Adria' 6-max Seat #5 is the button
Seat 4: fedor0f ($100 in chips) is sitting out
Seat 1: LuckyShikari ($100 in chips) 
Seat 2: CichiChanMarian ($118.67 in chips) 
Seat 3: Poker9803 ($143.84 in chips) 
Seat 5: Pon4uk.ua ($100 in chips) 
Seat 6: nico1980595 ($139.68 in chips) 
nico1980595: posts small blind $0.50
LuckyShikari: posts big blind $1
fedor0f: sits out 
*** HOLE CARDS ***
CichiChanMarian: raises $1.50 to $2.50
Poker9803: folds 
Pon4uk.ua: folds 
nico1980595: folds 
LuckyShikari: folds 
Uncalled bet ($1.50) returned to CichiChanMarian
CichiChanMarian collected $2.50 from pot
CichiChanMarian: doesn't show hand 
*** SUMMARY ***
Total pot $2.50 | Rake $0 
Seat 4: fedor0f
Seat 1: LuckyShikari (big blind) folded before Flop
Seat 2: CichiChanMarian collected ($2.50)
Seat 3: Poker9803 folded before Flop (didn't bet)
Seat 5: Pon4uk.ua (button) folded before Flop (didn't bet)
Seat 6: nico1980595 (small blind) folded before Flop



PokerStars Hand #254637734496:  Hold'em No Limit ($0.50/$1.00 USD) - 2025/01/31 15:49:30 WET [2025/01/31 10:49:30 ET]
Table 'Adria' 6-max Seat #6 is the button
Seat 4: fedor0f ($100 in chips) is sitting out
Seat 1: LuckyShikari ($100 in chips) 
Seat 2: CichiChanMarian ($120.17 in chips) 
Seat 3: Poker9803 ($143.84 in chips) 
Seat 5: Pon4uk.ua ($100 in chips) 
Seat 6: nico1980595 ($139.18 in chips) 
LuckyShikari: posts small blind $0.50
CichiChanMarian: posts big blind $1
fedor0f: sits out 
*** HOLE CARDS ***
Poker9803: folds 
Pon4uk.ua: folds 
nico1980595: folds 
LuckyShikari: raises $1.50 to $2.50
CichiChanMarian: calls $1.50
*** FLOP *** [9c Kc Ts]
LuckyShikari: checks 
CichiChanMarian: checks 
*** TURN *** [9c Kc Ts] [9s]
LuckyShikari: checks 
CichiChanMarian: checks 
*** RIVER *** [9c Kc Ts 9s] [7c]
LuckyShikari: bets $3.50
CichiChanMarian: raises $8.81 to $12.31
LuckyShikari: folds 
Uncalled bet ($8.81) returned to CichiChanMarian
CichiChanMarian collected $11.40 from pot
CichiChanMarian: doesn't show hand 
*** SUMMARY ***
Total pot $12 | Rake $0.60 
Board [9c Kc Ts 9s 7c]
Seat 4: fedor0f
Seat 1: LuckyShikari (small blind) folded on the River
Seat 2: CichiChanMarian (big blind) collected ($11.40)
Seat 3: Poker9803 folded before Flop (didn't bet)
Seat 5: Pon4uk.ua folded before Flop (didn't bet)
Seat 6: nico1980595 (button) folded before Flop (didn't bet)



PokerStars Hand #254637746000:  Hold'em No Limit ($0.50/$1.00 USD) - 2025/01/31 15:50:24 WET [2025/01/31 10:50:24 ET]
Table 'Adria' 6-max Seat #1 is the button
Seat 4: fedor0f ($100 in chips) is sitting out
Seat 1: LuckyShikari ($100 in chips) 
Seat 2: CichiChanMarian ($125.57 in chips) 
Seat 3: Poker9803 ($143.84 in chips) 
Seat 5: Pon4uk.ua ($100 in chips) 
Seat 6: nico1980595 ($139.18 in chips) 
CichiChanMarian: posts small blind $0.50
Poker9803: posts big blind $1
fedor0f: sits out 
*** HOLE CARDS ***
Pon4uk.ua: folds 
nico1980595: raises $1 to $2
LuckyShikari: folds 
CichiChanMarian: folds 
Poker9803: calls $1
*** FLOP *** [Ks 5d 6s]
Poker9803: checks 
nico1980595: bets $3
Poker9803: raises $12 to $15
nico1980595: folds 
Uncalled bet ($12) returned to Poker9803
Poker9803 collected $9.98 from pot
Poker9803: doesn't show hand 
*** SUMMARY ***
Total pot $10.50 | Rake $0.52 
Board [Ks 5d 6s]
Seat 4: fedor0f
Seat 1: LuckyShikari (button) folded before Flop (didn't bet)
Seat 2: CichiChanMarian (small blind) folded before Flop
Seat 3: Poker9803 (big blind) collected ($9.98)
Seat 5: Pon4uk.ua folded before Flop (didn't bet)
Seat 6: nico1980595 folded on the Flop



PokerStars Hand #254637757469:  Hold'em No Limit ($0.50/$1.00 USD) - 2025/01/31 15:51:18 WET [2025/01/31 10:51:18 ET]
Table 'Adria' 6-max Seat #2 is the button
Seat 1: LuckyShikari ($100 in chips) 
Seat 2: CichiChanMarian ($125.07 in chips) 
Seat 3: Poker9803 ($148.82 in chips) 
Seat 4: fedor0f ($100 in chips) 
Seat 5: Pon4uk.ua ($100 in chips) 
Seat 6: nico1980595 ($134.18 in chips) 
Poker9803: posts small blind $0.50
fedor0f: posts big blind $1
*** HOLE CARDS ***
Pon4uk.ua: raises $1 to $2
nico1980595: folds 
LuckyShikari: folds 
CichiChanMarian: folds 
Poker9803: folds 
fedor0f: calls $1
*** FLOP *** [Kc 5d Js]
fedor0f: checks 
Pon4uk.ua: checks 
*** TURN *** [Kc 5d Js] [Ks]
fedor0f: bets $1.28
Pon4uk.ua: calls $1.28
*** RIVER *** [Kc 5d Js Ks] [Ac]
fedor0f: checks 
Pon4uk.ua: checks 
*** SHOW DOWN ***
fedor0f: shows [4c 6c] (a pair of Kings)
Pon4uk.ua: shows [9s 9d] (two pair, Kings and Nines)
Pon4uk.ua collected $6.71 from pot
*** SUMMARY ***
Total pot $7.06 | Rake $0.35 
Board [Kc 5d Js Ks Ac]
Seat 1: LuckyShikari folded before Flop (didn't bet)
Seat 2: CichiChanMarian (button) folded before Flop (didn't bet)
Seat 3: Poker9803 (small blind) folded before Flop
Seat 4: fedor0f (big blind) showed [4c 6c] and lost with a pair of Kings
Seat 5: Pon4uk.ua showed [9s 9d] and won ($6.71) with two pair, Kings and Nines
Seat 6: nico1980595 folded before Flop (didn't bet)



PokerStars Hand #254637765464:  Hold'em No Limit ($0.50/$1.00 USD) - 2025/01/31 15:51:56 WET [2025/01/31 10:51:56 ET]
Table 'Adria' 6-max Seat #3 is the button
Seat 1: LuckyShikari ($100 in chips) 
Seat 2: CichiChanMarian ($125.07 in chips) 
Seat 3: Poker9803 ($148.32 in chips) 
Seat 4: fedor0f ($100 in chips) 
Seat 5: Pon4uk.ua ($103.43 in chips) 
Seat 6: nico1980595 ($134.18 in chips) 
fedor0f: posts small blind $0.50
Pon4uk.ua: posts big blind $1
*** HOLE CARDS ***
nico1980595: raises $1 to $2
LuckyShikari: raises $5.50 to $7.50
CichiChanMarian: folds 
Poker9803: folds 
fedor0f: folds 
Pon4uk.ua: folds 
nico1980595: folds 
Uncalled bet ($5.50) returned to LuckyShikari
LuckyShikari collected $5.50 from pot
LuckyShikari: doesn't show hand 
*** SUMMARY ***
Total pot $5.50 | Rake $0 
Seat 1: LuckyShikari collected ($5.50)
Seat 2: CichiChanMarian folded before Flop (didn't bet)
Seat 3: Poker9803 (button) folded before Flop (didn't bet)
Seat 4: fedor0f (small blind) folded before Flop
Seat 5: Pon4uk.ua (big blind) folded before Flop
Seat 6: nico1980595 folded before Flop



PokerStars Hand #254637769748:  Hold'em No Limit ($0.50/$1.00 USD) - 2025/01/31 15:52:16 WET [2025/01/31 10:52:16 ET]
Table 'Adria' 6-max Seat #4 is the button
Seat 1: LuckyShikari ($103.50 in chips) 
Seat 2: CichiChanMarian ($125.07 in chips) 
Seat 3: Poker9803 ($148.32 in chips) 
Seat 4: fedor0f ($100 in chips) 
Seat 5: Pon4uk.ua ($102.43 in chips) 
Seat 6: nico1980595 ($132.18 in chips) 
Pon4uk.ua: posts small blind $0.50
nico1980595: posts big blind $1
*** HOLE CARDS ***
LuckyShikari: folds 
CichiChanMarian: folds 
Poker9803: folds 
fedor0f: folds 
Pon4uk.ua: raises $1.75 to $2.75
nico1980595: calls $1.75
*** FLOP *** [5c Jc 3s]
Pon4uk.ua: bets $2.61
nico1980595: folds 
Uncalled bet ($2.61) returned to Pon4uk.ua
Pon4uk.ua collected $5.22 from pot
Pon4uk.ua: doesn't show hand 
*** SUMMARY ***
Total pot $5.50 | Rake $0.28 
Board [5c Jc 3s]
Seat 1: LuckyShikari folded before Flop (didn't bet)
Seat 2: CichiChanMarian folded before Flop (didn't bet)
Seat 3: Poker9803 folded before Flop (didn't bet)
Seat 4: fedor0f (button) folded before Flop (didn't bet)
Seat 5: Pon4uk.ua (small blind) collected ($5.22)
Seat 6: nico1980595 (big blind) folded on the Flop



PokerStars Hand #254637779873:  Hold'em No Limit ($0.50/$1.00 USD) - 2025/01/31 15:53:04 WET [2025/01/31 10:53:04 ET]
Table 'Adria' 6-max Seat #5 is the button
Seat 1: LuckyShikari ($103.50 in chips) 
Seat 2: CichiChanMarian ($125.07 in chips) 
Seat 3: Poker9803 ($148.32 in chips) 
Seat 4: fedor0f ($100 in chips) 
Seat 5: Pon4uk.ua ($104.90 in chips) 
Seat 6: nico1980595 ($129.43 in chips) 
nico1980595: posts small blind $0.50
LuckyShikari: posts big blind $1
*** HOLE CARDS ***
CichiChanMarian: folds 
Poker9803: raises $1.50 to $2.50
fedor0f: folds 
Pon4uk.ua: folds 
nico1980595: folds 
LuckyShikari: folds 
Uncalled bet ($1.50) returned to Poker9803
Poker9803 collected $2.50 from pot
Poker9803: doesn't show hand 
*** SUMMARY ***
Total pot $2.50 | Rake $0 
Seat 1: LuckyShikari (big blind) folded before Flop
Seat 2: CichiChanMarian folded before Flop (didn't bet)
Seat 3: Poker9803 collected ($2.50)
Seat 4: fedor0f folded before Flop (didn't bet)
Seat 5: Pon4uk.ua (button) folded before Flop (didn't bet)
Seat 6: nico1980595 (small blind) folded before Flop



PokerStars Hand #254637785438:  Hold'em No Limit ($0.50/$1.00 USD) - 2025/01/31 15:53:30 WET [2025/01/31 10:53:30 ET]
Table 'Adria' 6-max Seat #6 is the button
Seat 1: LuckyShikari ($102.50 in chips) 
Seat 2: CichiChanMarian ($125.07 in chips) 
Seat 3: Poker9803 ($149.82 in chips) 
Seat 4: fedor0f ($100 in chips) 
Seat 5: Pon4uk.ua ($104.90 in chips) 
Seat 6: nico1980595 ($128.93 in chips) 
LuckyShikari: posts small blind $0.50
CichiChanMarian: posts big blind $1
*** HOLE CARDS ***
Poker9803: folds 
fedor0f: folds 
Pon4uk.ua: folds 
nico1980595: raises $1 to $2
LuckyShikari: calls $1.50
CichiChanMarian: folds 
*** FLOP *** [5d 8s Th]
LuckyShikari: checks 
nico1980595: checks 
*** TURN *** [5d 8s Th] [Jd]
LuckyShikari: bets $6.50
nico1980595: folds 
Uncalled bet ($6.50) returned to LuckyShikari
LuckyShikari collected $4.75 from pot
LuckyShikari: doesn't show hand 
*** SUMMARY ***
Total pot $5 | Rake $0.25 
Board [5d 8s Th Jd]
Seat 1: LuckyShikari (small blind) collected ($4.75)
Seat 2: CichiChanMarian (big blind) folded before Flop
Seat 3: Poker9803 folded before Flop (didn't bet)
Seat 4: fedor0f folded before Flop (didn't bet)
Seat 5: Pon4uk.ua folded before Flop (didn't bet)
Seat 6: nico1980595 (button) folded on the Turn



PokerStars Hand #254637795352:  Hold'em No Limit ($0.50/$1.00 USD) - 2025/01/31 15:54:17 WET [2025/01/31 10:54:17 ET]
Table 'Adria' 6-max Seat #1 is the button
Seat 1: LuckyShikari ($105.25 in chips) 
Seat 2: CichiChanMarian ($124.07 in chips) 
Seat 3: Poker9803 ($149.82 in chips) 
Seat 4: fedor0f ($100 in chips) 
Seat 5: Pon4uk.ua ($104.90 in chips) 
Seat 6: nico1980595 ($126.93 in chips) 
CichiChanMarian: posts small blind $0.50
Poker9803: posts big blind $1
*** HOLE CARDS ***
fedor0f: folds 
Pon4uk.ua: raises $1 to $2
nico1980595: calls $2
LuckyShikari: calls $2
CichiChanMarian: folds 
Poker9803: calls $1
*** FLOP *** [5s 5d 9d]
Poker9803: checks 
Pon4uk.ua: bets $4.04
nico1980595: folds 
LuckyShikari: folds 
Poker9803: folds 
Uncalled bet ($4.04) returned to Pon4uk.ua
Pon4uk.ua collected $8.08 from pot
Pon4uk.ua: doesn't show hand 
*** SUMMARY ***
Total pot $8.50 | Rake $0.42 
Board [5s 5d 9d]
Seat 1: LuckyShikari (button) folded on the Flop
Seat 2: CichiChanMarian (small blind) folded before Flop
Seat 3: Poker9803 (big blind) folded on the Flop
Seat 4: fedor0f folded before Flop (didn't bet)
Seat 5: Pon4uk.ua collected ($8.08)
Seat 6: nico1980595 folded on the Flop



PokerStars Hand #254637804573:  Hold'em No Limit ($0.50/$1.00 USD) - 2025/01/31 15:55:00 WET [2025/01/31 10:55:00 ET]
Table 'Adria' 6-max Seat #2 is the button
Seat 1: LuckyShikari ($103.25 in chips) 
Seat 2: CichiChanMarian ($123.57 in chips) 
Seat 3: Poker9803 ($147.82 in chips) 
Seat 4: fedor0f ($100 in chips) 
Seat 5: Pon4uk.ua ($110.98 in chips) 
Seat 6: nico1980595 ($124.93 in chips) 
Poker9803: posts small blind $0.50
fedor0f: posts big blind $1
*** HOLE CARDS ***
Pon4uk.ua: folds 
nico1980595: folds 
LuckyShikari: folds 
CichiChanMarian: folds 
Poker9803: folds 
Uncalled bet ($0.50) returned to fedor0f
fedor0f collected $1 from pot
fedor0f: doesn't show hand 
*** SUMMARY ***
Total pot $1 | Rake $0 
Seat 1: LuckyShikari folded before Flop (didn't bet)
Seat 2: CichiChanMarian (button) folded before Flop (didn't bet)
Seat 3: Poker9803 (small blind) folded before Flop
Seat 4: fedor0f (big blind) collected ($1)
Seat 5: Pon4uk.ua folded before Flop (didn't bet)
Seat 6: nico1980595 folded before Flop (didn't bet)



PokerStars Hand #254637807332:  Hold'em No Limit ($0.50/$1.00 USD) - 2025/01/31 15:55:13 WET [2025/01/31 10:55:13 ET]
Table 'Adria' 6-max Seat #3 is the button
Seat 1: LuckyShikari ($103.25 in chips) 
Seat 2: CichiChanMarian ($123.57 in chips) 
Seat 3: Poker9803 ($147.32 in chips) 
Seat 4: fedor0f ($100.50 in chips) 
Seat 5: Pon4uk.ua ($110.98 in chips) 
Seat 6: nico1980595 ($124.93 in chips) 
fedor0f: posts small blind $0.50
Pon4uk.ua: posts big blind $1
*** HOLE CARDS ***
nico1980595: raises $1 to $2
LuckyShikari: folds 
CichiChanMarian: folds 
Poker9803: folds 
fedor0f: raises $6 to $8
Pon4uk.ua: folds 
nico1980595: calls $6
*** FLOP *** [Qc 6h 7h]
fedor0f: checks 
nico1980595: bets $8
fedor0f: calls $8
*** TURN *** [Qc 6h 7h] [Tc]
fedor0f: checks 
nico1980595: checks 
*** RIVER *** [Qc 6h 7h Tc] [4h]
fedor0f: checks 
nico1980595: checks 
*** SHOW DOWN ***
fedor0f: shows [9s 9d] (a pair of Nines)
nico1980595: mucks hand 
fedor0f collected $31.35 from pot
*** SUMMARY ***
Total pot $33 | Rake $1.65 
Board [Qc 6h 7h Tc 4h]
Seat 1: LuckyShikari folded before Flop (didn't bet)
Seat 2: CichiChanMarian folded before Flop (didn't bet)
Seat 3: Poker9803 (button) folded before Flop (didn't bet)
Seat 4: fedor0f (small blind) showed [9s 9d] and won ($31.35) with a pair of Nines
Seat 5: Pon4uk.ua (big blind) folded before Flop
Seat 6: nico1980595 mucked



PokerStars Hand #254637823530:  Hold'em No Limit ($0.50/$1.00 USD) - 2025/01/31 15:56:53 WET [2025/01/31 10:56:53 ET]
Table 'Adria' 6-max Seat #4 is the button
Seat 1: LuckyShikari ($103.25 in chips) 
Seat 2: CichiChanMarian ($123.57 in chips) 
Seat 3: Poker9803 ($147.32 in chips) 
Seat 4: fedor0f ($115.85 in chips) 
Seat 5: Pon4uk.ua ($109.98 in chips) 
Seat 6: nico1980595 ($108.93 in chips) 
Pon4uk.ua: posts small blind $0.50
nico1980595: posts big blind $1
*** HOLE CARDS ***
LuckyShikari: folds 
CichiChanMarian: folds 
Poker9803: folds 
fedor0f: folds 
Pon4uk.ua: folds 
Uncalled bet ($0.50) returned to nico1980595
nico1980595 collected $1 from pot
nico1980595: doesn't show hand 
*** SUMMARY ***
Total pot $1 | Rake $0 
Seat 1: LuckyShikari folded before Flop (didn't bet)
Seat 2: CichiChanMarian folded before Flop (didn't bet)
Seat 3: Poker9803 folded before Flop (didn't bet)
Seat 4: fedor0f (button) folded before Flop (didn't bet)
Seat 5: Pon4uk.ua (small blind) folded before Flop
Seat 6: nico1980595 (big blind) collected ($1)



PokerStars Hand #254637825800:  Hold'em No Limit ($0.50/$1.00 USD) - 2025/01/31 15:57:07 WET [2025/01/31 10:57:07 ET]
Table 'Adria' 6-max Seat #5 is the button
Seat 1: LuckyShikari ($103.25 in chips) 
Seat 2: CichiChanMarian ($123.57 in chips) 
Seat 3: Poker9803 ($147.32 in chips) 
Seat 4: fedor0f ($115.85 in chips) 
Seat 5: Pon4uk.ua ($109.48 in chips) 
Seat 6: nico1980595 ($109.43 in chips) 
nico1980595: posts small blind $0.50
LuckyShikari: posts big blind $1
*** HOLE CARDS ***
CichiChanMarian: folds 
Poker9803: raises $1.50 to $2.50
fedor0f: folds 
Pon4uk.ua: folds 
nico1980595: calls $2
LuckyShikari: calls $1.50
*** FLOP *** [3c 6c Jh]
nico1980595: checks 
LuckyShikari: checks 
Poker9803: bets $2.35
nico1980595: calls $2.35
LuckyShikari: raises $8.15 to $10.50
Poker9803: calls $8.15
nico1980595: folds 
*** TURN *** [3c 6c Jh] [5s]
LuckyShikari: bets $22
Poker9803: folds 
Uncalled bet ($22) returned to LuckyShikari
LuckyShikari collected $29.31 from pot
LuckyShikari: doesn't show hand 
*** SUMMARY ***
Total pot $30.85 | Rake $1.54 
Board [3c 6c Jh 5s]
Seat 1: LuckyShikari (big blind) collected ($29.31)
Seat 2: CichiChanMarian folded before Flop (didn't bet)
Seat 3: Poker9803 folded on the Turn
Seat 4: fedor0f folded before Flop (didn't bet)
Seat 5: Pon4uk.ua (button) folded before Flop (didn't bet)
Seat 6: nico1980595 (small blind) folded on the Flop



PokerStars Hand #254637838306:  Hold'em No Limit ($0.50/$1.00 USD) - 2025/01/31 15:58:26 WET [2025/01/31 10:58:26 ET]
Table 'Adria' 6-max Seat #6 is the button
Seat 1: LuckyShikari ($119.56 in chips) 
Seat 2: CichiChanMarian ($123.57 in chips) 
Seat 3: Poker9803 ($134.32 in chips) 
Seat 4: fedor0f ($115.85 in chips) 
Seat 5: Pon4uk.ua ($109.48 in chips) 
Seat 6: nico1980595 ($104.58 in chips) 
LuckyShikari: posts small blind $0.50
CichiChanMarian: posts big blind $1
*** HOLE CARDS ***
Poker9803: raises $1.50 to $2.50
fedor0f: folds 
Pon4uk.ua: raises $5 to $7.50
nico1980595: folds 
LuckyShikari: folds 
CichiChanMarian: folds 
Poker9803: raises $12.75 to $20.25
Pon4uk.ua: calls $12.75
*** FLOP *** [Jh 3c 8c]
Poker9803: bets $9.97
Pon4uk.ua: calls $9.97
*** TURN *** [Jh 3c 8c] [Ad]
Poker9803: bets $19.62
Pon4uk.ua: folds 
Uncalled bet ($19.62) returned to Poker9803
Poker9803 collected $59.44 from pot
Poker9803: doesn't show hand 
*** SUMMARY ***
Total pot $61.94 | Rake $2.50 
Board [Jh 3c 8c Ad]
Seat 1: LuckyShikari (small blind) folded before Flop
Seat 2: CichiChanMarian (big blind) folded before Flop
Seat 3: Poker9803 collected ($59.44)
Seat 4: fedor0f folded before Flop (didn't bet)
Seat 5: Pon4uk.ua folded on the Turn
Seat 6: nico1980595 (button) folded before Flop (didn't bet)



PokerStars Hand #254637849400:  Hold'em No Limit ($0.50/$1.00 USD) - 2025/01/31 15:59:35 WET [2025/01/31 10:59:35 ET]
Table 'Adria' 6-max Seat #1 is the button
Seat 1: LuckyShikari ($119.06 in chips) 
Seat 2: CichiChanMarian ($122.57 in chips) 
Seat 3: Poker9803 ($163.54 in chips) 
Seat 4: fedor0f ($115.85 in chips) 
Seat 5: Pon4uk.ua ($100 in chips) 
Seat 6: nico1980595 ($104.58 in chips) 
CichiChanMarian: posts small blind $0.50
Poker9803: posts big blind $1
*** HOLE CARDS ***
fedor0f: folds 
Pon4uk.ua: folds 
nico1980595: folds 
LuckyShikari: folds 
CichiChanMarian: raises $2 to $3
Poker9803: folds 
Uncalled bet ($2) returned to CichiChanMarian
CichiChanMarian collected $2 from pot
CichiChanMarian: doesn't show hand 
*** SUMMARY ***
Total pot $2 | Rake $0 
Seat 1: LuckyShikari (button) folded before Flop (didn't bet)
Seat 2: CichiChanMarian (small blind) collected ($2)
Seat 3: Poker9803 (big blind) folded before Flop
Seat 4: fedor0f folded before Flop (didn't bet)
Seat 5: Pon4uk.ua folded before Flop (didn't bet)
Seat 6: nico1980595 folded before Flop (didn't bet)



PokerStars Hand #254637854333:  Hold'em No Limit ($0.50/$1.00 USD) - 2025/01/31 16:00:05 WET [2025/01/31 11:00:05 ET]
Table 'Adria' 6-max Seat #2 is the button
Seat 1: LuckyShikari ($119.06 in chips) 
Seat 2: CichiChanMarian ($123.57 in chips) 
Seat 3: Poker9803 ($162.54 in chips) 
Seat 4: fedor0f ($115.85 in chips) 
Seat 5: Pon4uk.ua ($100 in chips) 
Seat 6: nico1980595 ($104.58 in chips) 
Poker9803: posts small blind $0.50
fedor0f: posts big blind $1
*** HOLE CARDS ***
Pon4uk.ua: folds 
nico1980595: folds 
LuckyShikari: folds 
CichiChanMarian: folds 
Pon4uk.ua leaves the table
Poker9803: folds 
Uncalled bet ($0.50) returned to fedor0f
fedor0f collected $1 from pot
fedor0f: doesn't show hand 
*** SUMMARY ***
Total pot $1 | Rake $0 
Seat 1: LuckyShikari folded before Flop (didn't bet)
Seat 2: CichiChanMarian (button) folded before Flop (didn't bet)
Seat 3: Poker9803 (small blind) folded before Flop
Seat 4: fedor0f (big blind) collected ($1)
Seat 5: Pon4uk.ua folded before Flop (didn't bet)
Seat 6: nico1980595 folded before Flop (didn't bet)



PokerStars Hand #254637858247:  Hold'em No Limit ($0.50/$1.00 USD) - 2025/01/31 16:00:29 WET [2025/01/31 11:00:29 ET]
Table 'Adria' 6-max Seat #3 is the button
Seat 1: LuckyShikari ($119.06 in chips) 
Seat 2: CichiChanMarian ($123.57 in chips) 
Seat 3: Poker9803 ($162.04 in chips) 
Seat 4: fedor0f ($116.35 in chips) 
Seat 6: nico1980595 ($104.58 in chips) 
fedor0f: posts small blind $0.50
nico1980595: posts big blind $1
*** HOLE CARDS ***
LuckyShikari: raises $1 to $2
CichiChanMarian: raises $5 to $7
Poker9803: folds 
fedor0f: folds 
nico1980595: folds 
LuckyShikari: folds 
Uncalled bet ($5) returned to CichiChanMarian
CichiChanMarian collected $5.50 from pot
CichiChanMarian: doesn't show hand 
*** SUMMARY ***
Total pot $5.50 | Rake $0 
Seat 1: LuckyShikari folded before Flop
Seat 2: CichiChanMarian collected ($5.50)
Seat 3: Poker9803 (button) folded before Flop (didn't bet)
Seat 4: fedor0f (small blind) folded before Flop
Seat 6: nico1980595 (big blind) folded before Flop



PokerStars Hand #254637861421:  Hold'em No Limit ($0.50/$1.00 USD) - 2025/01/31 16:00:46 WET [2025/01/31 11:00:46 ET]
Table 'Adria' 6-max Seat #4 is the button
Seat 1: LuckyShikari ($117.06 in chips) 
Seat 2: CichiChanMarian ($127.07 in chips) 
Seat 3: Poker9803 ($162.04 in chips) 
Seat 4: fedor0f ($115.85 in chips) 
Seat 6: nico1980595 ($103.58 in chips) 
nico1980595: posts small blind $0.50
LuckyShikari: posts big blind $1
*** HOLE CARDS ***
CichiChanMarian: folds 
Poker9803: folds 
fedor0f: folds 
nico1980595: raises $1 to $2
LuckyShikari: calls $1
*** FLOP *** [9c 5d Tc]
nico1980595: checks 
LuckyShikari: checks 
*** TURN *** [9c 5d Tc] [Qh]
nico1980595: checks 
LuckyShikari: checks 
*** RIVER *** [9c 5d Tc Qh] [6s]
nico1980595: checks 
LuckyShikari: checks 
*** SHOW DOWN ***
nico1980595: shows [6h As] (a pair of Sixes)
LuckyShikari: mucks hand 
nico1980595 collected $3.80 from pot
*** SUMMARY ***
Total pot $4 | Rake $0.20 
Board [9c 5d Tc Qh 6s]
Seat 1: LuckyShikari (big blind) mucked
Seat 2: CichiChanMarian folded before Flop (didn't bet)
Seat 3: Poker9803 folded before Flop (didn't bet)
Seat 4: fedor0f (button) folded before Flop (didn't bet)
Seat 6: nico1980595 (small blind) showed [6h As] and won ($3.80) with a pair of Sixes



PokerStars Hand #254637866149:  Hold'em No Limit ($0.50/$1.00 USD) - 2025/01/31 16:01:11 WET [2025/01/31 11:01:11 ET]
Table 'Adria' 6-max Seat #6 is the button
Seat 1: LuckyShikari ($115.06 in chips) 
Seat 2: CichiChanMarian ($127.07 in chips) 
Seat 3: Poker9803 ($162.04 in chips) 
Seat 4: fedor0f ($115.85 in chips) 
Seat 6: nico1980595 ($105.38 in chips) 
LuckyShikari: posts small blind $0.50
CichiChanMarian: posts big blind $1
*** HOLE CARDS ***
Poker9803: folds 
fedor0f: folds 
nico1980595: folds 
LuckyShikari: calls $0.50
CichiChanMarian: checks 
*** FLOP *** [8h 2d 2h]
LuckyShikari: checks 
CichiChanMarian: bets $1
LuckyShikari: raises $2.50 to $3.50
CichiChanMarian: calls $2.50
*** TURN *** [8h 2d 2h] [Jh]
LuckyShikari: checks 
reiyser joins the table at seat #5 
CichiChanMarian: bets $2.82
LuckyShikari: calls $2.82
*** RIVER *** [8h 2d 2h Jh] [8c]
LuckyShikari: checks 
CichiChanMarian: bets $27.82
LuckyShikari: folds 
Uncalled bet ($27.82) returned to CichiChanMarian
CichiChanMarian collected $13.91 from pot
CichiChanMarian: doesn't show hand 
*** SUMMARY ***
Total pot $14.64 | Rake $0.73 
Board [8h 2d 2h Jh 8c]
Seat 1: LuckyShikari (small blind) folded on the River
Seat 2: CichiChanMarian (big blind) collected ($13.91)
Seat 3: Poker9803 folded before Flop (didn't bet)
Seat 4: fedor0f folded before Flop (didn't bet)
Seat 6: nico1980595 (button) folded before Flop (didn't bet)



PokerStars Hand #254637874851:  Hold'em No Limit ($0.50/$1.00 USD) - 2025/01/31 16:01:54 WET [2025/01/31 11:01:54 ET]
Table 'Adria' 6-max Seat #1 is the button
Seat 5: reiyser ($100 in chips) is sitting out
Seat 1: LuckyShikari ($107.74 in chips) 
Seat 2: CichiChanMarian ($133.66 in chips) 
Seat 3: Poker9803 ($162.04 in chips) 
Seat 4: fedor0f ($115.85 in chips) 
Seat 6: nico1980595 ($105.38 in chips) 
CichiChanMarian: posts small blind $0.50
Poker9803: posts big blind $1
reiyser: sits out 
*** HOLE CARDS ***
fedor0f: folds 
nico1980595: folds 
LuckyShikari: folds 
CichiChanMarian: raises $2 to $3
Poker9803: folds 
Uncalled bet ($2) returned to CichiChanMarian
CichiChanMarian collected $2 from pot
CichiChanMarian: doesn't show hand 
*** SUMMARY ***
Total pot $2 | Rake $0 
Seat 5: reiyser
Seat 1: LuckyShikari (button) folded before Flop (didn't bet)
Seat 2: CichiChanMarian (small blind) collected ($2)
Seat 3: Poker9803 (big blind) folded before Flop
Seat 4: fedor0f folded before Flop (didn't bet)
Seat 6: nico1980595 folded before Flop (didn't bet)



PokerStars Hand #254637879718:  Hold'em No Limit ($0.50/$1.00 USD) - 2025/01/31 16:02:17 WET [2025/01/31 11:02:17 ET]
Table 'Adria' 6-max Seat #2 is the button
Seat 5: reiyser ($100 in chips) is sitting out
Seat 1: LuckyShikari ($107.74 in chips) 
Seat 2: CichiChanMarian ($134.66 in chips) 
Seat 3: Poker9803 ($161.04 in chips) 
Seat 4: fedor0f ($115.85 in chips) 
Seat 6: nico1980595 ($105.38 in chips) 
Poker9803: posts small blind $0.50
fedor0f: posts big blind $1
reiyser: sits out 
*** HOLE CARDS ***
nico1980595: folds 
LuckyShikari: raises $1 to $2
CichiChanMarian: folds 
Poker9803: folds 
fedor0f: folds 
Uncalled bet ($1) returned to LuckyShikari
LuckyShikari collected $2.50 from pot
LuckyShikari: doesn't show hand 
*** SUMMARY ***
Total pot $2.50 | Rake $0 
Seat 5: reiyser
Seat 1: LuckyShikari collected ($2.50)
Seat 2: CichiChanMarian (button) folded before Flop (didn't bet)
Seat 3: Poker9803 (small blind) folded before Flop
Seat 4: fedor0f (big blind) folded before Flop
Seat 6: nico1980595 folded before Flop (didn't bet)



PokerStars Hand #254637882119:  Hold'em No Limit ($0.50/$1.00 USD) - 2025/01/31 16:02:29 WET [2025/01/31 11:02:29 ET]
Table 'Adria' 6-max Seat #3 is the button
Seat 1: LuckyShikari ($109.24 in chips) 
Seat 2: CichiChanMarian ($134.66 in chips) 
Seat 3: Poker9803 ($160.54 in chips) 
Seat 4: fedor0f ($114.85 in chips) 
Seat 5: reiyser ($100 in chips) 
Seat 6: nico1980595 ($105.38 in chips) 
fedor0f: posts small blind $0.50
reiyser: posts big blind $1
*** HOLE CARDS ***
nico1980595: raises $1 to $2
LuckyShikari: folds 
CichiChanMarian: folds 
Poker9803: folds 
fedor0f: folds 
reiyser: folds 
Uncalled bet ($1) returned to nico1980595
nico1980595 collected $2.50 from pot
nico1980595: doesn't show hand 
*** SUMMARY ***
Total pot $2.50 | Rake $0 
Seat 1: LuckyShikari folded before Flop (didn't bet)
Seat 2: CichiChanMarian folded before Flop (didn't bet)
Seat 3: Poker9803 (button) folded before Flop (didn't bet)
Seat 4: fedor0f (small blind) folded before Flop
Seat 5: reiyser (big blind) folded before Flop
Seat 6: nico1980595 collected ($2.50)



PokerStars Hand #254637887967:  Hold'em No Limit ($0.50/$1.00 USD) - 2025/01/31 16:02:56 WET [2025/01/31 11:02:56 ET]
Table 'Adria' 6-max Seat #4 is the button
Seat 1: LuckyShikari ($109.24 in chips) 
Seat 2: CichiChanMarian ($134.66 in chips) 
Seat 3: Poker9803 ($160.54 in chips) 
Seat 4: fedor0f ($114.35 in chips) 
Seat 5: reiyser ($100 in chips) 
Seat 6: nico1980595 ($106.88 in chips) 
reiyser: posts small blind $0.50
nico1980595: posts big blind $1
*** HOLE CARDS ***
LuckyShikari: folds 
CichiChanMarian: raises $1.50 to $2.50
Poker9803: folds 
fedor0f: folds 
reiyser: folds 
nico1980595: raises $4.50 to $7
CichiChanMarian: raises $13 to $20
nico1980595: calls $13
*** FLOP *** [Kc Tc Jh]
nico1980595: checks 
CichiChanMarian: bets $9.62
nico1980595: raises $16.38 to $26
CichiChanMarian: calls $16.38
*** TURN *** [Kc Tc Jh] [Kh]
nico1980595: bets $60.88 and is all-in
CichiChanMarian: calls $60.88
*** RIVER *** [Kc Tc Jh Kh] [7c]
*** SHOW DOWN ***
nico1980595: shows [8s 8h] (two pair, Kings and Eights)
CichiChanMarian: shows [Ah Qh] (a straight, Ten to Ace)
CichiChanMarian collected $211.76 from pot
*** SUMMARY ***
Total pot $214.26 | Rake $2.50 
Board [Kc Tc Jh Kh 7c]
Seat 1: LuckyShikari folded before Flop (didn't bet)
Seat 2: CichiChanMarian showed [Ah Qh] and won ($211.76) with a straight, Ten to Ace
Seat 3: Poker9803 folded before Flop (didn't bet)
Seat 4: fedor0f (button) folded before Flop (didn't bet)
Seat 5: reiyser (small blind) folded before Flop
Seat 6: nico1980595 (big blind) showed [8s 8h] and lost with two pair, Kings and Eights



PokerStars Hand #254637905859:  Hold'em No Limit ($0.50/$1.00 USD) - 2025/01/31 16:04:20 WET [2025/01/31 11:04:20 ET]
Table 'Adria' 6-max Seat #5 is the button
Seat 6: nico1980595 ($0 in chips) is sitting out
Seat 1: LuckyShikari ($109.24 in chips) 
Seat 2: CichiChanMarian ($239.54 in chips) 
Seat 3: Poker9803 ($160.54 in chips) 
Seat 4: fedor0f ($114.35 in chips) 
Seat 5: reiyser ($100 in chips) 
LuckyShikari: posts small blind $0.50
CichiChanMarian: posts big blind $1
*** HOLE CARDS ***
Poker9803: raises $1.50 to $2.50
nico1980595 leaves the table
fedor0f: folds 
reiyser: folds 
LuckyShikari: folds 
CichiChanMarian: calls $1.50
*** FLOP *** [8c 2c 6d]
CichiChanMarian: checks 
Poker9803: checks 
*** TURN *** [8c 2c 6d] [3s]
CichiChanMarian: bets $6.94
Poker9803: folds 
Uncalled bet ($6.94) returned to CichiChanMarian
CichiChanMarian collected $5.22 from pot
CichiChanMarian: doesn't show hand 
*** SUMMARY ***
Total pot $5.50 | Rake $0.28 
Board [8c 2c 6d 3s]
Seat 6: nico1980595
Seat 1: LuckyShikari (small blind) folded before Flop
Seat 2: CichiChanMarian (big blind) collected ($5.22)
Seat 3: Poker9803 folded on the Turn
Seat 4: fedor0f folded before Flop (didn't bet)
Seat 5: reiyser (button) folded before Flop (didn't bet)



PokerStars Hand #254637916481:  Hold'em No Limit ($0.50/$1.00 USD) - 2025/01/31 16:05:08 WET [2025/01/31 11:05:08 ET]
Table 'Adria' 6-max Seat #1 is the button
Seat 3: Poker9803 ($158.04 in chips) is sitting out
Seat 4: fedor0f ($114.35 in chips) is sitting out
Seat 1: LuckyShikari ($108.74 in chips) 
Seat 2: CichiChanMarian ($242.26 in chips) 
Seat 5: reiyser ($100 in chips) 
CichiChanMarian: posts small blind $0.50
Poker9803: is sitting out 
fedor0f: is sitting out 
reiyser: posts big blind $1
*** HOLE CARDS ***
coeeeelho joins the table at seat #6 
fedor0f leaves the table
Poker9803 leaves the table
LuckyShikari: folds 
CichiChanMarian: raises $2 to $3
reiyser: raises $7 to $10
coeeeelho leaves the table
CichiChanMarian: raises $18 to $28
reiyser: folds 
Uncalled bet ($18) returned to CichiChanMarian
CichiChanMarian collected $20 from pot
CichiChanMarian: doesn't show hand 
*** SUMMARY ***
Total pot $20 | Rake $0 
Seat 3: Poker9803
Seat 4: fedor0f
Seat 1: LuckyShikari (button) folded before Flop (didn't bet)
Seat 2: CichiChanMarian (small blind) collected ($20)
Seat 5: reiyser (big blind) folded before Flop



PokerStars Hand #254638259185:  Hold'em No Limit ($0.50/$1.00 USD) - 2025/01/31 16:31:07 WET [2025/01/31 11:31:07 ET]
Table 'Adria' 6-max Seat #6 is the button
Seat 1: LuckyShikari ($100 in chips) 
Seat 2: Xenicide ($120.25 in chips) 
Seat 3: Poker9803 ($156.04 in chips) 
Seat 4: AlexPinsk1 ($100 in chips) 
Seat 5: KuningasRane ($100 in chips) 
Seat 6: BoyLoc0 ($141.50 in chips) 
LuckyShikari: posts small blind $0.50
Xenicide: posts big blind $1
*** HOLE CARDS ***
Poker9803: folds 
AlexPinsk1: folds 
KuningasRane: folds 
BoyLoc0: raises $1.50 to $2.50
LuckyShikari: folds 
Xenicide: folds 
Uncalled bet ($1.50) returned to BoyLoc0
BoyLoc0 collected $2.50 from pot
BoyLoc0: doesn't show hand 
*** SUMMARY ***
Total pot $2.50 | Rake $0 
Seat 1: LuckyShikari (small blind) folded before Flop
Seat 2: Xenicide (big blind) folded before Flop
Seat 3: Poker9803 folded before Flop (didn't bet)
Seat 4: AlexPinsk1 folded before Flop (didn't bet)
Seat 5: KuningasRane folded before Flop (didn't bet)
Seat 6: BoyLoc0 (button) collected ($2.50)



PokerStars Hand #254638264132:  Hold'em No Limit ($0.50/$1.00 USD) - 2025/01/31 16:31:30 WET [2025/01/31 11:31:30 ET]
Table 'Adria' 6-max Seat #1 is the button
Seat 3: Poker9803 ($156.04 in chips) is sitting out
Seat 1: LuckyShikari ($100 in chips) 
Seat 2: Xenicide ($119.25 in chips) 
Seat 4: AlexPinsk1 ($100 in chips) 
Seat 5: KuningasRane ($100 in chips) 
Seat 6: BoyLoc0 ($143 in chips) 
Xenicide: posts small blind $0.50
Poker9803: is sitting out 
AlexPinsk1: posts big blind $1
*** HOLE CARDS ***
KuningasRane: folds 
BoyLoc0: raises $1.50 to $2.50
Poker9803 leaves the table
LuckyShikari: raises $7.50 to $10
Xenicide: folds 
AlexPinsk1: folds 
BoyLoc0: folds 
Uncalled bet ($7.50) returned to LuckyShikari
LuckyShikari collected $6.50 from pot
LuckyShikari: doesn't show hand 
*** SUMMARY ***
Total pot $6.50 | Rake $0 
Seat 3: Poker9803
Seat 1: LuckyShikari (button) collected ($6.50)
Seat 2: Xenicide (small blind) folded before Flop
Seat 4: AlexPinsk1 (big blind) folded before Flop
Seat 5: KuningasRane folded before Flop (didn't bet)
Seat 6: BoyLoc0 folded before Flop



PokerStars Hand #254638269002:  Hold'em No Limit ($0.50/$1.00 USD) - 2025/01/31 16:31:52 WET [2025/01/31 11:31:52 ET]
Table 'Adria' 6-max Seat #2 is the button
Seat 1: LuckyShikari ($104 in chips) 
Seat 2: Xenicide ($118.75 in chips) 
Seat 4: AlexPinsk1 ($100 in chips) 
Seat 5: KuningasRane ($100 in chips) 
Seat 6: BoyLoc0 ($140.50 in chips) 
AlexPinsk1: posts small blind $0.50
KuningasRane: posts big blind $1
*** HOLE CARDS ***
BoyLoc0: folds 
LuckyShikari: folds 
LuckyShikari leaves the table
Xenicide: folds 
AlexPinsk1: raises $2 to $3
KuningasRane: raises $6 to $9
AlexPinsk1: folds 
Uncalled bet ($6) returned to KuningasRane
KuningasRane collected $6 from pot
KuningasRane: doesn't show hand 
*** SUMMARY ***
Total pot $6 | Rake $0 
Seat 1: LuckyShikari folded before Flop (didn't bet)
Seat 2: Xenicide (button) folded before Flop (didn't bet)
Seat 4: AlexPinsk1 (small blind) folded before Flop
Seat 5: KuningasRane (big blind) collected ($6)
Seat 6: BoyLoc0 folded before Flop (didn't bet)



PokerStars Hand #254638279735:  Hold'em No Limit ($0.50/$1.00 USD) - 2025/01/31 16:32:41 WET [2025/01/31 11:32:41 ET]
Table 'Adria' 6-max Seat #4 is the button
Seat 2: Xenicide ($118.75 in chips) 
Seat 4: AlexPinsk1 ($100 in chips) 
Seat 5: KuningasRane ($103 in chips) 
Seat 6: BoyLoc0 ($140.50 in chips) 
KuningasRane: posts small blind $0.50
BoyLoc0: posts big blind $1
*** HOLE CARDS ***
Xenicide: folds 
AlexPinsk1: raises $1.50 to $2.50
Kristo 914 joins the table at seat #3 
KuningasRane: raises $6 to $8.50
BoyLoc0: folds 
AlexPinsk1: folds 
Uncalled bet ($6) returned to KuningasRane
KuningasRane collected $6 from pot
KuningasRane: doesn't show hand 
*** SUMMARY ***
Total pot $6 | Rake $0 
Seat 2: Xenicide folded before Flop (didn't bet)
Seat 4: AlexPinsk1 (button) folded before Flop
Seat 5: KuningasRane (small blind) collected ($6)
Seat 6: BoyLoc0 (big blind) folded before Flop



PokerStars Hand #254638282992:  Hold'em No Limit ($0.50/$1.00 USD) - 2025/01/31 16:32:56 WET [2025/01/31 11:32:56 ET]
Table 'Adria' 6-max Seat #5 is the button
Seat 3: Kristo 914 ($100 in chips) is sitting out
Seat 2: Xenicide ($118.75 in chips) 
Seat 4: AlexPinsk1 ($100 in chips) 
Seat 5: KuningasRane ($106.50 in chips) 
Seat 6: BoyLoc0 ($139.50 in chips) 
BoyLoc0: posts small blind $0.50
Xenicide: posts big blind $1
Kristo 914: sits out 
*** HOLE CARDS ***
AlexPinsk1: raises $1.50 to $2.50
KuningasRane: folds 
BoyLoc0: folds 
Xenicide: folds 
Uncalled bet ($1.50) returned to AlexPinsk1
AlexPinsk1 collected $2.50 from pot
AlexPinsk1: doesn't show hand 
DarioS1603 joins the table at seat #1 
DarioS1603 is disconnected 
*** SUMMARY ***
Total pot $2.50 | Rake $0 
Seat 3: Kristo 914
Seat 2: Xenicide (big blind) folded before Flop
Seat 4: AlexPinsk1 collected ($2.50)
Seat 5: KuningasRane (button) folded before Flop (didn't bet)
Seat 6: BoyLoc0 (small blind) folded before Flop



PokerStars Hand #254638286506:  Hold'em No Limit ($0.50/$1.00 USD) - 2025/01/31 16:33:12 WET [2025/01/31 11:33:12 ET]
Table 'Adria' 6-max Seat #6 is the button
Seat 1: DarioS1603 ($52.34 in chips) is sitting out
Seat 2: Xenicide ($117.75 in chips) 
Seat 3: Kristo 914 ($100 in chips) 
Seat 4: AlexPinsk1 ($101.50 in chips) 
Seat 5: KuningasRane ($106.50 in chips) 
Seat 6: BoyLoc0 ($139 in chips) 
Xenicide: posts small blind $0.50
Kristo 914: posts big blind $1
*** HOLE CARDS ***
AlexPinsk1: folds 
KuningasRane: folds 
BoyLoc0: folds 
Xenicide: folds 
Uncalled bet ($0.50) returned to Kristo 914
Kristo 914 collected $1 from pot
Kristo 914: doesn't show hand 
*** SUMMARY ***
Total pot $1 | Rake $0 
Seat 1: DarioS1603
Seat 2: Xenicide (small blind) folded before Flop
Seat 3: Kristo 914 (big blind) collected ($1)
Seat 4: AlexPinsk1 folded before Flop (didn't bet)
Seat 5: KuningasRane folded before Flop (didn't bet)
Seat 6: BoyLoc0 (button) folded before Flop (didn't bet)



PokerStars Hand #254638289383:  Hold'em No Limit ($0.50/$1.00 USD) - 2025/01/31 16:33:25 WET [2025/01/31 11:33:25 ET]
Table 'Adria' 6-max Seat #2 is the button
Seat 1: DarioS1603 ($52.34 in chips) 
Seat 2: Xenicide ($117.25 in chips) 
Seat 3: Kristo 914 ($100.50 in chips) 
Seat 4: AlexPinsk1 ($101.50 in chips) 
Seat 5: KuningasRane ($106.50 in chips) 
Seat 6: BoyLoc0 ($139 in chips) 
Kristo 914: posts small blind $0.50
AlexPinsk1: posts big blind $1
DarioS1603: posts big blind $1
*** HOLE CARDS ***
KuningasRane: folds 
BoyLoc0: folds 
DarioS1603: checks 
Xenicide: folds 
Kristo 914: raises $4.50 to $5.50
AlexPinsk1: folds 
DarioS1603: folds 
Uncalled bet ($4.50) returned to Kristo 914
Kristo 914 collected $3 from pot
Kristo 914: doesn't show hand 
*** SUMMARY ***
Total pot $3 | Rake $0 
Seat 1: DarioS1603 folded before Flop (didn't bet)
Seat 2: Xenicide (button) folded before Flop (didn't bet)
Seat 3: Kristo 914 (small blind) collected ($3)
Seat 4: AlexPinsk1 (big blind) folded before Flop
Seat 5: KuningasRane folded before Flop (didn't bet)
Seat 6: BoyLoc0 folded before Flop (didn't bet)



PokerStars Hand #254638294807:  Hold'em No Limit ($0.50/$1.00 USD) - 2025/01/31 16:33:50 WET [2025/01/31 11:33:50 ET]
Table 'Adria' 6-max Seat #3 is the button
Seat 1: DarioS1603 ($51.34 in chips) 
Seat 2: Xenicide ($117.25 in chips) 
Seat 3: Kristo 914 ($102.50 in chips) 
Seat 4: AlexPinsk1 ($100.50 in chips) 
Seat 5: KuningasRane ($106.50 in chips) 
Seat 6: BoyLoc0 ($139 in chips) 
AlexPinsk1: posts small blind $0.50
KuningasRane: posts big blind $1
*** HOLE CARDS ***
BoyLoc0: folds 
DarioS1603: calls $1
Xenicide: raises $3 to $4
Kristo 914: calls $4
AlexPinsk1: folds 
KuningasRane: folds 
DarioS1603: folds 
*** FLOP *** [Tc 8c Ah]
Xenicide: checks 
Kristo 914: bets $5.09
Xenicide: folds 
Uncalled bet ($5.09) returned to Kristo 914
Kristo 914 collected $9.98 from pot
Kristo 914: doesn't show hand 
*** SUMMARY ***
Total pot $10.50 | Rake $0.52 
Board [Tc 8c Ah]
Seat 1: DarioS1603 folded before Flop
Seat 2: Xenicide folded on the Flop
Seat 3: Kristo 914 (button) collected ($9.98)
Seat 4: AlexPinsk1 (small blind) folded before Flop
Seat 5: KuningasRane (big blind) folded before Flop
Seat 6: BoyLoc0 folded before Flop (didn't bet)



PokerStars Hand #254638308045:  Hold'em No Limit ($0.50/$1.00 USD) - 2025/01/31 16:34:50 WET [2025/01/31 11:34:50 ET]
Table 'Adria' 6-max Seat #4 is the button
Seat 1: DarioS1603 ($50.34 in chips) 
Seat 2: Xenicide ($113.25 in chips) 
Seat 3: Kristo 914 ($108.48 in chips) 
Seat 4: AlexPinsk1 ($100 in chips) 
Seat 5: KuningasRane ($105.50 in chips) 
Seat 6: BoyLoc0 ($139 in chips) 
KuningasRane: posts small blind $0.50
BoyLoc0: posts big blind $1
*** HOLE CARDS ***
DarioS1603: raises $1 to $2
Xenicide: folds 
Kristo 914: folds 
AlexPinsk1: folds 
KuningasRane: calls $1.50
BoyLoc0: folds 
*** FLOP *** [8s 4s 7d]
KuningasRane: checks 
DarioS1603: bets $1
KuningasRane: folds 
Uncalled bet ($1) returned to DarioS1603
DarioS1603 collected $4.69 from pot
*** SUMMARY ***
Total pot $5 | Rake $0.31 
Board [8s 4s 7d]
Seat 1: DarioS1603 collected ($4.69)
Seat 2: Xenicide folded before Flop (didn't bet)
Seat 3: Kristo 914 folded before Flop (didn't bet)
Seat 4: AlexPinsk1 (button) folded before Flop (didn't bet)
Seat 5: KuningasRane (small blind) folded on the Flop
Seat 6: BoyLoc0 (big blind) folded before Flop



PokerStars Hand #254638316281:  Hold'em No Limit ($0.50/$1.00 USD) - 2025/01/31 16:35:27 WET [2025/01/31 11:35:27 ET]
Table 'Adria' 6-max Seat #5 is the button
Seat 1: DarioS1603 ($53.03 in chips) 
Seat 2: Xenicide ($113.25 in chips) 
Seat 3: Kristo 914 ($108.48 in chips) 
Seat 4: AlexPinsk1 ($100 in chips) 
Seat 5: KuningasRane ($103.50 in chips) 
Seat 6: BoyLoc0 ($138 in chips) 
BoyLoc0: posts small blind $0.50
DarioS1603: posts big blind $1
*** HOLE CARDS ***
Xenicide: folds 
Kristo 914: raises $1.40 to $2.40
AlexPinsk1: folds 
KuningasRane: folds 
BoyLoc0: folds 
DarioS1603: calls $1.40
*** FLOP *** [8d Ah 5d]
DarioS1603: checks 
Kristo 914: bets $1
DarioS1603: calls $1
*** TURN *** [8d Ah 5d] [9c]
DarioS1603: checks 
Kristo 914: checks 
*** RIVER *** [8d Ah 5d 9c] [Tc]
DarioS1603: bets $2
Kristo 914: folds 
Uncalled bet ($2) returned to DarioS1603
DarioS1603 collected $6.85 from pot
*** SUMMARY ***
Total pot $7.30 | Rake $0.45 
Board [8d Ah 5d 9c Tc]
Seat 1: DarioS1603 (big blind) collected ($6.85)
Seat 2: Xenicide folded before Flop (didn't bet)
Seat 3: Kristo 914 folded on the River
Seat 4: AlexPinsk1 folded before Flop (didn't bet)
Seat 5: KuningasRane (button) folded before Flop (didn't bet)
Seat 6: BoyLoc0 (small blind) folded before Flop



PokerStars Hand #254638324088:  Hold'em No Limit ($0.50/$1.00 USD) - 2025/01/31 16:36:03 WET [2025/01/31 11:36:03 ET]
Table 'Adria' 6-max Seat #6 is the button
Seat 1: DarioS1603 ($56.48 in chips) 
Seat 2: Xenicide ($113.25 in chips) 
Seat 3: Kristo 914 ($105.08 in chips) 
Seat 4: AlexPinsk1 ($100 in chips) 
Seat 5: KuningasRane ($103.50 in chips) 
Seat 6: BoyLoc0 ($137.50 in chips) 
DarioS1603: posts small blind $0.50
Xenicide: posts big blind $1
*** HOLE CARDS ***
Kristo 914: folds 
AlexPinsk1: folds 
KuningasRane: raises $1.50 to $2.50
BoyLoc0: folds 
DarioS1603: folds 
Xenicide: raises $7.50 to $10
KuningasRane: folds 
Uncalled bet ($7.50) returned to Xenicide
Xenicide collected $5.50 from pot
*** SUMMARY ***
Total pot $5.50 | Rake $0 
Seat 1: DarioS1603 (small blind) folded before Flop
Seat 2: Xenicide (big blind) collected ($5.50)
Seat 3: Kristo 914 folded before Flop (didn't bet)
Seat 4: AlexPinsk1 folded before Flop (didn't bet)
Seat 5: KuningasRane folded before Flop
Seat 6: BoyLoc0 (button) folded before Flop (didn't bet)



PokerStars Hand #254638330188:  Hold'em No Limit ($0.50/$1.00 USD) - 2025/01/31 16:36:30 WET [2025/01/31 11:36:30 ET]
Table 'Adria' 6-max Seat #1 is the button
Seat 1: DarioS1603 ($55.98 in chips) 
Seat 2: Xenicide ($116.25 in chips) 
Seat 3: Kristo 914 ($105.08 in chips) 
Seat 4: AlexPinsk1 ($100 in chips) 
Seat 5: KuningasRane ($101 in chips) 
Seat 6: BoyLoc0 ($137.50 in chips) 
Xenicide: posts small blind $0.50
Kristo 914: posts big blind $1
*** HOLE CARDS ***
AlexPinsk1: raises $1.50 to $2.50
KuningasRane: folds 
BoyLoc0: folds 
DarioS1603: folds 
Xenicide: folds 
Kristo 914: folds 
Uncalled bet ($1.50) returned to AlexPinsk1
AlexPinsk1 collected $2.50 from pot
AlexPinsk1: doesn't show hand 
*** SUMMARY ***
Total pot $2.50 | Rake $0 
Seat 1: DarioS1603 (button) folded before Flop (didn't bet)
Seat 2: Xenicide (small blind) folded before Flop
Seat 3: Kristo 914 (big blind) folded before Flop
Seat 4: AlexPinsk1 collected ($2.50)
Seat 5: KuningasRane folded before Flop (didn't bet)
Seat 6: BoyLoc0 folded before Flop (didn't bet)



PokerStars Hand #254638333603:  Hold'em No Limit ($0.50/$1.00 USD) - 2025/01/31 16:36:46 WET [2025/01/31 11:36:46 ET]
Table 'Adria' 6-max Seat #2 is the button
Seat 1: DarioS1603 ($55.98 in chips) 
Seat 2: Xenicide ($115.75 in chips) 
Seat 3: Kristo 914 ($104.08 in chips) 
Seat 4: AlexPinsk1 ($101.50 in chips) 
Seat 5: KuningasRane ($101 in chips) 
Seat 6: BoyLoc0 ($137.50 in chips) 
Kristo 914: posts small blind $0.50
AlexPinsk1: posts big blind $1
*** HOLE CARDS ***
KuningasRane: folds 
BoyLoc0: raises $1.50 to $2.50
DarioS1603: folds 
Xenicide: folds 
Kristo 914: folds 
AlexPinsk1: calls $1.50
*** FLOP *** [Qd Ks 2d]
AlexPinsk1: checks 
BoyLoc0: bets $1.72
AlexPinsk1: calls $1.72
*** TURN *** [Qd Ks 2d] [Ah]
AlexPinsk1: checks 
BoyLoc0: checks 
*** RIVER *** [Qd Ks 2d Ah] [8s]
AlexPinsk1: bets $6.37
BoyLoc0: folds 
Uncalled bet ($6.37) returned to AlexPinsk1
AlexPinsk1 collected $8.49 from pot
AlexPinsk1: doesn't show hand 
*** SUMMARY ***
Total pot $8.94 | Rake $0.45 
Board [Qd Ks 2d Ah 8s]
Seat 1: DarioS1603 folded before Flop (didn't bet)
Seat 2: Xenicide (button) folded before Flop (didn't bet)
Seat 3: Kristo 914 (small blind) folded before Flop
Seat 4: AlexPinsk1 (big blind) collected ($8.49)
Seat 5: KuningasRane folded before Flop (didn't bet)
Seat 6: BoyLoc0 folded on the River



PokerStars Hand #254638351070:  Hold'em No Limit ($0.50/$1.00 USD) - 2025/01/31 16:38:04 WET [2025/01/31 11:38:04 ET]
Table 'Adria' 6-max Seat #3 is the button
Seat 1: DarioS1603 ($55.98 in chips) 
Seat 2: Xenicide ($115.75 in chips) 
Seat 3: Kristo 914 ($103.58 in chips) 
Seat 4: AlexPinsk1 ($105.77 in chips) 
Seat 5: KuningasRane ($101 in chips) 
Seat 6: BoyLoc0 ($133.28 in chips) 
AlexPinsk1: posts small blind $0.50
KuningasRane: posts big blind $1
*** HOLE CARDS ***
BoyLoc0: folds 
DarioS1603: calls $1
Xenicide: folds 
Kristo 914: folds 
AlexPinsk1: folds 
KuningasRane: checks 
*** FLOP *** [3c 9s Qh]
KuningasRane: checks 
DarioS1603: bets $2
KuningasRane: folds 
Uncalled bet ($2) returned to DarioS1603
DarioS1603 collected $2.35 from pot
*** SUMMARY ***
Total pot $2.50 | Rake $0.15 
Board [3c 9s Qh]
Seat 1: DarioS1603 collected ($2.35)
Seat 2: Xenicide folded before Flop (didn't bet)
Seat 3: Kristo 914 (button) folded before Flop (didn't bet)
Seat 4: AlexPinsk1 (small blind) folded before Flop
Seat 5: KuningasRane (big blind) folded on the Flop
Seat 6: BoyLoc0 folded before Flop (didn't bet)



PokerStars Hand #254638356745:  Hold'em No Limit ($0.50/$1.00 USD) - 2025/01/31 16:38:30 WET [2025/01/31 11:38:30 ET]
Table 'Adria' 6-max Seat #4 is the button
Seat 1: DarioS1603 ($57.33 in chips) 
Seat 2: Xenicide ($115.75 in chips) 
Seat 3: Kristo 914 ($103.58 in chips) 
Seat 4: AlexPinsk1 ($105.27 in chips) 
Seat 5: KuningasRane ($100 in chips) 
Seat 6: BoyLoc0 ($133.28 in chips) 
KuningasRane: posts small blind $0.50
BoyLoc0: posts big blind $1
*** HOLE CARDS ***
DarioS1603: folds 
Xenicide: raises $1 to $2
Kristo 914: folds 
AlexPinsk1: folds 
DarioS1603 leaves the table
KuningasRane: raises $6 to $8
BoyLoc0: folds 
Xenicide: folds 
Uncalled bet ($6) returned to KuningasRane
KuningasRane collected $5 from pot
KuningasRane: doesn't show hand 
*** SUMMARY ***
Total pot $5 | Rake $0 
Seat 1: DarioS1603 folded before Flop (didn't bet)
Seat 2: Xenicide folded before Flop
Seat 3: Kristo 914 folded before Flop (didn't bet)
Seat 4: AlexPinsk1 (button) folded before Flop (didn't bet)
Seat 5: KuningasRane (small blind) collected ($5)
Seat 6: BoyLoc0 (big blind) folded before Flop



PokerStars Hand #254638364623:  Hold'em No Limit ($0.50/$1.00 USD) - 2025/01/31 16:39:06 WET [2025/01/31 11:39:06 ET]
Table 'Adria' 6-max Seat #5 is the button
Seat 2: Xenicide ($113.75 in chips) 
Seat 3: Kristo 914 ($103.58 in chips) 
Seat 4: AlexPinsk1 ($105.27 in chips) 
Seat 5: KuningasRane ($103 in chips) 
Seat 6: BoyLoc0 ($132.28 in chips) 
BoyLoc0: posts small blind $0.50
Xenicide: posts big blind $1
*** HOLE CARDS ***
Kristo 914: folds 
AlexPinsk1: folds 
KuningasRane: folds 
BoyLoc0: raises $2 to $3
Xenicide: raises $4.50 to $7.50
BoyLoc0: calls $4.50
*** FLOP *** [4d 3h Kh]
BoyLoc0: checks 
Xenicide: bets $3.56
BoyLoc0: calls $3.56
*** TURN *** [4d 3h Kh] [Ad]
BoyLoc0: checks 
Xenicide: checks 
*** RIVER *** [4d 3h Kh Ad] [Qh]
BoyLoc0: bets $6.93
Xenicide: folds 
Uncalled bet ($6.93) returned to BoyLoc0
BoyLoc0 collected $21.01 from pot
BoyLoc0: doesn't show hand 
*** SUMMARY ***
Total pot $22.12 | Rake $1.11 
Board [4d 3h Kh Ad Qh]
Seat 2: Xenicide (big blind) folded on the River
Seat 3: Kristo 914 folded before Flop (didn't bet)
Seat 4: AlexPinsk1 folded before Flop (didn't bet)
Seat 5: KuningasRane (button) folded before Flop (didn't bet)
Seat 6: BoyLoc0 (small blind) collected ($21.01)



PokerStars Hand #254638379621:  Hold'em No Limit ($0.50/$1.00 USD) - 2025/01/31 16:40:12 WET [2025/01/31 11:40:12 ET]
Table 'Adria' 6-max Seat #6 is the button
Seat 2: Xenicide ($102.69 in chips) 
Seat 3: Kristo 914 ($103.58 in chips) 
Seat 4: AlexPinsk1 ($105.27 in chips) 
Seat 5: KuningasRane ($103 in chips) 
Seat 6: BoyLoc0 ($142.23 in chips) 
Xenicide: posts small blind $0.50
Kristo 914: posts big blind $1
*** HOLE CARDS ***
AlexPinsk1: folds 
KuningasRane: raises $1.50 to $2.50
BoyLoc0: folds 
Xenicide: folds 
Kristo 914: folds 
Uncalled bet ($1.50) returned to KuningasRane
KuningasRane collected $2.50 from pot
KuningasRane: doesn't show hand 
*** SUMMARY ***
Total pot $2.50 | Rake $0 
Seat 2: Xenicide (small blind) folded before Flop
Seat 3: Kristo 914 (big blind) folded before Flop
Seat 4: AlexPinsk1 folded before Flop (didn't bet)
Seat 5: KuningasRane collected ($2.50)
Seat 6: BoyLoc0 (button) folded before Flop (didn't bet)



PokerStars Hand #254638382660:  Hold'em No Limit ($0.50/$1.00 USD) - 2025/01/31 16:40:26 WET [2025/01/31 11:40:26 ET]
Table 'Adria' 6-max Seat #2 is the button
Seat 2: Xenicide ($102.19 in chips) 
Seat 3: Kristo 914 ($102.58 in chips) 
Seat 4: AlexPinsk1 ($105.27 in chips) 
Seat 5: KuningasRane ($104.50 in chips) 
Seat 6: BoyLoc0 ($142.23 in chips) 
Kristo 914: posts small blind $0.50
AlexPinsk1: posts big blind $1
*** HOLE CARDS ***
KuningasRane: folds 
BoyLoc0: folds 
Xenicide: raises $1.25 to $2.25
Kristo 914: folds 
AlexPinsk1: folds 
Uncalled bet ($1.25) returned to Xenicide
Xenicide collected $2.50 from pot
*** SUMMARY ***
Total pot $2.50 | Rake $0 
Seat 2: Xenicide (button) collected ($2.50)
Seat 3: Kristo 914 (small blind) folded before Flop
Seat 4: AlexPinsk1 (big blind) folded before Flop
Seat 5: KuningasRane folded before Flop (didn't bet)
Seat 6: BoyLoc0 folded before Flop (didn't bet)



PokerStars Hand #254638385485:  Hold'em No Limit ($0.50/$1.00 USD) - 2025/01/31 16:40:38 WET [2025/01/31 11:40:38 ET]
Table 'Adria' 6-max Seat #3 is the button
Seat 2: Xenicide ($103.69 in chips) 
Seat 3: Kristo 914 ($102.08 in chips) 
Seat 4: AlexPinsk1 ($104.27 in chips) 
Seat 5: KuningasRane ($104.50 in chips) 
Seat 6: BoyLoc0 ($142.23 in chips) 
AlexPinsk1: posts small blind $0.50
KuningasRane: posts big blind $1
*** HOLE CARDS ***
BoyLoc0: raises $1.50 to $2.50
Xenicide: folds 
Kristo 914: folds 
AlexPinsk1: folds 
KuningasRane: folds 
Uncalled bet ($1.50) returned to BoyLoc0
BoyLoc0 collected $2.50 from pot
BoyLoc0: doesn't show hand 
*** SUMMARY ***
Total pot $2.50 | Rake $0 
Seat 2: Xenicide folded before Flop (didn't bet)
Seat 3: Kristo 914 (button) folded before Flop (didn't bet)
Seat 4: AlexPinsk1 (small blind) folded before Flop
Seat 5: KuningasRane (big blind) folded before Flop
Seat 6: BoyLoc0 collected ($2.50)



PokerStars Hand #254638391849:  Hold'em No Limit ($0.50/$1.00 USD) - 2025/01/31 16:41:07 WET [2025/01/31 11:41:07 ET]
Table 'Adria' 6-max Seat #4 is the button
Seat 2: Xenicide ($103.69 in chips) 
Seat 3: Kristo 914 ($102.08 in chips) 
Seat 4: AlexPinsk1 ($103.77 in chips) 
Seat 5: KuningasRane ($103.50 in chips) 
Seat 6: BoyLoc0 ($143.73 in chips) 
KuningasRane: posts small blind $0.50
BoyLoc0: posts big blind $1
*** HOLE CARDS ***
Xenicide: folds 
Kristo 914: folds 
AlexPinsk1: folds 
KuningasRane: folds 
Uncalled bet ($0.50) returned to BoyLoc0
BoyLoc0 collected $1 from pot
BoyLoc0: doesn't show hand 
*** SUMMARY ***
Total pot $1 | Rake $0 
Seat 2: Xenicide folded before Flop (didn't bet)
Seat 3: Kristo 914 folded before Flop (didn't bet)
Seat 4: AlexPinsk1 (button) folded before Flop (didn't bet)
Seat 5: KuningasRane (small blind) folded before Flop
Seat 6: BoyLoc0 (big blind) collected ($1)



PokerStars Hand #254638394468:  Hold'em No Limit ($0.50/$1.00 USD) - 2025/01/31 16:41:18 WET [2025/01/31 11:41:18 ET]
Table 'Adria' 6-max Seat #5 is the button
Seat 2: Xenicide ($103.69 in chips) 
Seat 3: Kristo 914 ($102.08 in chips) 
Seat 4: AlexPinsk1 ($103.77 in chips) 
Seat 5: KuningasRane ($103 in chips) 
Seat 6: BoyLoc0 ($144.23 in chips) 
BoyLoc0: posts small blind $0.50
Xenicide: posts big blind $1
*** HOLE CARDS ***
Kristo 914: folds 
AlexPinsk1: folds 
KuningasRane: raises $1.50 to $2.50
BoyLoc0: folds 
Xenicide: folds 
Uncalled bet ($1.50) returned to KuningasRane
KuningasRane collected $2.50 from pot
KuningasRane: doesn't show hand 
*** SUMMARY ***
Total pot $2.50 | Rake $0 
Seat 2: Xenicide (big blind) folded before Flop
Seat 3: Kristo 914 folded before Flop (didn't bet)
Seat 4: AlexPinsk1 folded before Flop (didn't bet)
Seat 5: KuningasRane (button) collected ($2.50)
Seat 6: BoyLoc0 (small blind) folded before Flop



PokerStars Hand #254638399481:  Hold'em No Limit ($0.50/$1.00 USD) - 2025/01/31 16:41:41 WET [2025/01/31 11:41:41 ET]
Table 'Adria' 6-max Seat #6 is the button
Seat 2: Xenicide ($102.69 in chips) 
Seat 3: Kristo 914 ($102.08 in chips) 
Seat 4: AlexPinsk1 ($103.77 in chips) 
Seat 5: KuningasRane ($104.50 in chips) 
Seat 6: BoyLoc0 ($143.73 in chips) 
Xenicide: posts small blind $0.50
Kristo 914: posts big blind $1
*** HOLE CARDS ***
AlexPinsk1: raises $1.50 to $2.50
KuningasRane: folds 
BoyLoc0: folds 
Xenicide: folds 
Kristo 914: folds 
Uncalled bet ($1.50) returned to AlexPinsk1
AlexPinsk1 collected $2.50 from pot
AlexPinsk1: doesn't show hand 
*** SUMMARY ***
Total pot $2.50 | Rake $0 
Seat 2: Xenicide (small blind) folded before Flop
Seat 3: Kristo 914 (big blind) folded before Flop
Seat 4: AlexPinsk1 collected ($2.50)
Seat 5: KuningasRane folded before Flop (didn't bet)
Seat 6: BoyLoc0 (button) folded before Flop (didn't bet)



PokerStars Hand #254638407467:  Hold'em No Limit ($0.50/$1.00 USD) - 2025/01/31 16:42:16 WET [2025/01/31 11:42:16 ET]
Table 'Adria' 6-max Seat #2 is the button
Seat 2: Xenicide ($102.19 in chips) 
Seat 3: Kristo 914 ($101.08 in chips) 
Seat 4: AlexPinsk1 ($105.27 in chips) 
Seat 5: KuningasRane ($104.50 in chips) 
Seat 6: BoyLoc0 ($143.73 in chips) 
Kristo 914: posts small blind $0.50
AlexPinsk1: posts big blind $1
*** HOLE CARDS ***
KuningasRane: raises $1.50 to $2.50
BoyLoc0: raises $5 to $7.50
Xenicide: raises $8 to $15.50
Kristo 914: folds 
AlexPinsk1: folds 
KuningasRane: folds 
BoyLoc0: calls $8
*** FLOP *** [8c Th Ac]
BoyLoc0: checks 
Xenicide: bets $8.31
BoyLoc0: calls $8.31
*** TURN *** [8c Th Ac] [7d]
BoyLoc0: checks 
Xenicide: checks 
*** RIVER *** [8c Th Ac 7d] [Kh]
BoyLoc0: checks 
Xenicide: checks 
*** SHOW DOWN ***
BoyLoc0: shows [Qh Qc] (a pair of Queens)
Xenicide: shows [Ad 9d] (a pair of Aces)
Xenicide collected $49.12 from pot
*** SUMMARY ***
Total pot $51.62 | Rake $2.50 
Board [8c Th Ac 7d Kh]
Seat 2: Xenicide (button) showed [Ad 9d] and won ($49.12) with a pair of Aces
Seat 3: Kristo 914 (small blind) folded before Flop
Seat 4: AlexPinsk1 (big blind) folded before Flop
Seat 5: KuningasRane folded before Flop
Seat 6: BoyLoc0 showed [Qh Qc] and lost with a pair of Queens



PokerStars Hand #254638423081:  Hold'em No Limit ($0.50/$1.00 USD) - 2025/01/31 16:43:25 WET [2025/01/31 11:43:25 ET]
Table 'Adria' 6-max Seat #3 is the button
Seat 2: Xenicide ($127.50 in chips) 
Seat 3: Kristo 914 ($100.58 in chips) 
Seat 4: AlexPinsk1 ($104.27 in chips) 
Seat 5: KuningasRane ($102 in chips) 
Seat 6: BoyLoc0 ($119.92 in chips) 
AlexPinsk1: posts small blind $0.50
KuningasRane: posts big blind $1
*** HOLE CARDS ***
BoyLoc0: folds 
Xenicide: folds 
Kristo 914: raises $1.40 to $2.40
AlexPinsk1: raises $7.60 to $10
KuningasRane: folds 
Kristo 914: calls $7.60
*** FLOP *** [Tc Jd 3h]
AlexPinsk1: bets $9.97
Kristo 914: folds 
Uncalled bet ($9.97) returned to AlexPinsk1
AlexPinsk1 collected $19.95 from pot
AlexPinsk1: doesn't show hand 
*** SUMMARY ***
Total pot $21 | Rake $1.05 
Board [Tc Jd 3h]
Seat 2: Xenicide folded before Flop (didn't bet)
Seat 3: Kristo 914 (button) folded on the Flop
Seat 4: AlexPinsk1 (small blind) collected ($19.95)
Seat 5: KuningasRane (big blind) folded before Flop
Seat 6: BoyLoc0 folded before Flop (didn't bet)



PokerStars Hand #254638434080:  Hold'em No Limit ($0.50/$1.00 USD) - 2025/01/31 16:44:13 WET [2025/01/31 11:44:13 ET]
Table 'Adria' 6-max Seat #4 is the button
Seat 2: Xenicide ($127.50 in chips) 
Seat 3: Kristo 914 ($100 in chips) 
Seat 4: AlexPinsk1 ($114.22 in chips) 
Seat 5: KuningasRane ($101 in chips) 
Seat 6: BoyLoc0 ($119.92 in chips) 
KuningasRane: posts small blind $0.50
BoyLoc0: posts big blind $1
*** HOLE CARDS ***
Xenicide: folds 
Kristo 914: folds 
AlexPinsk1: folds 
KuningasRane: raises $1.50 to $2.50
BoyLoc0: calls $1.50
*** FLOP *** [2h 5h 6h]
KuningasRane: bets $1.90
BoyLoc0: folds 
Uncalled bet ($1.90) returned to KuningasRane
KuningasRane collected $4.75 from pot
KuningasRane: doesn't show hand 
*** SUMMARY ***
Total pot $5 | Rake $0.25 
Board [2h 5h 6h]
Seat 2: Xenicide folded before Flop (didn't bet)
Seat 3: Kristo 914 folded before Flop (didn't bet)
Seat 4: AlexPinsk1 (button) folded before Flop (didn't bet)
Seat 5: KuningasRane (small blind) collected ($4.75)
Seat 6: BoyLoc0 (big blind) folded on the Flop



PokerStars Hand #254638441270:  Hold'em No Limit ($0.50/$1.00 USD) - 2025/01/31 16:44:45 WET [2025/01/31 11:44:45 ET]
Table 'Adria' 6-max Seat #5 is the button
Seat 2: Xenicide ($127.50 in chips) 
Seat 3: Kristo 914 ($100 in chips) 
Seat 4: AlexPinsk1 ($114.22 in chips) 
Seat 5: KuningasRane ($103.25 in chips) 
Seat 6: BoyLoc0 ($117.42 in chips) 
BoyLoc0: posts small blind $0.50
Xenicide: posts big blind $1
*** HOLE CARDS ***
Kristo 914: folds 
AlexPinsk1: folds 
KuningasRane: folds 
BoyLoc0: folds 
Uncalled bet ($0.50) returned to Xenicide
Xenicide collected $1 from pot
*** SUMMARY ***
Total pot $1 | Rake $0 
Seat 2: Xenicide (big blind) collected ($1)
Seat 3: Kristo 914 folded before Flop (didn't bet)
Seat 4: AlexPinsk1 folded before Flop (didn't bet)
Seat 5: KuningasRane (button) folded before Flop (didn't bet)
Seat 6: BoyLoc0 (small blind) folded before Flop



PokerStars Hand #254638446402:  Hold'em No Limit ($0.50/$1.00 USD) - 2025/01/31 16:45:07 WET [2025/01/31 11:45:07 ET]
Table 'Adria' 6-max Seat #6 is the button
Seat 2: Xenicide ($128 in chips) 
Seat 3: Kristo 914 ($100 in chips) 
Seat 4: AlexPinsk1 ($114.22 in chips) 
Seat 5: KuningasRane ($103.25 in chips) 
Seat 6: BoyLoc0 ($116.92 in chips) 
Xenicide: posts small blind $0.50
Kristo 914: posts big blind $1
*** HOLE CARDS ***
AlexPinsk1: folds 
KuningasRane: folds 
BoyLoc0: folds 
Xenicide: raises $2.50 to $3.50
Kristo 914: folds 
Uncalled bet ($2.50) returned to Xenicide
Xenicide collected $2 from pot
*** SUMMARY ***
Total pot $2 | Rake $0 
Seat 2: Xenicide (small blind) collected ($2)
Seat 3: Kristo 914 (big blind) folded before Flop
Seat 4: AlexPinsk1 folded before Flop (didn't bet)
Seat 5: KuningasRane folded before Flop (didn't bet)
Seat 6: BoyLoc0 (button) folded before Flop (didn't bet)



PokerStars Hand #254638451719:  Hold'em No Limit ($0.50/$1.00 USD) - 2025/01/31 16:45:31 WET [2025/01/31 11:45:31 ET]
Table 'Adria' 6-max Seat #2 is the button
Seat 2: Xenicide ($129 in chips) 
Seat 3: Kristo 914 ($100 in chips) 
Seat 4: AlexPinsk1 ($114.22 in chips) 
Seat 5: KuningasRane ($103.25 in chips) 
Seat 6: BoyLoc0 ($116.92 in chips) 
Kristo 914: posts small blind $0.50
AlexPinsk1: posts big blind $1
*** HOLE CARDS ***
KuningasRane: folds 
BoyLoc0: folds 
Xenicide: raises $1.25 to $2.25
Kristo 914: folds 
AlexPinsk1: calls $1.25
*** FLOP *** [3c 4s 7s]
AlexPinsk1: checks 
Xenicide: checks 
*** TURN *** [3c 4s 7s] [6h]
AlexPinsk1: bets $2
Xenicide: calls $2
*** RIVER *** [3c 4s 7s 6h] [Tc]
AlexPinsk1: bets $6.41
Xenicide: calls $6.41
*** SHOW DOWN ***
AlexPinsk1: shows [Jc Th] (a pair of Tens)
Xenicide: shows [5h 5s] (a straight, Three to Seven)
Xenicide collected $20.73 from pot
*** SUMMARY ***
Total pot $21.82 | Rake $1.09 
Board [3c 4s 7s 6h Tc]
Seat 2: Xenicide (button) showed [5h 5s] and won ($20.73) with a straight, Three to Seven
Seat 3: Kristo 914 (small blind) folded before Flop
Seat 4: AlexPinsk1 (big blind) showed [Jc Th] and lost with a pair of Tens
Seat 5: KuningasRane folded before Flop (didn't bet)
Seat 6: BoyLoc0 folded before Flop (didn't bet)



PokerStars Hand #254638468703:  Hold'em No Limit ($0.50/$1.00 USD) - 2025/01/31 16:46:46 WET [2025/01/31 11:46:46 ET]
Table 'Adria' 6-max Seat #3 is the button
Seat 2: Xenicide ($139.07 in chips) 
Seat 3: Kristo 914 ($100 in chips) 
Seat 4: AlexPinsk1 ($103.56 in chips) 
Seat 5: KuningasRane ($103.25 in chips) 
Seat 6: BoyLoc0 ($116.92 in chips) 
AlexPinsk1: posts small blind $0.50
KuningasRane: posts big blind $1
*** HOLE CARDS ***
BoyLoc0: folds 
Xenicide: folds 
Kristo 914: folds 
AlexPinsk1: folds 
Uncalled bet ($0.50) returned to KuningasRane
KuningasRane collected $1 from pot
KuningasRane: doesn't show hand 
*** SUMMARY ***
Total pot $1 | Rake $0 
Seat 2: Xenicide folded before Flop (didn't bet)
Seat 3: Kristo 914 (button) folded before Flop (didn't bet)
Seat 4: AlexPinsk1 (small blind) folded before Flop
Seat 5: KuningasRane (big blind) collected ($1)
Seat 6: BoyLoc0 folded before Flop (didn't bet)



PokerStars Hand #254638471789:  Hold'em No Limit ($0.50/$1.00 USD) - 2025/01/31 16:47:00 WET [2025/01/31 11:47:00 ET]
Table 'Adria' 6-max Seat #4 is the button
Seat 2: Xenicide ($139.07 in chips) 
Seat 3: Kristo 914 ($100 in chips) 
Seat 4: AlexPinsk1 ($103.06 in chips) 
Seat 5: KuningasRane ($103.75 in chips) 
Seat 6: BoyLoc0 ($116.92 in chips) 
KuningasRane: posts small blind $0.50
BoyLoc0: posts big blind $1
*** HOLE CARDS ***
Xenicide: folds 
Kristo 914: raises $1.40 to $2.40
AlexPinsk1: raises $5.10 to $7.50
KuningasRane: folds 
BoyLoc0: folds 
Kristo 914: raises $12.50 to $20
AlexPinsk1: folds 
Uncalled bet ($12.50) returned to Kristo 914
Kristo 914 collected $16.50 from pot
Kristo 914: doesn't show hand 
*** SUMMARY ***
Total pot $16.50 | Rake $0 
Seat 2: Xenicide folded before Flop (didn't bet)
Seat 3: Kristo 914 collected ($16.50)
Seat 4: AlexPinsk1 (button) folded before Flop
Seat 5: KuningasRane (small blind) folded before Flop
Seat 6: BoyLoc0 (big blind) folded before Flop



PokerStars Hand #254638481311:  Hold'em No Limit ($0.50/$1.00 USD) - 2025/01/31 16:47:42 WET [2025/01/31 11:47:42 ET]
Table 'Adria' 6-max Seat #5 is the button
Seat 2: Xenicide ($139.07 in chips) 
Seat 3: Kristo 914 ($109 in chips) 
Seat 4: AlexPinsk1 ($100 in chips) 
Seat 5: KuningasRane ($103.25 in chips) 
Seat 6: BoyLoc0 ($115.92 in chips) 
BoyLoc0: posts small blind $0.50
Xenicide: posts big blind $1
*** HOLE CARDS ***
Kristo 914: folds 
AlexPinsk1: raises $1.50 to $2.50
KuningasRane: folds 
BoyLoc0: raises $7.50 to $10
Xenicide is disconnected 
Xenicide is connected 
Xenicide: folds 
AlexPinsk1: raises $14.50 to $24.50
BoyLoc0: folds 
Uncalled bet ($14.50) returned to AlexPinsk1
AlexPinsk1 collected $21 from pot
AlexPinsk1: doesn't show hand 
Raphael Poulin joins the table at seat #1 
Raphael Poulin is disconnected 
*** SUMMARY ***
Total pot $21 | Rake $0 
Seat 2: Xenicide (big blind) folded before Flop
Seat 3: Kristo 914 folded before Flop (didn't bet)
Seat 4: AlexPinsk1 collected ($21)
Seat 5: KuningasRane (button) folded before Flop (didn't bet)
Seat 6: BoyLoc0 (small blind) folded before Flop



PokerStars Hand #254638497148:  Hold'em No Limit ($0.50/$1.00 USD) - 2025/01/31 16:48:52 WET [2025/01/31 11:48:52 ET]
Table 'Adria' 6-max Seat #6 is the button
Seat 1: Raphael Poulin ($33.50 in chips) is sitting out
Seat 2: Xenicide ($138.07 in chips) is sitting out
Seat 3: Kristo 914 ($109 in chips) 
Seat 4: AlexPinsk1 ($111 in chips) 
Seat 5: KuningasRane ($103.25 in chips) 
Seat 6: BoyLoc0 ($105.92 in chips) 
Xenicide is disconnected 
Xenicide has timed out while disconnected
Xenicide: is sitting out 
Kristo 914: posts small blind $0.50
AlexPinsk1: posts big blind $1
*** HOLE CARDS ***
KuningasRane: folds 
BoyLoc0: folds 
Kristo 914: raises $2 to $3
AlexPinsk1: folds 
Uncalled bet ($2) returned to Kristo 914
Kristo 914 collected $2 from pot
Kristo 914: doesn't show hand 
*** SUMMARY ***
Total pot $2 | Rake $0 
Seat 1: Raphael Poulin
Seat 2: Xenicide
Seat 3: Kristo 914 (small blind) collected ($2)
Seat 4: AlexPinsk1 (big blind) folded before Flop
Seat 5: KuningasRane folded before Flop (didn't bet)
Seat 6: BoyLoc0 (button) folded before Flop (didn't bet)



PokerStars Hand #254638503160:  Hold'em No Limit ($0.50/$1.00 USD) - 2025/01/31 16:49:18 WET [2025/01/31 11:49:18 ET]
Table 'Adria' 6-max Seat #3 is the button
Seat 1: Raphael Poulin ($33.50 in chips) is sitting out
Seat 2: Xenicide ($138.07 in chips) is sitting out
Seat 3: Kristo 914 ($110 in chips) 
Seat 4: AlexPinsk1 ($110 in chips) 
Seat 5: KuningasRane ($103.25 in chips) 
Seat 6: BoyLoc0 ($105.92 in chips) 
AlexPinsk1: posts small blind $0.50
KuningasRane: posts big blind $1
Raphael Poulin: sits out 
*** HOLE CARDS ***
BoyLoc0: folds 
Kristo 914: folds 
AlexPinsk1: folds 
Uncalled bet ($0.50) returned to KuningasRane
KuningasRane collected $1 from pot
KuningasRane: doesn't show hand 
Raphael Poulin leaves the table
*** SUMMARY ***
Total pot $1 | Rake $0 
Seat 1: Raphael Poulin
Seat 2: Xenicide
Seat 3: Kristo 914 (button) folded before Flop (didn't bet)
Seat 4: AlexPinsk1 (small blind) folded before Flop
Seat 5: KuningasRane (big blind) collected ($1)
Seat 6: BoyLoc0 folded before Flop (didn't bet)



PokerStars Hand #254638505184:  Hold'em No Limit ($0.50/$1.00 USD) - 2025/01/31 16:49:27 WET [2025/01/31 11:49:27 ET]
Table 'Adria' 6-max Seat #4 is the button
Seat 2: Xenicide ($138.07 in chips) is sitting out
Seat 3: Kristo 914 ($110 in chips) 
Seat 4: AlexPinsk1 ($109.50 in chips) 
Seat 5: KuningasRane ($103.75 in chips) 
Seat 6: BoyLoc0 ($105.92 in chips) 
KuningasRane: posts small blind $0.50
BoyLoc0: posts big blind $1
*** HOLE CARDS ***
Kristo 914: raises $1.40 to $2.40
AlexPinsk1: folds 
KuningasRane: folds 
BoyLoc0: folds 
Uncalled bet ($1.40) returned to Kristo 914
Kristo 914 collected $2.50 from pot
Kristo 914: doesn't show hand 
*** SUMMARY ***
Total pot $2.50 | Rake $0 
Seat 2: Xenicide
Seat 3: Kristo 914 collected ($2.50)
Seat 4: AlexPinsk1 (button) folded before Flop (didn't bet)
Seat 5: KuningasRane (small blind) folded before Flop
Seat 6: BoyLoc0 (big blind) folded before Flop



PokerStars Hand #254638508400:  Hold'em No Limit ($0.50/$1.00 USD) - 2025/01/31 16:49:42 WET [2025/01/31 11:49:42 ET]
Table 'Adria' 6-max Seat #5 is the button
Seat 2: Xenicide ($138.07 in chips) is sitting out
Seat 3: Kristo 914 ($111.50 in chips) 
Seat 4: AlexPinsk1 ($109.50 in chips) 
Seat 5: KuningasRane ($103.25 in chips) 
Seat 6: BoyLoc0 ($104.92 in chips) 
BoyLoc0: posts small blind $0.50
Xenicide has timed out
Xenicide: is sitting out 
Kristo 914: posts big blind $1
*** HOLE CARDS ***
AlexPinsk1: folds 
KuningasRane: folds 
Xenicide is disconnected 
BoyLoc0: raises $2 to $3
Kristo 914: folds 
Uncalled bet ($2) returned to BoyLoc0
BoyLoc0 collected $2 from pot
BoyLoc0: doesn't show hand 
*** SUMMARY ***
Total pot $2 | Rake $0 
Seat 2: Xenicide
Seat 3: Kristo 914 (big blind) folded before Flop
Seat 4: AlexPinsk1 folded before Flop (didn't bet)
Seat 5: KuningasRane (button) folded before Flop (didn't bet)
Seat 6: BoyLoc0 (small blind) collected ($2)



PokerStars Hand #254638513312:  Hold'em No Limit ($0.50/$1.00 USD) - 2025/01/31 16:50:03 WET [2025/01/31 11:50:03 ET]
Table 'Adria' 6-max Seat #6 is the button
Seat 2: Xenicide ($138.07 in chips) is sitting out
Seat 4: AlexPinsk1 ($109.50 in chips) is sitting out
Seat 3: Kristo 914 ($110.50 in chips) 
Seat 5: KuningasRane ($103.25 in chips) 
Seat 6: BoyLoc0 ($105.92 in chips) 
Kristo 914: posts small blind $0.50
AlexPinsk1: is sitting out 
KuningasRane: posts big blind $1
*** HOLE CARDS ***
BoyLoc0: folds 
AlexPinsk1 leaves the table
Kristo 914: raises $2 to $3
KuningasRane: folds 
Uncalled bet ($2) returned to Kristo 914
Kristo 914 collected $2 from pot
Kristo 914: doesn't show hand 
*** SUMMARY ***
Total pot $2 | Rake $0 
Seat 2: Xenicide
Seat 4: AlexPinsk1
Seat 3: Kristo 914 (small blind) collected ($2)
Seat 5: KuningasRane (big blind) folded before Flop
Seat 6: BoyLoc0 (button) folded before Flop (didn't bet)



PokerStars Hand #254638516361:  Hold'em No Limit ($0.50/$1.00 USD) - 2025/01/31 16:50:16 WET [2025/01/31 11:50:16 ET]
Table 'Adria' 6-max Seat #3 is the button
Seat 2: Xenicide ($138.07 in chips) is sitting out
Seat 3: Kristo 914 ($111.50 in chips) 
Seat 5: KuningasRane ($102.25 in chips) 
Seat 6: BoyLoc0 ($105.92 in chips) 
KuningasRane: posts small blind $0.50
BoyLoc0: posts big blind $1
*** HOLE CARDS ***
Ysiven joins the table at seat #1 
Kristo 914: folds 
KuningasRane: raises $1.50 to $2.50
BoyLoc0: calls $1.50
*** FLOP *** [2s Kh Ts]
KuningasRane: bets $1.90
BoyLoc0: calls $1.90
*** TURN *** [2s Kh Ts] [6c]
KuningasRane: checks 
BoyLoc0: checks 
*** RIVER *** [2s Kh Ts 6c] [Ac]
KuningasRane: checks 
BoyLoc0: checks 
*** SHOW DOWN ***
KuningasRane: shows [9d 8d] (high card Ace)
BoyLoc0: shows [Th 9c] (a pair of Tens)
BoyLoc0 collected $8.36 from pot
*** SUMMARY ***
Total pot $8.80 | Rake $0.44 
Board [2s Kh Ts 6c Ac]
Seat 2: Xenicide
Seat 3: Kristo 914 (button) folded before Flop (didn't bet)
Seat 5: KuningasRane (small blind) showed [9d 8d] and lost with high card Ace
Seat 6: BoyLoc0 (big blind) showed [Th 9c] and won ($8.36) with a pair of Tens



PokerStars Hand #254638528115:  Hold'em No Limit ($0.50/$1.00 USD) - 2025/01/31 16:51:09 WET [2025/01/31 11:51:09 ET]
Table 'Adria' 6-max Seat #5 is the button
Seat 2: Xenicide ($138.07 in chips) is sitting out
Seat 1: Ysiven ($100 in chips) 
Seat 3: Kristo 914 ($111.50 in chips) 
Seat 5: KuningasRane ($100 in chips) 
Seat 6: BoyLoc0 ($109.88 in chips) 
BoyLoc0: posts small blind $0.50
Ysiven: posts big blind $1
*** HOLE CARDS ***
Kristo 914: folds 
KuningasRane: raises $1.50 to $2.50
BoyLoc0: raises $7.50 to $10
Ysiven: raises $12.50 to $22.50
KuningasRane: folds 
BoyLoc0: folds 
Uncalled bet ($12.50) returned to Ysiven
Ysiven collected $22.50 from pot
Ysiven: doesn't show hand 
*** SUMMARY ***
Total pot $22.50 | Rake $0 
Seat 2: Xenicide
Seat 1: Ysiven (big blind) collected ($22.50)
Seat 3: Kristo 914 folded before Flop (didn't bet)
Seat 5: KuningasRane (button) folded before Flop
Seat 6: BoyLoc0 (small blind) folded before Flop



PokerStars Hand #254638536649:  Hold'em No Limit ($0.50/$1.00 USD) - 2025/01/31 16:51:47 WET [2025/01/31 11:51:47 ET]
Table 'Adria' 6-max Seat #6 is the button
Seat 1: Ysiven ($112.50 in chips) 
Seat 2: Xenicide ($138.07 in chips) 
Seat 3: Kristo 914 ($111.50 in chips) 
Seat 5: KuningasRane ($100 in chips) 
Seat 6: BoyLoc0 ($100 in chips) 
Ysiven: posts small blind $0.50
Xenicide: posts big blind $1
*** HOLE CARDS ***
Kristo 914: folds 
KuningasRane: folds 
BoyLoc0: raises $1.50 to $2.50
Ysiven: raises $9.50 to $12
Xenicide: folds 
BoyLoc0: calls $9.50
*** FLOP *** [9d 2d 3d]
Ysiven: bets $16.50
BoyLoc0: folds 
Uncalled bet ($16.50) returned to Ysiven
Ysiven collected $23.75 from pot
Ysiven: doesn't show hand 
*** SUMMARY ***
Total pot $25 | Rake $1.25 
Board [9d 2d 3d]
Seat 1: Ysiven (small blind) collected ($23.75)
Seat 2: Xenicide (big blind) folded before Flop
Seat 3: Kristo 914 folded before Flop (didn't bet)
Seat 5: KuningasRane folded before Flop (didn't bet)
Seat 6: BoyLoc0 (button) folded on the Flop



PokerStars Hand #254638550335:  Hold'em No Limit ($0.50/$1.00 USD) - 2025/01/31 16:52:48 WET [2025/01/31 11:52:48 ET]
Table 'Adria' 6-max Seat #1 is the button
Seat 1: Ysiven ($124.25 in chips) 
Seat 2: Xenicide ($137.07 in chips) 
Seat 3: Kristo 914 ($111.50 in chips) 
Seat 5: KuningasRane ($100 in chips) 
Seat 6: BoyLoc0 ($100 in chips) 
Xenicide: posts small blind $0.50
Kristo 914: posts big blind $1
*** HOLE CARDS ***
KuningasRane: raises $1.50 to $2.50
BoyLoc0: folds 
Ysiven: folds 
Xenicide: folds 
Kristo 914: folds 
Uncalled bet ($1.50) returned to KuningasRane
KuningasRane collected $2.50 from pot
KuningasRane: doesn't show hand 
*** SUMMARY ***
Total pot $2.50 | Rake $0 
Seat 1: Ysiven (button) folded before Flop (didn't bet)
Seat 2: Xenicide (small blind) folded before Flop
Seat 3: Kristo 914 (big blind) folded before Flop
Seat 5: KuningasRane collected ($2.50)
Seat 6: BoyLoc0 folded before Flop (didn't bet)



PokerStars Hand #254638553340:  Hold'em No Limit ($0.50/$1.00 USD) - 2025/01/31 16:53:02 WET [2025/01/31 11:53:02 ET]
Table 'Adria' 6-max Seat #2 is the button
Seat 1: Ysiven ($124.25 in chips) 
Seat 2: Xenicide ($136.57 in chips) 
Seat 3: Kristo 914 ($110.50 in chips) 
Seat 5: KuningasRane ($101.50 in chips) 
Seat 6: BoyLoc0 ($100 in chips) 
Kristo 914: posts small blind $0.50
KuningasRane: posts big blind $1
*** HOLE CARDS ***
BoyLoc0: folds 
Ysiven: raises $1.30 to $2.30
Xenicide: folds 
Kristo 914: folds 
KuningasRane: raises $6.10 to $8.40
Ysiven: folds 
Uncalled bet ($6.10) returned to KuningasRane
KuningasRane collected $5.10 from pot
KuningasRane: doesn't show hand 
*** SUMMARY ***
Total pot $5.10 | Rake $0 
Seat 1: Ysiven folded before Flop
Seat 2: Xenicide (button) folded before Flop (didn't bet)
Seat 3: Kristo 914 (small blind) folded before Flop
Seat 5: KuningasRane (big blind) collected ($5.10)
Seat 6: BoyLoc0 folded before Flop (didn't bet)



PokerStars Hand #254638561221:  Hold'em No Limit ($0.50/$1.00 USD) - 2025/01/31 16:53:37 WET [2025/01/31 11:53:37 ET]
Table 'Adria' 6-max Seat #3 is the button
Seat 1: Ysiven ($121.95 in chips) 
Seat 2: Xenicide ($136.57 in chips) 
Seat 3: Kristo 914 ($110 in chips) 
Seat 5: KuningasRane ($104.30 in chips) 
Seat 6: BoyLoc0 ($100 in chips) 
KuningasRane: posts small blind $0.50
BoyLoc0: posts big blind $1
*** HOLE CARDS ***
Ysiven: folds 
Xenicide: raises $1 to $2
Kristo 914: folds 
KuningasRane: folds 
BoyLoc0: folds 
Uncalled bet ($1) returned to Xenicide
Xenicide collected $2.50 from pot
*** SUMMARY ***
Total pot $2.50 | Rake $0 
Seat 1: Ysiven folded before Flop (didn't bet)
Seat 2: Xenicide collected ($2.50)
Seat 3: Kristo 914 (button) folded before Flop (didn't bet)
Seat 5: KuningasRane (small blind) folded before Flop
Seat 6: BoyLoc0 (big blind) folded before Flop



PokerStars Hand #254638569345:  Hold'em No Limit ($0.50/$1.00 USD) - 2025/01/31 16:54:13 WET [2025/01/31 11:54:13 ET]
Table 'Adria' 6-max Seat #5 is the button
Seat 1: Ysiven ($121.95 in chips) 
Seat 2: Xenicide ($138.07 in chips) 
Seat 3: Kristo 914 ($110 in chips) 
Seat 5: KuningasRane ($103.80 in chips) 
Seat 6: BoyLoc0 ($100 in chips) 
BoyLoc0: posts small blind $0.50
Ysiven: posts big blind $1
*** HOLE CARDS ***
Xenicide: folds 
Kristo 914: folds 
KuningasRane: folds 
BoyLoc0: raises $2 to $3
Ysiven: folds 
Uncalled bet ($2) returned to BoyLoc0
BoyLoc0 collected $2 from pot
BoyLoc0: doesn't show hand 
*** SUMMARY ***
Total pot $2 | Rake $0 
Seat 1: Ysiven (big blind) folded before Flop
Seat 2: Xenicide folded before Flop (didn't bet)
Seat 3: Kristo 914 folded before Flop (didn't bet)
Seat 5: KuningasRane (button) folded before Flop (didn't bet)
Seat 6: BoyLoc0 (small blind) collected ($2)



PokerStars Hand #254638573484:  Hold'em No Limit ($0.50/$1.00 USD) - 2025/01/31 16:54:31 WET [2025/01/31 11:54:31 ET]
Table 'Adria' 6-max Seat #6 is the button
Seat 1: Ysiven ($120.95 in chips) 
Seat 2: Xenicide ($138.07 in chips) 
Seat 3: Kristo 914 ($110 in chips) 
Seat 5: KuningasRane ($103.80 in chips) 
Seat 6: BoyLoc0 ($101 in chips) 
Ysiven: posts small blind $0.50
Xenicide: posts big blind $1
*** HOLE CARDS ***
MidniteGospel joins the table at seat #4 
Kristo 914: folds 
KuningasRane: raises $1.50 to $2.50
BoyLoc0: folds 
Ysiven: folds 
Xenicide: calls $1.50
*** FLOP *** [6h 4h 8c]
Xenicide: bets $1.62
KuningasRane: raises $3.38 to $5
Xenicide: raises $8.37 to $13.37
KuningasRane: calls $8.37
*** TURN *** [6h 4h 8c] [Kh]
Xenicide: checks 
KuningasRane: checks 
*** RIVER *** [6h 4h 8c Kh] [Qd]
Xenicide: checks 
KuningasRane: checks 
*** SHOW DOWN ***
Xenicide: shows [7d 4d] (a pair of Fours)
KuningasRane: shows [Ts Td] (a pair of Tens)
KuningasRane collected $30.63 from pot
*** SUMMARY ***
Total pot $32.24 | Rake $1.61 
Board [6h 4h 8c Kh Qd]
Seat 1: Ysiven (small blind) folded before Flop
Seat 2: Xenicide (big blind) showed [7d 4d] and lost with a pair of Fours
Seat 3: Kristo 914 folded before Flop (didn't bet)
Seat 5: KuningasRane showed [Ts Td] and won ($30.63) with a pair of Tens
Seat 6: BoyLoc0 (button) folded before Flop (didn't bet)



PokerStars Hand #254638591850:  Hold'em No Limit ($0.50/$1.00 USD) - 2025/01/31 16:56:06 WET [2025/01/31 11:56:06 ET]
Table 'Adria' 6-max Seat #1 is the button
Seat 4: MidniteGospel ($40 in chips) is sitting out
Seat 1: Ysiven ($120.45 in chips) 
Seat 2: Xenicide ($122.20 in chips) 
Seat 3: Kristo 914 ($110 in chips) 
Seat 5: KuningasRane ($118.56 in chips) 
Seat 6: BoyLoc0 ($101 in chips) 
Xenicide: posts small blind $0.50
Kristo 914: posts big blind $1
MidniteGospel: sits out 
*** HOLE CARDS ***
KuningasRane: folds 
BoyLoc0: folds 
Ysiven: raises $1.50 to $2.50
Xenicide: folds 
Kristo 914: folds 
Uncalled bet ($1.50) returned to Ysiven
Ysiven collected $2.50 from pot
Ysiven: doesn't show hand 
*** SUMMARY ***
Total pot $2.50 | Rake $0 
Seat 4: MidniteGospel
Seat 1: Ysiven (button) collected ($2.50)
Seat 2: Xenicide (small blind) folded before Flop
Seat 3: Kristo 914 (big blind) folded before Flop
Seat 5: KuningasRane folded before Flop (didn't bet)
Seat 6: BoyLoc0 folded before Flop (didn't bet)



PokerStars Hand #254638594071:  Hold'em No Limit ($0.50/$1.00 USD) - 2025/01/31 16:56:18 WET [2025/01/31 11:56:18 ET]
Table 'Adria' 6-max Seat #2 is the button
Seat 1: Ysiven ($121.95 in chips) 
Seat 2: Xenicide ($121.70 in chips) 
Seat 3: Kristo 914 ($109 in chips) 
Seat 4: MidniteGospel ($40 in chips) 
Seat 5: KuningasRane ($118.56 in chips) 
Seat 6: BoyLoc0 ($101 in chips) 
Kristo 914: posts small blind $0.50
MidniteGospel: posts big blind $1
*** HOLE CARDS ***
KuningasRane: raises $1.50 to $2.50
BoyLoc0: folds 
Ysiven: folds 
Xenicide: folds 
Kristo 914: folds 
MidniteGospel: calls $1.50
*** FLOP *** [6c 8h 3c]
MidniteGospel: checks 
KuningasRane: checks 
*** TURN *** [6c 8h 3c] [Ad]
MidniteGospel: checks 
KuningasRane: bets $2.09
MidniteGospel: folds 
Uncalled bet ($2.09) returned to KuningasRane
KuningasRane collected $5.22 from pot
KuningasRane: doesn't show hand 
*** SUMMARY ***
Total pot $5.50 | Rake $0.28 
Board [6c 8h 3c Ad]
Seat 1: Ysiven folded before Flop (didn't bet)
Seat 2: Xenicide (button) folded before Flop (didn't bet)
Seat 3: Kristo 914 (small blind) folded before Flop
Seat 4: MidniteGospel (big blind) folded on the Turn
Seat 5: KuningasRane collected ($5.22)
Seat 6: BoyLoc0 folded before Flop (didn't bet)



PokerStars Hand #254638604054:  Hold'em No Limit ($0.50/$1.00 USD) - 2025/01/31 16:57:16 WET [2025/01/31 11:57:16 ET]
Table 'Adria' 6-max Seat #3 is the button
Seat 1: Ysiven ($121.95 in chips) 
Seat 2: Xenicide ($121.70 in chips) 
Seat 3: Kristo 914 ($108.50 in chips) 
Seat 4: MidniteGospel ($37.50 in chips) 
Seat 5: KuningasRane ($121.28 in chips) 
Seat 6: BoyLoc0 ($101 in chips) 
MidniteGospel: posts small blind $0.50
KuningasRane: posts big blind $1
*** HOLE CARDS ***
BoyLoc0: folds 
Ysiven: folds 
Xenicide: folds 
Kristo 914: folds 
MidniteGospel: folds 
Uncalled bet ($0.50) returned to KuningasRane
KuningasRane collected $1 from pot
KuningasRane: doesn't show hand 
*** SUMMARY ***
Total pot $1 | Rake $0 
Seat 1: Ysiven folded before Flop (didn't bet)
Seat 2: Xenicide folded before Flop (didn't bet)
Seat 3: Kristo 914 (button) folded before Flop (didn't bet)
Seat 4: MidniteGospel (small blind) folded before Flop
Seat 5: KuningasRane (big blind) collected ($1)
Seat 6: BoyLoc0 folded before Flop (didn't bet)



PokerStars Hand #254638607645:  Hold'em No Limit ($0.50/$1.00 USD) - 2025/01/31 16:57:36 WET [2025/01/31 11:57:36 ET]
Table 'Adria' 6-max Seat #4 is the button
Seat 1: Ysiven ($121.95 in chips) 
Seat 2: Xenicide ($121.70 in chips) 
Seat 3: Kristo 914 ($108.50 in chips) 
Seat 4: MidniteGospel ($37 in chips) 
Seat 5: KuningasRane ($121.78 in chips) 
Seat 6: BoyLoc0 ($101 in chips) 
KuningasRane: posts small blind $0.50
BoyLoc0: posts big blind $1
*** HOLE CARDS ***
Ysiven: folds 
Xenicide: folds 
Kristo 914: folds 
MidniteGospel: calls $1
KuningasRane: folds 
BoyLoc0: checks 
*** FLOP *** [6h Qs 4c]
BoyLoc0: checks 
MidniteGospel: checks 
*** TURN *** [6h Qs 4c] [Ac]
BoyLoc0: checks 
MidniteGospel: checks 
*** RIVER *** [6h Qs 4c Ac] [Tc]
BoyLoc0: checks 
MidniteGospel: checks 
*** SHOW DOWN ***
BoyLoc0: shows [2d 9d] (high card Ace)
MidniteGospel: shows [5c 5s] (a pair of Fives)
MidniteGospel collected $2.38 from pot
*** SUMMARY ***
Total pot $2.50 | Rake $0.12 
Board [6h Qs 4c Ac Tc]
Seat 1: Ysiven folded before Flop (didn't bet)
Seat 2: Xenicide folded before Flop (didn't bet)
Seat 3: Kristo 914 folded before Flop (didn't bet)
Seat 4: MidniteGospel (button) showed [5c 5s] and won ($2.38) with a pair of Fives
Seat 5: KuningasRane (small blind) folded before Flop
Seat 6: BoyLoc0 (big blind) showed [2d 9d] and lost with high card Ace



PokerStars Hand #254638614155:  Hold'em No Limit ($0.50/$1.00 USD) - 2025/01/31 16:58:14 WET [2025/01/31 11:58:14 ET]
Table 'Adria' 6-max Seat #5 is the button
Seat 1: Ysiven ($121.95 in chips) 
Seat 2: Xenicide ($121.70 in chips) 
Seat 3: Kristo 914 ($108.50 in chips) 
Seat 4: MidniteGospel ($38.38 in chips) 
Seat 5: KuningasRane ($121.28 in chips) 
Seat 6: BoyLoc0 ($100 in chips) 
BoyLoc0: posts small blind $0.50
Ysiven: posts big blind $1
*** HOLE CARDS ***
Xenicide: folds 
Kristo 914: folds 
MidniteGospel: calls $1
KuningasRane: folds 
BoyLoc0: folds 
Ysiven: checks 
*** FLOP *** [4d 6d 2d]
Ysiven: checks 
MidniteGospel: checks 
*** TURN *** [4d 6d 2d] [Qs]
Ysiven: checks 
MidniteGospel: bets $1
Ysiven: calls $1
*** RIVER *** [4d 6d 2d Qs] [4c]
Ysiven: checks 
MidniteGospel: bets $2
Ysiven: calls $2
*** SHOW DOWN ***
MidniteGospel: shows [4h Qd] (a full house, Fours full of Queens)
Ysiven: mucks hand 
MidniteGospel collected $8.08 from pot
*** SUMMARY ***
Total pot $8.50 | Rake $0.42 
Board [4d 6d 2d Qs 4c]
Seat 1: Ysiven (big blind) mucked
Seat 2: Xenicide folded before Flop (didn't bet)
Seat 3: Kristo 914 folded before Flop (didn't bet)
Seat 4: MidniteGospel showed [4h Qd] and won ($8.08) with a full house, Fours full of Queens
Seat 5: KuningasRane (button) folded before Flop (didn't bet)
Seat 6: BoyLoc0 (small blind) folded before Flop



PokerStars Hand #254638625134:  Hold'em No Limit ($0.50/$1.00 USD) - 2025/01/31 16:59:17 WET [2025/01/31 11:59:17 ET]
Table 'Adria' 6-max Seat #6 is the button
Seat 1: Ysiven ($117.95 in chips) 
Seat 2: Xenicide ($121.70 in chips) 
Seat 3: Kristo 914 ($108.50 in chips) 
Seat 4: MidniteGospel ($42.46 in chips) 
Seat 5: KuningasRane ($121.28 in chips) 
Seat 6: BoyLoc0 ($100 in chips) 
Ysiven: posts small blind $0.50
Xenicide: posts big blind $1
*** HOLE CARDS ***
MidniteGospel is disconnected 
Kristo 914: folds 
MidniteGospel is connected 
MidniteGospel has timed out
MidniteGospel: folds 
KuningasRane: folds 
BoyLoc0: folds 
Ysiven: folds 
Uncalled bet ($0.50) returned to Xenicide
Xenicide collected $1 from pot
*** SUMMARY ***
Total pot $1 | Rake $0 
Seat 1: Ysiven (small blind) folded before Flop
Seat 2: Xenicide (big blind) collected ($1)
Seat 3: Kristo 914 folded before Flop (didn't bet)
Seat 4: MidniteGospel folded before Flop (didn't bet)
Seat 5: KuningasRane folded before Flop (didn't bet)
Seat 6: BoyLoc0 (button) folded before Flop (didn't bet)



PokerStars Hand #254638630475:  Hold'em No Limit ($0.50/$1.00 USD) - 2025/01/31 16:59:48 WET [2025/01/31 11:59:48 ET]
Table 'Adria' 6-max Seat #1 is the button
Seat 4: MidniteGospel ($42.46 in chips) is sitting out
Seat 1: Ysiven ($117.45 in chips) 
Seat 2: Xenicide ($122.20 in chips) 
Seat 3: Kristo 914 ($108.50 in chips) 
Seat 5: KuningasRane ($121.28 in chips) 
Seat 6: BoyLoc0 ($100 in chips) 
Xenicide: posts small blind $0.50
Kristo 914: posts big blind $1
*** HOLE CARDS ***
KuningasRane: folds 
BoyLoc0: folds 
Ysiven: folds 
Xenicide: raises $2.50 to $3.50
Kristo 914: calls $2.50
*** FLOP *** [Jh Kh Kc]
Xenicide: bets $2.06
Kristo 914: folds 
Uncalled bet ($2.06) returned to Xenicide
Xenicide collected $6.65 from pot
*** SUMMARY ***
Total pot $7 | Rake $0.35 
Board [Jh Kh Kc]
Seat 4: MidniteGospel
Seat 1: Ysiven (button) folded before Flop (didn't bet)
Seat 2: Xenicide (small blind) collected ($6.65)
Seat 3: Kristo 914 (big blind) folded on the Flop
Seat 5: KuningasRane folded before Flop (didn't bet)
Seat 6: BoyLoc0 folded before Flop (didn't bet)



PokerStars Hand #254638638497:  Hold'em No Limit ($0.50/$1.00 USD) - 2025/01/31 17:00:33 WET [2025/01/31 12:00:33 ET]
Table 'Adria' 6-max Seat #2 is the button
Seat 1: Ysiven ($117.45 in chips) 
Seat 2: Xenicide ($125.35 in chips) 
Seat 3: Kristo 914 ($105 in chips) 
Seat 4: MidniteGospel ($42.46 in chips) 
Seat 5: KuningasRane ($121.28 in chips) 
Seat 6: BoyLoc0 ($100 in chips) 
Kristo 914: posts small blind $0.50
MidniteGospel: posts big blind $1
*** HOLE CARDS ***
KuningasRane: folds 
BoyLoc0: raises $1.50 to $2.50
Ysiven: folds 
Xenicide: folds 
Kristo 914: folds 
MidniteGospel: raises $1.50 to $4
BoyLoc0: calls $1.50
*** FLOP *** [2d 5c 9s]
MidniteGospel: checks 
BoyLoc0: bets $4.04
MidniteGospel: calls $4.04
*** TURN *** [2d 5c 9s] [Td]
MidniteGospel: checks 
BoyLoc0: checks 
*** RIVER *** [2d 5c 9s Td] [5s]
MidniteGospel: checks 
BoyLoc0: bets $5.20
MidniteGospel: calls $5.20
*** SHOW DOWN ***
BoyLoc0: shows [6c 6d] (two pair, Sixes and Fives)
MidniteGospel: shows [7s 7d] (two pair, Sevens and Fives)
MidniteGospel collected $25.63 from pot
*** SUMMARY ***
Total pot $26.98 | Rake $1.35 
Board [2d 5c 9s Td 5s]
Seat 1: Ysiven folded before Flop (didn't bet)
Seat 2: Xenicide (button) folded before Flop (didn't bet)
Seat 3: Kristo 914 (small blind) folded before Flop
Seat 4: MidniteGospel (big blind) showed [7s 7d] and won ($25.63) with two pair, Sevens and Fives
Seat 5: KuningasRane folded before Flop (didn't bet)
Seat 6: BoyLoc0 showed [6c 6d] and lost with two pair, Sixes and Fives



PokerStars Hand #254638653216:  Hold'em No Limit ($0.50/$1.00 USD) - 2025/01/31 17:01:46 WET [2025/01/31 12:01:46 ET]
Table 'Adria' 6-max Seat #3 is the button
Seat 1: Ysiven ($117.45 in chips) 
Seat 2: Xenicide ($125.35 in chips) 
Seat 3: Kristo 914 ($104.50 in chips) 
Seat 4: MidniteGospel ($54.85 in chips) 
Seat 5: KuningasRane ($121.28 in chips) 
Seat 6: BoyLoc0 ($100 in chips) 
MidniteGospel: posts small blind $0.50
KuningasRane: posts big blind $1
*** HOLE CARDS ***
BoyLoc0: folds 
Ysiven: folds 
Xenicide: folds 
Kristo 914: folds 
MidniteGospel: calls $0.50
KuningasRane: raises $2.50 to $3.50
MidniteGospel: folds 
Uncalled bet ($2.50) returned to KuningasRane
KuningasRane collected $2 from pot
KuningasRane: doesn't show hand 
*** SUMMARY ***
Total pot $2 | Rake $0 
Seat 1: Ysiven folded before Flop (didn't bet)
Seat 2: Xenicide folded before Flop (didn't bet)
Seat 3: Kristo 914 (button) folded before Flop (didn't bet)
Seat 4: MidniteGospel (small blind) folded before Flop
Seat 5: KuningasRane (big blind) collected ($2)
Seat 6: BoyLoc0 folded before Flop (didn't bet)



PokerStars Hand #254638664917:  Hold'em No Limit ($0.50/$1.00 USD) - 2025/01/31 17:02:39 WET [2025/01/31 12:02:39 ET]
Table 'Adria' 6-max Seat #4 is the button
Seat 1: Ysiven ($117.45 in chips) 
Seat 2: Xenicide ($125.35 in chips) 
Seat 3: Kristo 914 ($104.50 in chips) 
Seat 4: MidniteGospel ($53.85 in chips) 
Seat 5: KuningasRane ($122.28 in chips) 
Seat 6: BoyLoc0 ($100 in chips) 
KuningasRane: posts small blind $0.50
BoyLoc0: posts big blind $1
*** HOLE CARDS ***
Ysiven: folds 
Xenicide: folds 
Kristo 914: folds 
MidniteGospel: folds 
KuningasRane: folds 
Uncalled bet ($0.50) returned to BoyLoc0
BoyLoc0 collected $1 from pot
BoyLoc0: doesn't show hand 
*** SUMMARY ***
Total pot $1 | Rake $0 
Seat 1: Ysiven folded before Flop (didn't bet)
Seat 2: Xenicide folded before Flop (didn't bet)
Seat 3: Kristo 914 folded before Flop (didn't bet)
Seat 4: MidniteGospel (button) folded before Flop (didn't bet)
Seat 5: KuningasRane (small blind) folded before Flop
Seat 6: BoyLoc0 (big blind) collected ($1)



PokerStars Hand #254638672025:  Hold'em No Limit ($0.50/$1.00 USD) - 2025/01/31 17:03:09 WET [2025/01/31 12:03:09 ET]
Table 'Adria' 6-max Seat #5 is the button
Seat 1: Ysiven ($117.45 in chips) 
Seat 2: Xenicide ($125.35 in chips) 
Seat 3: Kristo 914 ($104.50 in chips) 
Seat 4: MidniteGospel ($53.85 in chips) 
Seat 5: KuningasRane ($121.78 in chips) 
Seat 6: BoyLoc0 ($100.50 in chips) 
BoyLoc0: posts small blind $0.50
Ysiven: posts big blind $1
*** HOLE CARDS ***
Xenicide: folds 
Kristo 914: folds 
MidniteGospel has timed out
MidniteGospel: folds 
KuningasRane: folds 
BoyLoc0: folds 
Uncalled bet ($0.50) returned to Ysiven
Ysiven collected $1 from pot
Ysiven: doesn't show hand 
*** SUMMARY ***
Total pot $1 | Rake $0 
Seat 1: Ysiven (big blind) collected ($1)
Seat 2: Xenicide folded before Flop (didn't bet)
Seat 3: Kristo 914 folded before Flop (didn't bet)
Seat 4: MidniteGospel folded before Flop (didn't bet)
Seat 5: KuningasRane (button) folded before Flop (didn't bet)
Seat 6: BoyLoc0 (small blind) folded before Flop



PokerStars Hand #254638680418:  Hold'em No Limit ($0.50/$1.00 USD) - 2025/01/31 17:03:46 WET [2025/01/31 12:03:46 ET]
Table 'Adria' 6-max Seat #6 is the button
Seat 4: MidniteGospel ($53.85 in chips) is sitting out
Seat 1: Ysiven ($117.95 in chips) 
Seat 2: Xenicide ($125.35 in chips) 
Seat 3: Kristo 914 ($104.50 in chips) 
Seat 5: KuningasRane ($121.78 in chips) 
Seat 6: BoyLoc0 ($100 in chips) 
Ysiven: posts small blind $0.50
Xenicide: posts big blind $1
*** HOLE CARDS ***
Kristo 914: raises $1.40 to $2.40
KuningasRane: folds 
BoyLoc0: folds 
Ysiven: folds 
Xenicide: calls $1.40
*** FLOP *** [8s Tc Ks]
Xenicide: checks 
Kristo 914: bets $4
Xenicide: calls $4
*** TURN *** [8s Tc Ks] [Qs]
Xenicide: bets $3.92
Kristo 914: calls $3.92
*** RIVER *** [8s Tc Ks Qs] [9d]
Xenicide: checks 
Kristo 914: bets $30
Xenicide: folds 
Uncalled bet ($30) returned to Kristo 914
Kristo 914 collected $20.08 from pot
Kristo 914: doesn't show hand 
*** SUMMARY ***
Total pot $21.14 | Rake $1.06 
Board [8s Tc Ks Qs 9d]
Seat 4: MidniteGospel
Seat 1: Ysiven (small blind) folded before Flop
Seat 2: Xenicide (big blind) folded on the River
Seat 3: Kristo 914 collected ($20.08)
Seat 5: KuningasRane folded before Flop (didn't bet)
Seat 6: BoyLoc0 (button) folded before Flop (didn't bet)



PokerStars Hand #254638699971:  Hold'em No Limit ($0.50/$1.00 USD) - 2025/01/31 17:05:12 WET [2025/01/31 12:05:12 ET]
Table 'Adria' 6-max Seat #1 is the button
Seat 4: MidniteGospel ($53.85 in chips) is sitting out
Seat 1: Ysiven ($117.45 in chips) 
Seat 2: Xenicide ($115.03 in chips) 
Seat 3: Kristo 914 ($114.26 in chips) 
Seat 5: KuningasRane ($121.78 in chips) 
Seat 6: BoyLoc0 ($100 in chips) 
Xenicide: posts small blind $0.50
Kristo 914: posts big blind $1
*** HOLE CARDS ***
KuningasRane: folds 
BoyLoc0: folds 
Ysiven: folds 
Xenicide: folds 
Uncalled bet ($0.50) returned to Kristo 914
Kristo 914 collected $1 from pot
Kristo 914: doesn't show hand 
*** SUMMARY ***
Total pot $1 | Rake $0 
Seat 4: MidniteGospel
Seat 1: Ysiven (button) folded before Flop (didn't bet)
Seat 2: Xenicide (small blind) folded before Flop
Seat 3: Kristo 914 (big blind) collected ($1)
Seat 5: KuningasRane folded before Flop (didn't bet)
Seat 6: BoyLoc0 folded before Flop (didn't bet)



PokerStars Hand #254638702724:  Hold'em No Limit ($0.50/$1.00 USD) - 2025/01/31 17:05:24 WET [2025/01/31 12:05:24 ET]
Table 'Adria' 6-max Seat #2 is the button
Seat 4: MidniteGospel ($53.85 in chips) is sitting out
Seat 1: Ysiven ($117.45 in chips) 
Seat 2: Xenicide ($114.53 in chips) 
Seat 3: Kristo 914 ($114.76 in chips) 
Seat 5: KuningasRane ($121.78 in chips) 
Seat 6: BoyLoc0 ($100 in chips) 
Kristo 914: posts small blind $0.50
KuningasRane: posts big blind $1
*** HOLE CARDS ***
BoyLoc0: raises $1.50 to $2.50
Ysiven: folds 
Xenicide: folds 
Kristo 914: folds 
KuningasRane: calls $1.50
*** FLOP *** [7d Qd 2h]
KuningasRane: checks 
BoyLoc0: bets $1.72
KuningasRane: calls $1.72
*** TURN *** [7d Qd 2h] [7h]
KuningasRane: checks 
BoyLoc0: bets $6.37
KuningasRane: raises $19.23 to $25.60
BoyLoc0: calls $19.23
*** RIVER *** [7d Qd 2h 7h] [9s]
KuningasRane: bets $38.35
BoyLoc0: raises $31.83 to $70.18 and is all-in
KuningasRane: calls $31.83
*** SHOW DOWN ***
BoyLoc0: shows [Qh Qc] (a full house, Queens full of Sevens)
KuningasRane: shows [5s 7s] (three of a kind, Sevens)
BoyLoc0 collected $198 from pot
*** SUMMARY ***
Total pot $200.50 | Rake $2.50 
Board [7d Qd 2h 7h 9s]
Seat 4: MidniteGospel
Seat 1: Ysiven folded before Flop (didn't bet)
Seat 2: Xenicide (button) folded before Flop (didn't bet)
Seat 3: Kristo 914 (small blind) folded before Flop
Seat 5: KuningasRane (big blind) showed [5s 7s] and lost with three of a kind, Sevens
Seat 6: BoyLoc0 showed [Qh Qc] and won ($198) with a full house, Queens full of Sevens



PokerStars Hand #254638789366:  Hold'em No Limit ($0.50/$1.00 USD) - 2025/01/31 17:11:39 WET [2025/01/31 12:11:39 ET]
Table 'Adria' 6-max Seat #4 is the button
Seat 1: Ysiven ($100 in chips) 
Seat 2: Xenicide ($113.03 in chips) 
Seat 3: Kristo 914 ($133.24 in chips) 
Seat 4: MidniteGospel ($69.38 in chips) 
Seat 5: KuningasRane ($100 in chips) 
Seat 6: BoyLoc0 ($200.50 in chips) 
KuningasRane: posts small blind $0.50
BoyLoc0: posts big blind $1
*** HOLE CARDS ***
Ysiven: folds 
Xenicide: folds 
Kristo 914: raises $1.40 to $2.40
MidniteGospel: folds 
KuningasRane: folds 
BoyLoc0: folds 
Uncalled bet ($1.40) returned to Kristo 914
Kristo 914 collected $2.50 from pot
Kristo 914: doesn't show hand 
*** SUMMARY ***
Total pot $2.50 | Rake $0 
Seat 1: Ysiven folded before Flop (didn't bet)
Seat 2: Xenicide folded before Flop (didn't bet)
Seat 3: Kristo 914 collected ($2.50)
Seat 4: MidniteGospel (button) folded before Flop (didn't bet)
Seat 5: KuningasRane (small blind) folded before Flop
Seat 6: BoyLoc0 (big blind) folded before Flop



PokerStars Hand #254638792995:  Hold'em No Limit ($0.50/$1.00 USD) - 2025/01/31 17:11:55 WET [2025/01/31 12:11:55 ET]
Table 'Adria' 6-max Seat #5 is the button
Seat 1: Ysiven ($100 in chips) 
Seat 2: Xenicide ($113.03 in chips) 
Seat 3: Kristo 914 ($134.74 in chips) 
Seat 4: MidniteGospel ($69.38 in chips) 
Seat 5: KuningasRane ($100 in chips) 
Seat 6: BoyLoc0 ($199.50 in chips) 
BoyLoc0: posts small blind $0.50
Ysiven: posts big blind $1
*** HOLE CARDS ***
Xenicide: folds 
Kristo 914: folds 
MidniteGospel: calls $1
KuningasRane: folds 
BoyLoc0: folds 
Ysiven: checks 
*** FLOP *** [5c 4c 7s]
Ysiven: checks 
MidniteGospel: bets $1
Ysiven: folds 
Uncalled bet ($1) returned to MidniteGospel
MidniteGospel collected $2.38 from pot
MidniteGospel: doesn't show hand 
*** SUMMARY ***
Total pot $2.50 | Rake $0.12 
Board [5c 4c 7s]
Seat 1: Ysiven (big blind) folded on the Flop
Seat 2: Xenicide folded before Flop (didn't bet)
Seat 3: Kristo 914 folded before Flop (didn't bet)
Seat 4: MidniteGospel collected ($2.38)
Seat 5: KuningasRane (button) folded before Flop (didn't bet)
Seat 6: BoyLoc0 (small blind) folded before Flop



PokerStars Hand #254638801295:  Hold'em No Limit ($0.50/$1.00 USD) - 2025/01/31 17:12:30 WET [2025/01/31 12:12:30 ET]
Table 'Adria' 6-max Seat #6 is the button
Seat 1: Ysiven ($100 in chips) 
Seat 2: Xenicide ($113.03 in chips) 
Seat 3: Kristo 914 ($134.74 in chips) 
Seat 4: MidniteGospel ($70.76 in chips) 
Seat 5: KuningasRane ($100 in chips) 
Seat 6: BoyLoc0 ($199 in chips) 
Ysiven: posts small blind $0.50
Xenicide: posts big blind $1
*** HOLE CARDS ***
Kristo 914: folds 
MidniteGospel: calls $1
KuningasRane: folds 
BoyLoc0: raises $3 to $4
Ysiven: folds 
Xenicide: folds 
MidniteGospel: folds 
Uncalled bet ($3) returned to BoyLoc0
BoyLoc0 collected $3.50 from pot
BoyLoc0: doesn't show hand 
*** SUMMARY ***
Total pot $3.50 | Rake $0 
Seat 1: Ysiven (small blind) folded before Flop
Seat 2: Xenicide (big blind) folded before Flop
Seat 3: Kristo 914 folded before Flop (didn't bet)
Seat 4: MidniteGospel folded before Flop
Seat 5: KuningasRane folded before Flop (didn't bet)
Seat 6: BoyLoc0 (button) collected ($3.50)



PokerStars Hand #254638805787:  Hold'em No Limit ($0.50/$1.00 USD) - 2025/01/31 17:12:49 WET [2025/01/31 12:12:49 ET]
Table 'Adria' 6-max Seat #1 is the button
Seat 1: Ysiven ($100 in chips) 
Seat 2: Xenicide ($112.03 in chips) 
Seat 3: Kristo 914 ($134.74 in chips) 
Seat 4: MidniteGospel ($69.76 in chips) 
Seat 5: KuningasRane ($100 in chips) 
Seat 6: BoyLoc0 ($201.50 in chips) 
Xenicide: posts small blind $0.50
Kristo 914: posts big blind $1
*** HOLE CARDS ***
MidniteGospel: folds 
KuningasRane: folds 
BoyLoc0: folds 
Ysiven: folds 
MidniteGospel leaves the table
Oli3579 joins the table at seat #4 
Xenicide: raises $2.50 to $3.50
Kristo 914: raises $7 to $10.50
Xenicide: folds 
Uncalled bet ($7) returned to Kristo 914
Kristo 914 collected $7 from pot
Kristo 914: doesn't show hand 
*** SUMMARY ***
Total pot $7 | Rake $0 
Seat 1: Ysiven (button) folded before Flop (didn't bet)
Seat 2: Xenicide (small blind) folded before Flop
Seat 3: Kristo 914 (big blind) collected ($7)
Seat 4: MidniteGospel folded before Flop (didn't bet)
Seat 5: KuningasRane folded before Flop (didn't bet)
Seat 6: BoyLoc0 folded before Flop (didn't bet)



PokerStars Hand #254638814045:  Hold'em No Limit ($0.50/$1.00 USD) - 2025/01/31 17:13:24 WET [2025/01/31 12:13:24 ET]
Table 'Adria' 6-max Seat #2 is the button
Seat 1: Ysiven ($100 in chips) 
Seat 2: Xenicide ($108.53 in chips) 
Seat 3: Kristo 914 ($138.24 in chips) 
Seat 4: Oli3579 ($100 in chips) 
Seat 5: KuningasRane ($100 in chips) 
Seat 6: BoyLoc0 ($201.50 in chips) 
Kristo 914: posts small blind $0.50
Oli3579: posts big blind $1
*** HOLE CARDS ***
KuningasRane: folds 
BoyLoc0: folds 
Ysiven: folds 
Xenicide: folds 
Kristo 914: raises $2 to $3
Oli3579: folds 
Uncalled bet ($2) returned to Kristo 914
Kristo 914 collected $2 from pot
Kristo 914: doesn't show hand 
*** SUMMARY ***
Total pot $2 | Rake $0 
Seat 1: Ysiven folded before Flop (didn't bet)
Seat 2: Xenicide (button) folded before Flop (didn't bet)
Seat 3: Kristo 914 (small blind) collected ($2)
Seat 4: Oli3579 (big blind) folded before Flop
Seat 5: KuningasRane folded before Flop (didn't bet)
Seat 6: BoyLoc0 folded before Flop (didn't bet)



PokerStars Hand #254638819711:  Hold'em No Limit ($0.50/$1.00 USD) - 2025/01/31 17:13:48 WET [2025/01/31 12:13:48 ET]
Table 'Adria' 6-max Seat #3 is the button
Seat 1: Ysiven ($100 in chips) 
Seat 2: Xenicide ($108.53 in chips) 
Seat 3: Kristo 914 ($139.24 in chips) 
Seat 4: Oli3579 ($100 in chips) 
Seat 5: KuningasRane ($100 in chips) 
Seat 6: BoyLoc0 ($201.50 in chips) 
Oli3579: posts small blind $0.50
KuningasRane: posts big blind $1
*** HOLE CARDS ***
BoyLoc0: folds 
Ysiven: folds 
Xenicide: raises $1 to $2
Kristo 914: folds 
Oli3579: folds 
KuningasRane: calls $1
*** FLOP *** [9d 2c 5d]
KuningasRane: checks 
Xenicide: bets $1.07
KuningasRane: calls $1.07
*** TURN *** [9d 2c 5d] [Ah]
KuningasRane: checks 
Xenicide: bets $9.46
KuningasRane: raises $17.66 to $27.12
Xenicide: calls $17.66
*** RIVER *** [9d 2c 5d Ah] [8s]
KuningasRane: bets $38.87
Xenicide: calls $38.87
*** SHOW DOWN ***
KuningasRane: shows [9c As] (two pair, Aces and Nines)
Xenicide: mucks hand 
KuningasRane collected $136.12 from pot
*** SUMMARY ***
Total pot $138.62 | Rake $2.50 
Board [9d 2c 5d Ah 8s]
Seat 1: Ysiven folded before Flop (didn't bet)
Seat 2: Xenicide mucked
Seat 3: Kristo 914 (button) folded before Flop (didn't bet)
Seat 4: Oli3579 (small blind) folded before Flop
Seat 5: KuningasRane (big blind) showed [9c As] and won ($136.12) with two pair, Aces and Nines
Seat 6: BoyLoc0 folded before Flop (didn't bet)



PokerStars Hand #254638837733:  Hold'em No Limit ($0.50/$1.00 USD) - 2025/01/31 17:15:04 WET [2025/01/31 12:15:04 ET]
Table 'Adria' 6-max Seat #4 is the button
Seat 1: Ysiven ($100 in chips) 
Seat 2: Xenicide ($100 in chips) 
Seat 3: Kristo 914 ($139.24 in chips) 
Seat 4: Oli3579 ($100 in chips) 
Seat 5: KuningasRane ($167.06 in chips) 
Seat 6: BoyLoc0 ($201.50 in chips) 
KuningasRane: posts small blind $0.50
BoyLoc0: posts big blind $1
*** HOLE CARDS ***
Ysiven: folds 
Xenicide: raises $1 to $2
Kristo 914: folds 
Oli3579: folds 
KuningasRane: raises $6 to $8
BoyLoc0: folds 
Xenicide: calls $6
*** FLOP *** [Qc Qh 9h]
KuningasRane: bets $6.46
Xenicide: folds 
Uncalled bet ($6.46) returned to KuningasRane
KuningasRane collected $16.15 from pot
KuningasRane: doesn't show hand 
*** SUMMARY ***
Total pot $17 | Rake $0.85 
Board [Qc Qh 9h]
Seat 1: Ysiven folded before Flop (didn't bet)
Seat 2: Xenicide folded on the Flop
Seat 3: Kristo 914 folded before Flop (didn't bet)
Seat 4: Oli3579 (button) folded before Flop (didn't bet)
Seat 5: KuningasRane (small blind) collected ($16.15)
Seat 6: BoyLoc0 (big blind) folded before Flop



PokerStars Hand #254638849460:  Hold'em No Limit ($0.50/$1.00 USD) - 2025/01/31 17:15:54 WET [2025/01/31 12:15:54 ET]
Table 'Adria' 6-max Seat #5 is the button
Seat 1: Ysiven ($100 in chips) 
Seat 2: Xenicide ($100 in chips) 
Seat 3: Kristo 914 ($139.24 in chips) 
Seat 4: Oli3579 ($100 in chips) 
Seat 5: KuningasRane ($175.21 in chips) 
Seat 6: BoyLoc0 ($200.50 in chips) 
BoyLoc0: posts small blind $0.50
Ysiven: posts big blind $1
*** HOLE CARDS ***
Xenicide: folds 
Kristo 914: folds 
Oli3579: folds 
KuningasRane: raises $1.50 to $2.50
BoyLoc0: folds 
Ysiven: calls $1.50
*** FLOP *** [Jc As 3s]
Ysiven: checks 
KuningasRane: checks 
*** TURN *** [Jc As 3s] [8c]
Ysiven: checks 
KuningasRane: checks 
*** RIVER *** [Jc As 3s 8c] [Ks]
Ysiven: checks 
KuningasRane: bets $2
Ysiven: folds 
Uncalled bet ($2) returned to KuningasRane
KuningasRane collected $5.22 from pot
KuningasRane: doesn't show hand 
*** SUMMARY ***
Total pot $5.50 | Rake $0.28 
Board [Jc As 3s 8c Ks]
Seat 1: Ysiven (big blind) folded on the River
Seat 2: Xenicide folded before Flop (didn't bet)
Seat 3: Kristo 914 folded before Flop (didn't bet)
Seat 4: Oli3579 folded before Flop (didn't bet)
Seat 5: KuningasRane (button) collected ($5.22)
Seat 6: BoyLoc0 (small blind) folded before Flop



PokerStars Hand #254638865551:  Hold'em No Limit ($0.50/$1.00 USD) - 2025/01/31 17:17:01 WET [2025/01/31 12:17:01 ET]
Table 'Adria' 6-max Seat #6 is the button
Seat 1: Ysiven ($100 in chips) 
Seat 2: Xenicide ($100 in chips) 
Seat 3: Kristo 914 ($139.24 in chips) 
Seat 4: Oli3579 ($100 in chips) 
Seat 5: KuningasRane ($177.93 in chips) 
Seat 6: BoyLoc0 ($200 in chips) 
Ysiven: posts small blind $0.50
Xenicide: posts big blind $1
*** HOLE CARDS ***
Kristo 914: folds 
Oli3579: folds 
KuningasRane: folds 
BoyLoc0: raises $1.50 to $2.50
Ysiven: folds 
Xenicide: calls $1.50
*** FLOP *** [Ah Tc 2d]
Xenicide: checks 
BoyLoc0: bets $3.92
Xenicide: folds 
Uncalled bet ($3.92) returned to BoyLoc0
BoyLoc0 collected $5.22 from pot
BoyLoc0: doesn't show hand 
*** SUMMARY ***
Total pot $5.50 | Rake $0.28 
Board [Ah Tc 2d]
Seat 1: Ysiven (small blind) folded before Flop
Seat 2: Xenicide (big blind) folded on the Flop
Seat 3: Kristo 914 folded before Flop (didn't bet)
Seat 4: Oli3579 folded before Flop (didn't bet)
Seat 5: KuningasRane folded before Flop (didn't bet)
Seat 6: BoyLoc0 (button) collected ($5.22)



PokerStars Hand #254638880505:  Hold'em No Limit ($0.50/$1.00 USD) - 2025/01/31 17:18:03 WET [2025/01/31 12:18:03 ET]
Table 'Adria' 6-max Seat #1 is the button
Seat 1: Ysiven ($100 in chips) 
Seat 2: Xenicide ($100 in chips) 
Seat 3: Kristo 914 ($139.24 in chips) 
Seat 4: Oli3579 ($100 in chips) 
Seat 5: KuningasRane ($177.93 in chips) 
Seat 6: BoyLoc0 ($202.72 in chips) 
Xenicide: posts small blind $0.50
Kristo 914: posts big blind $1
*** HOLE CARDS ***
Oli3579: folds 
KuningasRane: raises $1.50 to $2.50
BoyLoc0: folds 
Ysiven: folds 
Xenicide: folds 
Kristo 914: folds 
Uncalled bet ($1.50) returned to KuningasRane
KuningasRane collected $2.50 from pot
KuningasRane: doesn't show hand 
*** SUMMARY ***
Total pot $2.50 | Rake $0 
Seat 1: Ysiven (button) folded before Flop (didn't bet)
Seat 2: Xenicide (small blind) folded before Flop
Seat 3: Kristo 914 (big blind) folded before Flop
Seat 4: Oli3579 folded before Flop (didn't bet)
Seat 5: KuningasRane collected ($2.50)
Seat 6: BoyLoc0 folded before Flop (didn't bet)



PokerStars Hand #254638885372:  Hold'em No Limit ($0.50/$1.00 USD) - 2025/01/31 17:18:23 WET [2025/01/31 12:18:23 ET]
Table 'Adria' 6-max Seat #2 is the button
Seat 1: Ysiven ($100 in chips) 
Seat 2: Xenicide ($100 in chips) 
Seat 3: Kristo 914 ($138.24 in chips) 
Seat 4: Oli3579 ($100 in chips) 
Seat 5: KuningasRane ($179.43 in chips) 
Seat 6: BoyLoc0 ($202.72 in chips) 
Kristo 914: posts small blind $0.50
Oli3579: posts big blind $1
*** HOLE CARDS ***
KuningasRane: folds 
BoyLoc0: folds 
Ysiven: folds 
Xenicide: folds 
Kristo 914: raises $2 to $3
Oli3579: calls $2
*** FLOP *** [Qd Jh 2c]
Kristo 914: checks 
Oli3579: bets $4.28
Kristo 914: folds 
Uncalled bet ($4.28) returned to Oli3579
Oli3579 collected $5.70 from pot
Oli3579: doesn't show hand 
*** SUMMARY ***
Total pot $6 | Rake $0.30 
Board [Qd Jh 2c]
Seat 1: Ysiven folded before Flop (didn't bet)
Seat 2: Xenicide (button) folded before Flop (didn't bet)
Seat 3: Kristo 914 (small blind) folded on the Flop
Seat 4: Oli3579 (big blind) collected ($5.70)
Seat 5: KuningasRane folded before Flop (didn't bet)
Seat 6: BoyLoc0 folded before Flop (didn't bet)



PokerStars Hand #254638894807:  Hold'em No Limit ($0.50/$1.00 USD) - 2025/01/31 17:19:01 WET [2025/01/31 12:19:01 ET]
Table 'Adria' 6-max Seat #3 is the button
Seat 1: Ysiven ($100 in chips) 
Seat 2: Xenicide ($100 in chips) 
Seat 3: Kristo 914 ($135.24 in chips) 
Seat 4: Oli3579 ($102.70 in chips) 
Seat 5: KuningasRane ($179.43 in chips) 
Seat 6: BoyLoc0 ($202.72 in chips) 
Oli3579: posts small blind $0.50
KuningasRane: posts big blind $1
*** HOLE CARDS ***
BoyLoc0: folds 
Ysiven: folds 
Xenicide: folds 
Kristo 914: raises $1.40 to $2.40
Oli3579: raises $8.60 to $11
KuningasRane: folds 
Kristo 914: raises $12.50 to $23.50
Oli3579: calls $12.50
*** FLOP *** [4d 3s Qc]
Oli3579: checks 
Kristo 914: bets $10.26
Oli3579: calls $10.26
*** TURN *** [4d 3s Qc] [Qs]
Oli3579: checks 
Kristo 914: bets $14.85
Oli3579: folds 
Uncalled bet ($14.85) returned to Kristo 914
Kristo 914 collected $66.02 from pot
Kristo 914: doesn't show hand 
*** SUMMARY ***
Total pot $68.52 | Rake $2.50 
Board [4d 3s Qc Qs]
Seat 1: Ysiven folded before Flop (didn't bet)
Seat 2: Xenicide folded before Flop (didn't bet)
Seat 3: Kristo 914 (button) collected ($66.02)
Seat 4: Oli3579 (small blind) folded on the Turn
Seat 5: KuningasRane (big blind) folded before Flop
Seat 6: BoyLoc0 folded before Flop (didn't bet)



PokerStars Hand #254638921768:  Hold'em No Limit ($0.50/$1.00 USD) - 2025/01/31 17:20:53 WET [2025/01/31 12:20:53 ET]
Table 'Adria' 6-max Seat #4 is the button
Seat 1: Ysiven ($100 in chips) 
Seat 2: Xenicide ($100 in chips) 
Seat 3: Kristo 914 ($167.50 in chips) 
Seat 4: Oli3579 ($100 in chips) 
Seat 5: KuningasRane ($178.43 in chips) 
Seat 6: BoyLoc0 ($202.72 in chips) 
KuningasRane: posts small blind $0.50
BoyLoc0: posts big blind $1
*** HOLE CARDS ***
Ysiven: raises $1 to $2
Xenicide: folds 
Kristo 914: folds 
Oli3579: folds 
KuningasRane: folds 
BoyLoc0: folds 
Uncalled bet ($1) returned to Ysiven
Ysiven collected $2.50 from pot
Ysiven: doesn't show hand 
*** SUMMARY ***
Total pot $2.50 | Rake $0 
Seat 1: Ysiven collected ($2.50)
Seat 2: Xenicide folded before Flop (didn't bet)
Seat 3: Kristo 914 folded before Flop (didn't bet)
Seat 4: Oli3579 (button) folded before Flop (didn't bet)
Seat 5: KuningasRane (small blind) folded before Flop
Seat 6: BoyLoc0 (big blind) folded before Flop



PokerStars Hand #254638925514:  Hold'em No Limit ($0.50/$1.00 USD) - 2025/01/31 17:21:08 WET [2025/01/31 12:21:08 ET]
Table 'Adria' 6-max Seat #5 is the button
Seat 1: Ysiven ($101.50 in chips) 
Seat 2: Xenicide ($100 in chips) 
Seat 3: Kristo 914 ($167.50 in chips) 
Seat 4: Oli3579 ($100 in chips) 
Seat 5: KuningasRane ($177.93 in chips) 
Seat 6: BoyLoc0 ($201.72 in chips) 
BoyLoc0: posts small blind $0.50
Ysiven: posts big blind $1
*** HOLE CARDS ***
Xenicide: folds 
Kristo 914: folds 
Oli3579: raises $1.25 to $2.25
KuningasRane: folds 
BoyLoc0: folds 
Ysiven: folds 
Uncalled bet ($1.25) returned to Oli3579
Oli3579 collected $2.50 from pot
Oli3579: doesn't show hand 
*** SUMMARY ***
Total pot $2.50 | Rake $0 
Seat 1: Ysiven (big blind) folded before Flop
Seat 2: Xenicide folded before Flop (didn't bet)
Seat 3: Kristo 914 folded before Flop (didn't bet)
Seat 4: Oli3579 collected ($2.50)
Seat 5: KuningasRane (button) folded before Flop (didn't bet)
Seat 6: BoyLoc0 (small blind) folded before Flop



PokerStars Hand #254638932162:  Hold'em No Limit ($0.50/$1.00 USD) - 2025/01/31 17:21:36 WET [2025/01/31 12:21:36 ET]
Table 'Adria' 6-max Seat #6 is the button
Seat 1: Ysiven ($100.50 in chips) 
Seat 2: Xenicide ($100 in chips) 
Seat 3: Kristo 914 ($167.50 in chips) 
Seat 4: Oli3579 ($101.50 in chips) 
Seat 5: KuningasRane ($177.93 in chips) 
Seat 6: BoyLoc0 ($201.22 in chips) 
Ysiven: posts small blind $0.50
Xenicide: posts big blind $1
*** HOLE CARDS ***
Kristo 914: raises $1.40 to $2.40
Oli3579: folds 
KuningasRane: folds 
BoyLoc0: folds 
Ysiven: folds 
Xenicide: raises $7.60 to $10
Kristo 914: folds 
Uncalled bet ($7.60) returned to Xenicide
Xenicide collected $5.30 from pot
*** SUMMARY ***
Total pot $5.30 | Rake $0 
Seat 1: Ysiven (small blind) folded before Flop
Seat 2: Xenicide (big blind) collected ($5.30)
Seat 3: Kristo 914 folded before Flop
Seat 4: Oli3579 folded before Flop (didn't bet)
Seat 5: KuningasRane folded before Flop (didn't bet)
Seat 6: BoyLoc0 (button) folded before Flop (didn't bet)



PokerStars Hand #254638945233:  Hold'em No Limit ($0.50/$1.00 USD) - 2025/01/31 17:22:31 WET [2025/01/31 12:22:31 ET]
Table 'Adria' 6-max Seat #1 is the button
Seat 1: Ysiven ($100 in chips) 
Seat 2: Xenicide ($102.90 in chips) 
Seat 3: Kristo 914 ($165.10 in chips) 
Seat 4: Oli3579 ($101.50 in chips) 
Seat 5: KuningasRane ($177.93 in chips) 
Seat 6: BoyLoc0 ($201.22 in chips) 
Xenicide: posts small blind $0.50
Kristo 914: posts big blind $1
*** HOLE CARDS ***
Oli3579: folds 
KuningasRane: folds 
BoyLoc0: folds 
Ysiven: folds 
Xenicide: folds 
Uncalled bet ($0.50) returned to Kristo 914
Kristo 914 collected $1 from pot
Kristo 914: doesn't show hand 
*** SUMMARY ***
Total pot $1 | Rake $0 
Seat 1: Ysiven (button) folded before Flop (didn't bet)
Seat 2: Xenicide (small blind) folded before Flop
Seat 3: Kristo 914 (big blind) collected ($1)
Seat 4: Oli3579 folded before Flop (didn't bet)
Seat 5: KuningasRane folded before Flop (didn't bet)
Seat 6: BoyLoc0 folded before Flop (didn't bet)



PokerStars Hand #254638948532:  Hold'em No Limit ($0.50/$1.00 USD) - 2025/01/31 17:22:45 WET [2025/01/31 12:22:45 ET]
Table 'Adria' 6-max Seat #2 is the button
Seat 1: Ysiven ($100 in chips) 
Seat 2: Xenicide ($102.40 in chips) 
Seat 3: Kristo 914 ($165.60 in chips) 
Seat 4: Oli3579 ($101.50 in chips) 
Seat 5: KuningasRane ($177.93 in chips) 
Seat 6: BoyLoc0 ($201.22 in chips) 
Kristo 914: posts small blind $0.50
Oli3579: posts big blind $1
*** HOLE CARDS ***
KuningasRane: folds 
BoyLoc0: folds 
Ysiven: folds 
Xenicide: folds 
Kristo 914: folds 
Uncalled bet ($0.50) returned to Oli3579
Oli3579 collected $1 from pot
Oli3579: doesn't show hand 
*** SUMMARY ***
Total pot $1 | Rake $0 
Seat 1: Ysiven folded before Flop (didn't bet)
Seat 2: Xenicide (button) folded before Flop (didn't bet)
Seat 3: Kristo 914 (small blind) folded before Flop
Seat 4: Oli3579 (big blind) collected ($1)
Seat 5: KuningasRane folded before Flop (didn't bet)
Seat 6: BoyLoc0 folded before Flop (didn't bet)



PokerStars Hand #254638952082:  Hold'em No Limit ($0.50/$1.00 USD) - 2025/01/31 17:23:00 WET [2025/01/31 12:23:00 ET]
Table 'Adria' 6-max Seat #3 is the button
Seat 1: Ysiven ($100 in chips) 
Seat 2: Xenicide ($102.40 in chips) 
Seat 3: Kristo 914 ($165.10 in chips) 
Seat 4: Oli3579 ($102 in chips) 
Seat 5: KuningasRane ($177.93 in chips) 
Seat 6: BoyLoc0 ($201.22 in chips) 
Oli3579: posts small blind $0.50
KuningasRane: posts big blind $1
*** HOLE CARDS ***
BoyLoc0: folds 
Ysiven: folds 
Xenicide: folds 
Kristo 914: folds 
Oli3579: folds 
Uncalled bet ($0.50) returned to KuningasRane
KuningasRane collected $1 from pot
KuningasRane: doesn't show hand 
*** SUMMARY ***
Total pot $1 | Rake $0 
Seat 1: Ysiven folded before Flop (didn't bet)
Seat 2: Xenicide folded before Flop (didn't bet)
Seat 3: Kristo 914 (button) folded before Flop (didn't bet)
Seat 4: Oli3579 (small blind) folded before Flop
Seat 5: KuningasRane (big blind) collected ($1)
Seat 6: BoyLoc0 folded before Flop (didn't bet)



PokerStars Hand #254638955912:  Hold'em No Limit ($0.50/$1.00 USD) - 2025/01/31 17:23:15 WET [2025/01/31 12:23:15 ET]
Table 'Adria' 6-max Seat #4 is the button
Seat 1: Ysiven ($100 in chips) 
Seat 2: Xenicide ($102.40 in chips) 
Seat 3: Kristo 914 ($165.10 in chips) 
Seat 4: Oli3579 ($101.50 in chips) 
Seat 5: KuningasRane ($178.43 in chips) 
Seat 6: BoyLoc0 ($201.22 in chips) 
KuningasRane: posts small blind $0.50
BoyLoc0: posts big blind $1
*** HOLE CARDS ***
Ysiven: folds 
Xenicide: folds 
Kristo 914: folds 
Oli3579: folds 
KuningasRane: folds 
Uncalled bet ($0.50) returned to BoyLoc0
BoyLoc0 collected $1 from pot
BoyLoc0: doesn't show hand 
*** SUMMARY ***
Total pot $1 | Rake $0 
Seat 1: Ysiven folded before Flop (didn't bet)
Seat 2: Xenicide folded before Flop (didn't bet)
Seat 3: Kristo 914 folded before Flop (didn't bet)
Seat 4: Oli3579 (button) folded before Flop (didn't bet)
Seat 5: KuningasRane (small blind) folded before Flop
Seat 6: BoyLoc0 (big blind) collected ($1)



PokerStars Hand #254638962003:  Hold'em No Limit ($0.50/$1.00 USD) - 2025/01/31 17:23:41 WET [2025/01/31 12:23:41 ET]
Table 'Adria' 6-max Seat #5 is the button
Seat 1: Ysiven ($100 in chips) 
Seat 2: Xenicide ($102.40 in chips) 
Seat 3: Kristo 914 ($165.10 in chips) 
Seat 4: Oli3579 ($101.50 in chips) 
Seat 5: KuningasRane ($177.93 in chips) 
Seat 6: BoyLoc0 ($201.72 in chips) 
BoyLoc0: posts small blind $0.50
Ysiven: posts big blind $1
*** HOLE CARDS ***
Xenicide: folds 
Kristo 914: folds 
Oli3579: folds 
KuningasRane: folds 
BoyLoc0: folds 
Uncalled bet ($0.50) returned to Ysiven
Ysiven collected $1 from pot
Ysiven: doesn't show hand 
*** SUMMARY ***
Total pot $1 | Rake $0 
Seat 1: Ysiven (big blind) collected ($1)
Seat 2: Xenicide folded before Flop (didn't bet)
Seat 3: Kristo 914 folded before Flop (didn't bet)
Seat 4: Oli3579 folded before Flop (didn't bet)
Seat 5: KuningasRane (button) folded before Flop (didn't bet)
Seat 6: BoyLoc0 (small blind) folded before Flop



PokerStars Hand #254638963811:  Hold'em No Limit ($0.50/$1.00 USD) - 2025/01/31 17:23:48 WET [2025/01/31 12:23:48 ET]
Table 'Adria' 6-max Seat #6 is the button
Seat 2: Xenicide ($102.40 in chips) is sitting out
Seat 1: Ysiven ($100.50 in chips) 
Seat 3: Kristo 914 ($165.10 in chips) 
Seat 4: Oli3579 ($101.50 in chips) 
Seat 5: KuningasRane ($177.93 in chips) 
Seat 6: BoyLoc0 ($201.22 in chips) 
Ysiven: posts small blind $0.50
Xenicide: is sitting out 
Kristo 914: posts big blind $1
*** HOLE CARDS ***
Oli3579: folds 
Xenicide leaves the table
KuningasRane: raises $1.50 to $2.50
BoyLoc0: folds 
Ysiven: folds 
Kristo 914: folds 
Uncalled bet ($1.50) returned to KuningasRane
KuningasRane collected $2.50 from pot
KuningasRane: doesn't show hand 
*** SUMMARY ***
Total pot $2.50 | Rake $0 
Seat 2: Xenicide
Seat 1: Ysiven (small blind) folded before Flop
Seat 3: Kristo 914 (big blind) folded before Flop
Seat 4: Oli3579 folded before Flop (didn't bet)
Seat 5: KuningasRane collected ($2.50)
Seat 6: BoyLoc0 (button) folded before Flop (didn't bet)



PokerStars Hand #254638968483:  Hold'em No Limit ($0.50/$1.00 USD) - 2025/01/31 17:24:08 WET [2025/01/31 12:24:08 ET]
Table 'Adria' 6-max Seat #1 is the button
Seat 1: Ysiven ($100 in chips) 
Seat 3: Kristo 914 ($164.10 in chips) 
Seat 4: Oli3579 ($101.50 in chips) 
Seat 5: KuningasRane ($179.43 in chips) 
Seat 6: BoyLoc0 ($201.22 in chips) 
Kristo 914: posts small blind $0.50
Oli3579: posts big blind $1
*** HOLE CARDS ***
KuningasRane: folds 
BoyLoc0: raises $1.50 to $2.50
Ysiven: folds 
Ryantoland25 joins the table at seat #2 
Ryantoland25 is disconnected 
Kristo 914: folds 
Oli3579: calls $1.50
*** FLOP *** [Ah 8c Qd]
Oli3579: checks 
BoyLoc0: bets $3.92
Oli3579: folds 
Uncalled bet ($3.92) returned to BoyLoc0
BoyLoc0 collected $5.22 from pot
BoyLoc0: doesn't show hand 
*** SUMMARY ***
Total pot $5.50 | Rake $0.28 
Board [Ah 8c Qd]
Seat 1: Ysiven (button) folded before Flop (didn't bet)
Seat 3: Kristo 914 (small blind) folded before Flop
Seat 4: Oli3579 (big blind) folded on the Flop
Seat 5: KuningasRane folded before Flop (didn't bet)
Seat 6: BoyLoc0 collected ($5.22)



PokerStars Hand #254638975359:  Hold'em No Limit ($0.50/$1.00 USD) - 2025/01/31 17:24:37 WET [2025/01/31 12:24:37 ET]
Table 'Adria' 6-max Seat #3 is the button
Seat 1: Ysiven ($100 in chips) 
Seat 2: Ryantoland25 ($32.76 in chips) 
Seat 3: Kristo 914 ($163.60 in chips) 
Seat 4: Oli3579 ($100 in chips) 
Seat 5: KuningasRane ($179.43 in chips) 
Seat 6: BoyLoc0 ($203.94 in chips) 
Oli3579: posts small blind $0.50
KuningasRane: posts big blind $1
Ryantoland25: posts big blind $1
*** HOLE CARDS ***
BoyLoc0: folds 
Ysiven: folds 
Ryantoland25: checks 
Kristo 914: folds 
Oli3579: calls $0.50
KuningasRane: raises $4 to $5
Ryantoland25: folds 
Oli3579: folds 
Uncalled bet ($4) returned to KuningasRane
KuningasRane collected $3 from pot
KuningasRane: doesn't show hand 
*** SUMMARY ***
Total pot $3 | Rake $0 
Seat 1: Ysiven folded before Flop (didn't bet)
Seat 2: Ryantoland25 folded before Flop (didn't bet)
Seat 3: Kristo 914 (button) folded before Flop (didn't bet)
Seat 4: Oli3579 (small blind) folded before Flop
Seat 5: KuningasRane (big blind) collected ($3)
Seat 6: BoyLoc0 folded before Flop (didn't bet)



PokerStars Hand #254638981747:  Hold'em No Limit ($0.50/$1.00 USD) - 2025/01/31 17:25:03 WET [2025/01/31 12:25:03 ET]
Table 'Adria' 6-max Seat #4 is the button
Seat 1: Ysiven ($100 in chips) 
Seat 2: Ryantoland25 ($31.76 in chips) 
Seat 3: Kristo 914 ($163.60 in chips) 
Seat 4: Oli3579 ($100 in chips) 
Seat 5: KuningasRane ($181.43 in chips) 
Seat 6: BoyLoc0 ($203.94 in chips) 
KuningasRane: posts small blind $0.50
BoyLoc0: posts big blind $1
*** HOLE CARDS ***
Ysiven: folds 
Ryantoland25: raises $1.50 to $2.50
Kristo 914: folds 
Oli3579: folds 
KuningasRane: calls $2
BoyLoc0: calls $1.50
*** FLOP *** [7h 6c Ts]
KuningasRane: checks 
BoyLoc0: checks 
Ryantoland25: bets $4.56
KuningasRane: folds 
BoyLoc0: calls $4.56
*** TURN *** [7h 6c Ts] [Ac]
BoyLoc0: checks 
Ryantoland25: checks 
*** RIVER *** [7h 6c Ts Ac] [3c]
BoyLoc0: bets $25.69
Ryantoland25: folds 
Uncalled bet ($25.69) returned to BoyLoc0
BoyLoc0 collected $15.79 from pot
BoyLoc0: doesn't show hand 
*** SUMMARY ***
Total pot $16.62 | Rake $0.83 
Board [7h 6c Ts Ac 3c]
Seat 1: Ysiven folded before Flop (didn't bet)
Seat 2: Ryantoland25 folded on the River
Seat 3: Kristo 914 folded before Flop (didn't bet)
Seat 4: Oli3579 (button) folded before Flop (didn't bet)
Seat 5: KuningasRane (small blind) folded on the Flop
Seat 6: BoyLoc0 (big blind) collected ($15.79)



PokerStars Hand #254638993696:  Hold'em No Limit ($0.50/$1.00 USD) - 2025/01/31 17:25:53 WET [2025/01/31 12:25:53 ET]
Table 'Adria' 6-max Seat #5 is the button
Seat 1: Ysiven ($100 in chips) 
Seat 2: Ryantoland25 ($24.70 in chips) 
Seat 3: Kristo 914 ($163.60 in chips) 
Seat 4: Oli3579 ($100 in chips) 
Seat 5: KuningasRane ($178.93 in chips) 
Seat 6: BoyLoc0 ($212.67 in chips) 
BoyLoc0: posts small blind $0.50
Ysiven: posts big blind $1
*** HOLE CARDS ***
Ryantoland25: raises $1.50 to $2.50
Kristo 914: folds 
Oli3579: folds 
KuningasRane: raises $6.50 to $9
BoyLoc0: folds 
Ysiven: folds 
Ryantoland25: raises $15.70 to $24.70 and is all-in
KuningasRane: calls $15.70
*** FLOP *** [Td 6s 8h]
*** TURN *** [Td 6s 8h] [Ad]
*** RIVER *** [Td 6s 8h Ad] [9d]
*** SHOW DOWN ***
Ryantoland25: shows [Qd Ac] (a pair of Aces)
KuningasRane: shows [Ks Kc] (a pair of Kings)
Ryantoland25 collected $48.40 from pot
*** SUMMARY ***
Total pot $50.90 | Rake $2.50 
Board [Td 6s 8h Ad 9d]
Seat 1: Ysiven (big blind) folded before Flop
Seat 2: Ryantoland25 showed [Qd Ac] and won ($48.40) with a pair of Aces
Seat 3: Kristo 914 folded before Flop (didn't bet)
Seat 4: Oli3579 folded before Flop (didn't bet)
Seat 5: KuningasRane (button) showed [Ks Kc] and lost with a pair of Kings
Seat 6: BoyLoc0 (small blind) folded before Flop



PokerStars Hand #254639001703:  Hold'em No Limit ($0.50/$1.00 USD) - 2025/01/31 17:26:26 WET [2025/01/31 12:26:26 ET]
Table 'Adria' 6-max Seat #6 is the button
Seat 1: Ysiven ($100 in chips) 
Seat 2: Ryantoland25 ($48.40 in chips) 
Seat 3: Kristo 914 ($163.60 in chips) 
Seat 4: Oli3579 ($100 in chips) 
Seat 5: KuningasRane ($154.23 in chips) 
Seat 6: BoyLoc0 ($212.17 in chips) 
Ysiven: posts small blind $0.50
Ryantoland25: posts big blind $1
*** HOLE CARDS ***
Kristo 914: folds 
Oli3579: raises $1.25 to $2.25
KuningasRane: calls $2.25
BoyLoc0: folds 
Ysiven: folds 
Ryantoland25: calls $1.25
*** FLOP *** [3h Kd Kh]
Ryantoland25: checks 
Oli3579: checks 
KuningasRane: checks 
*** TURN *** [3h Kd Kh] [4s]
Ryantoland25: bets $4.45
Oli3579: folds 
KuningasRane: folds 
Uncalled bet ($4.45) returned to Ryantoland25
Ryantoland25 collected $6.89 from pot
Kristo 914 leaves the table
*** SUMMARY ***
Total pot $7.25 | Rake $0.36 
Board [3h Kd Kh 4s]
Seat 1: Ysiven (small blind) folded before Flop
Seat 2: Ryantoland25 (big blind) collected ($6.89)
Seat 3: Kristo 914 folded before Flop (didn't bet)
Seat 4: Oli3579 folded on the Turn
Seat 5: KuningasRane folded on the Turn
Seat 6: BoyLoc0 (button) folded before Flop (didn't bet)



PokerStars Hand #254639010893:  Hold'em No Limit ($0.50/$1.00 USD) - 2025/01/31 17:27:05 WET [2025/01/31 12:27:05 ET]
Table 'Adria' 6-max Seat #1 is the button
Seat 1: Ysiven ($100 in chips) 
Seat 2: Ryantoland25 ($53.04 in chips) 
Seat 4: Oli3579 ($100 in chips) 
Seat 5: KuningasRane ($151.98 in chips) 
Seat 6: BoyLoc0 ($212.17 in chips) 
Ryantoland25: posts small blind $0.50
Oli3579: posts big blind $1
*** HOLE CARDS ***
KuningasRane: folds 
BoyLoc0: folds 
Ysiven: raises $1.50 to $2.50
Ryantoland25: folds 
Oli3579: calls $1.50
*** FLOP *** [2s As 6s]
Oli3579: checks 
MaikonAll joins the table at seat #3 
Ysiven: bets $1.72
Oli3579: calls $1.72
*** TURN *** [2s As 6s] [7c]
Oli3579: checks 
Ysiven: checks 
*** RIVER *** [2s As 6s 7c] [Tc]
Oli3579: checks 
Ysiven: checks 
*** SHOW DOWN ***
Oli3579: shows [8s 8c] (a pair of Eights)
Ysiven: shows [Ks Kh] (a pair of Kings)
Ysiven collected $8.49 from pot
*** SUMMARY ***
Total pot $8.94 | Rake $0.45 
Board [2s As 6s 7c Tc]
Seat 1: Ysiven (button) showed [Ks Kh] and won ($8.49) with a pair of Kings
Seat 2: Ryantoland25 (small blind) folded before Flop
Seat 4: Oli3579 (big blind) showed [8s 8c] and lost with a pair of Eights
Seat 5: KuningasRane folded before Flop (didn't bet)
Seat 6: BoyLoc0 folded before Flop (didn't bet)



PokerStars Hand #254639027458:  Hold'em No Limit ($0.50/$1.00 USD) - 2025/01/31 17:28:14 WET [2025/01/31 12:28:14 ET]
Table 'Adria' 6-max Seat #2 is the button
Seat 3: MaikonAll ($100 in chips) is sitting out
Seat 1: Ysiven ($104.27 in chips) 
Seat 2: Ryantoland25 ($52.54 in chips) 
Seat 4: Oli3579 ($100 in chips) 
Seat 5: KuningasRane ($151.98 in chips) 
Seat 6: BoyLoc0 ($212.17 in chips) 
Oli3579: posts small blind $0.50
KuningasRane: posts big blind $1
*** HOLE CARDS ***
BoyLoc0: folds 
Ysiven: folds 
Ryantoland25: folds 
Oli3579: folds 
Uncalled bet ($0.50) returned to KuningasRane
KuningasRane collected $1 from pot
KuningasRane: doesn't show hand 
*** SUMMARY ***
Total pot $1 | Rake $0 
Seat 3: MaikonAll
Seat 1: Ysiven folded before Flop (didn't bet)
Seat 2: Ryantoland25 (button) folded before Flop (didn't bet)
Seat 4: Oli3579 (small blind) folded before Flop
Seat 5: KuningasRane (big blind) collected ($1)
Seat 6: BoyLoc0 folded before Flop (didn't bet)



PokerStars Hand #254639033148:  Hold'em No Limit ($0.50/$1.00 USD) - 2025/01/31 17:28:38 WET [2025/01/31 12:28:38 ET]
Table 'Adria' 6-max Seat #4 is the button
Seat 3: MaikonAll ($100 in chips) is sitting out
Seat 1: Ysiven ($104.27 in chips) 
Seat 2: Ryantoland25 ($52.54 in chips) 
Seat 4: Oli3579 ($100 in chips) 
Seat 5: KuningasRane ($152.48 in chips) 
Seat 6: BoyLoc0 ($212.17 in chips) 
KuningasRane: posts small blind $0.50
BoyLoc0: posts big blind $1
MaikonAll: sits out 
*** HOLE CARDS ***
Ysiven: folds 
Ryantoland25: raises $1.50 to $2.50
Oli3579: folds 
KuningasRane: folds 
BoyLoc0: folds 
Uncalled bet ($1.50) returned to Ryantoland25
Ryantoland25 collected $2.50 from pot
*** SUMMARY ***
Total pot $2.50 | Rake $0 
Seat 3: MaikonAll
Seat 1: Ysiven folded before Flop (didn't bet)
Seat 2: Ryantoland25 collected ($2.50)
Seat 4: Oli3579 (button) folded before Flop (didn't bet)
Seat 5: KuningasRane (small blind) folded before Flop
Seat 6: BoyLoc0 (big blind) folded before Flop



PokerStars Hand #254639036933:  Hold'em No Limit ($0.50/$1.00 USD) - 2025/01/31 17:28:53 WET [2025/01/31 12:28:53 ET]
Table 'Adria' 6-max Seat #5 is the button
Seat 3: MaikonAll ($100 in chips) is sitting out
Seat 1: Ysiven ($104.27 in chips) 
Seat 2: Ryantoland25 ($54.04 in chips) 
Seat 4: Oli3579 ($100 in chips) 
Seat 5: KuningasRane ($151.98 in chips) 
Seat 6: BoyLoc0 ($211.17 in chips) 
BoyLoc0: posts small blind $0.50
Ysiven: posts big blind $1
MaikonAll: sits out 
*** HOLE CARDS ***
Ryantoland25: folds 
Oli3579: raises $1.25 to $2.25
KuningasRane: folds 
BoyLoc0: folds 
Ysiven: folds 
Uncalled bet ($1.25) returned to Oli3579
Oli3579 collected $2.50 from pot
Oli3579: doesn't show hand 
*** SUMMARY ***
Total pot $2.50 | Rake $0 
Seat 3: MaikonAll
Seat 1: Ysiven (big blind) folded before Flop
Seat 2: Ryantoland25 folded before Flop (didn't bet)
Seat 4: Oli3579 collected ($2.50)
Seat 5: KuningasRane (button) folded before Flop (didn't bet)
Seat 6: BoyLoc0 (small blind) folded before Flop



PokerStars Hand #254639040294:  Hold'em No Limit ($0.50/$1.00 USD) - 2025/01/31 17:29:07 WET [2025/01/31 12:29:07 ET]
Table 'Adria' 6-max Seat #6 is the button
Seat 3: MaikonAll ($100 in chips) is sitting out
Seat 1: Ysiven ($103.27 in chips) 
Seat 2: Ryantoland25 ($54.04 in chips) 
Seat 4: Oli3579 ($101.50 in chips) 
Seat 5: KuningasRane ($151.98 in chips) 
Seat 6: BoyLoc0 ($210.67 in chips) 
Ysiven: posts small blind $0.50
Ryantoland25: posts big blind $1
MaikonAll: sits out 
*** HOLE CARDS ***
Oli3579: folds 
KuningasRane: folds 
BoyLoc0: folds 
Ysiven: folds 
Uncalled bet ($0.50) returned to Ryantoland25
Ryantoland25 collected $1 from pot
*** SUMMARY ***
Total pot $1 | Rake $0 
Seat 3: MaikonAll
Seat 1: Ysiven (small blind) folded before Flop
Seat 2: Ryantoland25 (big blind) collected ($1)
Seat 4: Oli3579 folded before Flop (didn't bet)
Seat 5: KuningasRane folded before Flop (didn't bet)
Seat 6: BoyLoc0 (button) folded before Flop (didn't bet)



PokerStars Hand #254639042568:  Hold'em No Limit ($0.50/$1.00 USD) - 2025/01/31 17:29:17 WET [2025/01/31 12:29:17 ET]
Table 'Adria' 6-max Seat #1 is the button
Seat 1: Ysiven ($102.77 in chips) 
Seat 2: Ryantoland25 ($54.54 in chips) 
Seat 3: MaikonAll ($100 in chips) 
Seat 4: Oli3579 ($101.50 in chips) 
Seat 5: KuningasRane ($151.98 in chips) 
Seat 6: BoyLoc0 ($210.67 in chips) 
Ryantoland25: posts small blind $0.50
MaikonAll: posts big blind $1
*** HOLE CARDS ***
Oli3579: folds 
KuningasRane: raises $1.50 to $2.50
BoyLoc0: folds 
Ysiven: folds 
Ryantoland25: calls $2
MaikonAll: folds 
*** FLOP *** [8d Jh Jd]
Ryantoland25: checks 
KuningasRane: checks 
*** TURN *** [8d Jh Jd] [3c]
Ryantoland25: bets $4.85
KuningasRane: folds 
Uncalled bet ($4.85) returned to Ryantoland25
Ryantoland25 collected $5.70 from pot
*** SUMMARY ***
Total pot $6 | Rake $0.30 
Board [8d Jh Jd 3c]
Seat 1: Ysiven (button) folded before Flop (didn't bet)
Seat 2: Ryantoland25 (small blind) collected ($5.70)
Seat 3: MaikonAll (big blind) folded before Flop
Seat 4: Oli3579 folded before Flop (didn't bet)
Seat 5: KuningasRane folded on the Turn
Seat 6: BoyLoc0 folded before Flop (didn't bet)



PokerStars Hand #254639050235:  Hold'em No Limit ($0.50/$1.00 USD) - 2025/01/31 17:29:49 WET [2025/01/31 12:29:49 ET]
Table 'Adria' 6-max Seat #2 is the button
Seat 1: Ysiven ($102.77 in chips) 
Seat 2: Ryantoland25 ($57.74 in chips) 
Seat 3: MaikonAll ($100 in chips) 
Seat 4: Oli3579 ($101.50 in chips) 
Seat 5: KuningasRane ($149.48 in chips) 
Seat 6: BoyLoc0 ($210.67 in chips) 
MaikonAll: posts small blind $0.50
Oli3579: posts big blind $1
*** HOLE CARDS ***
KuningasRane: folds 
BoyLoc0: raises $1.50 to $2.50
Ysiven: folds 
Ryantoland25: calls $2.50
MaikonAll: folds 
Oli3579: folds 
*** FLOP *** [Qh 2s 5s]
BoyLoc0: checks 
Ryantoland25: checks 
*** TURN *** [Qh 2s 5s] [Ah]
BoyLoc0: bets $4.64
Ryantoland25: calls $4.64
*** RIVER *** [Qh 2s 5s Ah] [3h]
BoyLoc0: checks 
Ryantoland25: bets $16.99
BoyLoc0: calls $16.99
*** SHOW DOWN ***
Ryantoland25: shows [4h Th] (a flush, Ace high)
BoyLoc0: mucks hand 
Ryantoland25 collected $47.27 from pot
*** SUMMARY ***
Total pot $49.76 | Rake $2.49 
Board [Qh 2s 5s Ah 3h]
Seat 1: Ysiven folded before Flop (didn't bet)
Seat 2: Ryantoland25 (button) showed [4h Th] and won ($47.27) with a flush, Ace high
Seat 3: MaikonAll (small blind) folded before Flop
Seat 4: Oli3579 (big blind) folded before Flop
Seat 5: KuningasRane folded before Flop (didn't bet)
Seat 6: BoyLoc0 mucked



PokerStars Hand #254639066239:  Hold'em No Limit ($0.50/$1.00 USD) - 2025/01/31 17:30:54 WET [2025/01/31 12:30:54 ET]
Table 'Adria' 6-max Seat #3 is the button
Seat 1: Ysiven ($102.77 in chips) 
Seat 2: Ryantoland25 ($80.88 in chips) 
Seat 3: MaikonAll ($100 in chips) 
Seat 4: Oli3579 ($100.50 in chips) 
Seat 5: KuningasRane ($149.48 in chips) 
Seat 6: BoyLoc0 ($186.54 in chips) 
Oli3579: posts small blind $0.50
KuningasRane: posts big blind $1
*** HOLE CARDS ***
BoyLoc0: raises $1.50 to $2.50
Ysiven: folds 
Ryantoland25: folds 
MaikonAll: folds 
Oli3579: folds 
KuningasRane: calls $1.50
*** FLOP *** [3h 9d 7h]
KuningasRane: checks 
BoyLoc0: bets $3.92
KuningasRane: raises $9.14 to $13.06
BoyLoc0: folds 
Uncalled bet ($9.14) returned to KuningasRane
KuningasRane collected $12.67 from pot
KuningasRane: doesn't show hand 
*** SUMMARY ***
Total pot $13.34 | Rake $0.67 
Board [3h 9d 7h]
Seat 1: Ysiven folded before Flop (didn't bet)
Seat 2: Ryantoland25 folded before Flop (didn't bet)
Seat 3: MaikonAll (button) folded before Flop (didn't bet)
Seat 4: Oli3579 (small blind) folded before Flop
Seat 5: KuningasRane (big blind) collected ($12.67)
Seat 6: BoyLoc0 folded on the Flop



PokerStars Hand #254639073966:  Hold'em No Limit ($0.50/$1.00 USD) - 2025/01/31 17:31:25 WET [2025/01/31 12:31:25 ET]
Table 'Adria' 6-max Seat #4 is the button
Seat 1: Ysiven ($102.77 in chips) 
Seat 2: Ryantoland25 ($80.88 in chips) 
Seat 3: MaikonAll ($100 in chips) 
Seat 4: Oli3579 ($100 in chips) 
Seat 5: KuningasRane ($155.73 in chips) 
Seat 6: BoyLoc0 ($180.12 in chips) 
KuningasRane: posts small blind $0.50
BoyLoc0: posts big blind $1
*** HOLE CARDS ***
Ysiven: folds 
Ryantoland25: folds 
MaikonAll: folds 
Oli3579: folds 
KuningasRane: folds 
Uncalled bet ($0.50) returned to BoyLoc0
BoyLoc0 collected $1 from pot
BoyLoc0: doesn't show hand 
*** SUMMARY ***
Total pot $1 | Rake $0 
Seat 1: Ysiven folded before Flop (didn't bet)
Seat 2: Ryantoland25 folded before Flop (didn't bet)
Seat 3: MaikonAll folded before Flop (didn't bet)
Seat 4: Oli3579 (button) folded before Flop (didn't bet)
Seat 5: KuningasRane (small blind) folded before Flop
Seat 6: BoyLoc0 (big blind) collected ($1)



PokerStars Hand #254639076804:  Hold'em No Limit ($0.50/$1.00 USD) - 2025/01/31 17:31:37 WET [2025/01/31 12:31:37 ET]
Table 'Adria' 6-max Seat #5 is the button
Seat 1: Ysiven ($102.77 in chips) 
Seat 2: Ryantoland25 ($80.88 in chips) 
Seat 3: MaikonAll ($100 in chips) 
Seat 4: Oli3579 ($100 in chips) 
Seat 5: KuningasRane ($155.23 in chips) 
Seat 6: BoyLoc0 ($180.62 in chips) 
BoyLoc0: posts small blind $0.50
Ysiven: posts big blind $1
*** HOLE CARDS ***
Ryantoland25: folds 
MaikonAll: folds 
Oli3579: raises $1.25 to $2.25
KuningasRane: folds 
BoyLoc0: folds 
Ysiven: folds 
Uncalled bet ($1.25) returned to Oli3579
Oli3579 collected $2.50 from pot
Oli3579: doesn't show hand 
*** SUMMARY ***
Total pot $2.50 | Rake $0 
Seat 1: Ysiven (big blind) folded before Flop
Seat 2: Ryantoland25 folded before Flop (didn't bet)
Seat 3: MaikonAll folded before Flop (didn't bet)
Seat 4: Oli3579 collected ($2.50)
Seat 5: KuningasRane (button) folded before Flop (didn't bet)
Seat 6: BoyLoc0 (small blind) folded before Flop



PokerStars Hand #254639081233:  Hold'em No Limit ($0.50/$1.00 USD) - 2025/01/31 17:31:55 WET [2025/01/31 12:31:55 ET]
Table 'Adria' 6-max Seat #6 is the button
Seat 1: Ysiven ($101.77 in chips) 
Seat 2: Ryantoland25 ($80.88 in chips) 
Seat 3: MaikonAll ($100 in chips) 
Seat 4: Oli3579 ($101.50 in chips) 
Seat 5: KuningasRane ($155.23 in chips) 
Seat 6: BoyLoc0 ($180.12 in chips) 
Ysiven: posts small blind $0.50
Ryantoland25: posts big blind $1
*** HOLE CARDS ***
MaikonAll: folds 
Oli3579: folds 
KuningasRane: raises $1.50 to $2.50
BoyLoc0: folds 
Ysiven: folds 
Ryantoland25: calls $1.50
*** FLOP *** [7d Jh 3d]
Ryantoland25: checks 
KuningasRane: bets $2.09
Ryantoland25: calls $2.09
*** TURN *** [7d Jh 3d] [Kd]
Ryantoland25: checks 
KuningasRane: bets $3.68
Ryantoland25: calls $3.68
*** RIVER *** [7d Jh 3d Kd] [Kh]
Ryantoland25: bets $17.19
KuningasRane: calls $17.19
*** SHOW DOWN ***
Ryantoland25: shows [5d Qd] (a flush, King high)
KuningasRane: mucks hand 
Ryantoland25 collected $48.92 from pot
*** SUMMARY ***
Total pot $51.42 | Rake $2.50 
Board [7d Jh 3d Kd Kh]
Seat 1: Ysiven (small blind) folded before Flop
Seat 2: Ryantoland25 (big blind) showed [5d Qd] and won ($48.92) with a flush, King high
Seat 3: MaikonAll folded before Flop (didn't bet)
Seat 4: Oli3579 folded before Flop (didn't bet)
Seat 5: KuningasRane mucked
Seat 6: BoyLoc0 (button) folded before Flop (didn't bet)



PokerStars Hand #254639094021:  Hold'em No Limit ($0.50/$1.00 USD) - 2025/01/31 17:32:46 WET [2025/01/31 12:32:46 ET]
Table 'Adria' 6-max Seat #1 is the button
Seat 1: Ysiven ($101.27 in chips) 
Seat 2: Ryantoland25 ($104.34 in chips) 
Seat 3: MaikonAll ($100 in chips) 
Seat 4: Oli3579 ($101.50 in chips) 
Seat 5: KuningasRane ($129.77 in chips) 
Seat 6: BoyLoc0 ($180.12 in chips) 
Ryantoland25: posts small blind $0.50
MaikonAll: posts big blind $1
*** HOLE CARDS ***
Oli3579: folds 
KuningasRane: folds 
BoyLoc0: folds 
Ysiven: folds 
Ryantoland25: raises $1 to $2
MaikonAll: calls $1
*** FLOP *** [Ts As 7d]
Ryantoland25: checks 
MaikonAll: checks 
*** TURN *** [Ts As 7d] [9s]
Ryantoland25: checks 
MaikonAll: bets $2.85
Ryantoland25: folds 
Uncalled bet ($2.85) returned to MaikonAll
MaikonAll collected $3.80 from pot
MaikonAll: doesn't show hand 
*** SUMMARY ***
Total pot $4 | Rake $0.20 
Board [Ts As 7d 9s]
Seat 1: Ysiven (button) folded before Flop (didn't bet)
Seat 2: Ryantoland25 (small blind) folded on the Turn
Seat 3: MaikonAll (big blind) collected ($3.80)
Seat 4: Oli3579 folded before Flop (didn't bet)
Seat 5: KuningasRane folded before Flop (didn't bet)
Seat 6: BoyLoc0 folded before Flop (didn't bet)



PokerStars Hand #254639105492:  Hold'em No Limit ($0.50/$1.00 USD) - 2025/01/31 17:33:33 WET [2025/01/31 12:33:33 ET]
Table 'Adria' 6-max Seat #2 is the button
Seat 1: Ysiven ($101.27 in chips) 
Seat 2: Ryantoland25 ($102.34 in chips) 
Seat 3: MaikonAll ($101.80 in chips) 
Seat 4: Oli3579 ($101.50 in chips) 
Seat 5: KuningasRane ($129.77 in chips) 
Seat 6: BoyLoc0 ($180.12 in chips) 
MaikonAll: posts small blind $0.50
Oli3579: posts big blind $1
*** HOLE CARDS ***
KuningasRane: folds 
BoyLoc0: folds 
Ysiven: raises $1.30 to $2.30
Ryantoland25: folds 
Ryantoland25 leaves the table
MaikonAll: raises $8.70 to $11
Oli3579: folds 
Ysiven: calls $8.70
*** FLOP *** [6d 8c 3c]
MaikonAll: bets $10.93
Ysiven: folds 
Uncalled bet ($10.93) returned to MaikonAll
MaikonAll collected $21.85 from pot
MaikonAll: doesn't show hand 
*** SUMMARY ***
Total pot $23 | Rake $1.15 
Board [6d 8c 3c]
Seat 1: Ysiven folded on the Flop
Seat 2: Ryantoland25 (button) folded before Flop (didn't bet)
Seat 3: MaikonAll (small blind) collected ($21.85)
Seat 4: Oli3579 (big blind) folded before Flop
Seat 5: KuningasRane folded before Flop (didn't bet)
Seat 6: BoyLoc0 folded before Flop (didn't bet)



PokerStars Hand #254639120615:  Hold'em No Limit ($0.50/$1.00 USD) - 2025/01/31 17:34:35 WET [2025/01/31 12:34:35 ET]
Table 'Adria' 6-max Seat #3 is the button
Seat 1: Ysiven ($100 in chips) 
Seat 3: MaikonAll ($112.65 in chips) 
Seat 4: Oli3579 ($100.50 in chips) 
Seat 5: KuningasRane ($129.77 in chips) 
Seat 6: BoyLoc0 ($180.12 in chips) 
Oli3579: posts small blind $0.50
KuningasRane: posts big blind $1
*** HOLE CARDS ***
BoyLoc0: raises $1.50 to $2.50
Ysiven: folds 
MaikonAll: folds 
Oli3579: folds 
KuningasRane: folds 
Uncalled bet ($1.50) returned to BoyLoc0
BoyLoc0 collected $2.50 from pot
BoyLoc0: doesn't show hand 
*** SUMMARY ***
Total pot $2.50 | Rake $0 
Seat 1: Ysiven folded before Flop (didn't bet)
Seat 3: MaikonAll (button) folded before Flop (didn't bet)
Seat 4: Oli3579 (small blind) folded before Flop
Seat 5: KuningasRane (big blind) folded before Flop
Seat 6: BoyLoc0 collected ($2.50)



PokerStars Hand #254639123621:  Hold'em No Limit ($0.50/$1.00 USD) - 2025/01/31 17:34:48 WET [2025/01/31 12:34:48 ET]
Table 'Adria' 6-max Seat #4 is the button
Seat 1: Ysiven ($100 in chips) 
Seat 3: MaikonAll ($112.65 in chips) 
Seat 4: Oli3579 ($100 in chips) 
Seat 5: KuningasRane ($128.77 in chips) 
Seat 6: BoyLoc0 ($181.62 in chips) 
KuningasRane: posts small blind $0.50
BoyLoc0: posts big blind $1
*** HOLE CARDS ***
Ysiven: folds 
chelsea16730 joins the table at seat #2 
chelsea16730 is disconnected 
MaikonAll: folds 
Oli3579: folds 
KuningasRane: raises $1.50 to $2.50
BoyLoc0: calls $1.50
*** FLOP *** [9d 4s Tc]
KuningasRane: bets $1.90
BoyLoc0: calls $1.90
*** TURN *** [9d 4s Tc] [6s]
KuningasRane: bets $3.34
BoyLoc0: folds 
Uncalled bet ($3.34) returned to KuningasRane
KuningasRane collected $8.36 from pot
KuningasRane: doesn't show hand 
*** SUMMARY ***
Total pot $8.80 | Rake $0.44 
Board [9d 4s Tc 6s]
Seat 1: Ysiven folded before Flop (didn't bet)
Seat 3: MaikonAll folded before Flop (didn't bet)
Seat 4: Oli3579 (button) folded before Flop (didn't bet)
Seat 5: KuningasRane (small blind) collected ($8.36)
Seat 6: BoyLoc0 (big blind) folded on the Turn



PokerStars Hand #254639133340:  Hold'em No Limit ($0.50/$1.00 USD) - 2025/01/31 17:35:27 WET [2025/01/31 12:35:27 ET]
Table 'Adria' 6-max Seat #5 is the button
Seat 1: Ysiven ($100 in chips) 
Seat 2: chelsea16730 ($37.40 in chips) 
Seat 3: MaikonAll ($112.65 in chips) 
Seat 4: Oli3579 ($100 in chips) 
Seat 5: KuningasRane ($132.73 in chips) 
Seat 6: BoyLoc0 ($177.22 in chips) 
BoyLoc0: posts small blind $0.50
Ysiven: posts big blind $1
chelsea16730: posts big blind $1
*** HOLE CARDS ***
chelsea16730: checks 
MaikonAll: folds 
Oli3579: folds 
KuningasRane: folds 
BoyLoc0: folds 
Ysiven: checks 
*** FLOP *** [3d 9c 8c]
Ysiven: checks 
chelsea16730: checks 
*** TURN *** [3d 9c 8c] [7h]
Ysiven: bets $1
chelsea16730: raises $2 to $3
Ysiven: folds 
Uncalled bet ($2) returned to chelsea16730
chelsea16730 collected $4.28 from pot
*** SUMMARY ***
Total pot $4.50 | Rake $0.22 
Board [3d 9c 8c 7h]
Seat 1: Ysiven (big blind) folded on the Turn
Seat 2: chelsea16730 collected ($4.28)
Seat 3: MaikonAll folded before Flop (didn't bet)
Seat 4: Oli3579 folded before Flop (didn't bet)
Seat 5: KuningasRane (button) folded before Flop (didn't bet)
Seat 6: BoyLoc0 (small blind) folded before Flop



PokerStars Hand #254639143481:  Hold'em No Limit ($0.50/$1.00 USD) - 2025/01/31 17:36:09 WET [2025/01/31 12:36:09 ET]
Table 'Adria' 6-max Seat #6 is the button
Seat 1: Ysiven ($100 in chips) 
Seat 2: chelsea16730 ($39.68 in chips) 
Seat 3: MaikonAll ($112.65 in chips) 
Seat 4: Oli3579 ($100 in chips) 
Seat 5: KuningasRane ($132.73 in chips) 
Seat 6: BoyLoc0 ($176.72 in chips) 
Ysiven: posts small blind $0.50
chelsea16730: posts big blind $1
*** HOLE CARDS ***
MaikonAll: folds 
Oli3579: folds 
KuningasRane: raises $1.50 to $2.50
BoyLoc0: folds 
Ysiven: folds 
chelsea16730: calls $1.50
*** FLOP *** [6s 2d 6h]
chelsea16730: checks 
KuningasRane: checks 
*** TURN *** [6s 2d 6h] [As]
chelsea16730: checks 
KuningasRane: bets $2.09
chelsea16730: calls $2.09
*** RIVER *** [6s 2d 6h As] [5c]
chelsea16730: checks 
KuningasRane: checks 
*** SHOW DOWN ***
chelsea16730: shows [9h 9s] (two pair, Nines and Sixes)
KuningasRane: mucks hand 
chelsea16730 collected $9.20 from pot
*** SUMMARY ***
Total pot $9.68 | Rake $0.48 
Board [6s 2d 6h As 5c]
Seat 1: Ysiven (small blind) folded before Flop
Seat 2: chelsea16730 (big blind) showed [9h 9s] and won ($9.20) with two pair, Nines and Sixes
Seat 3: MaikonAll folded before Flop (didn't bet)
Seat 4: Oli3579 folded before Flop (didn't bet)
Seat 5: KuningasRane mucked
Seat 6: BoyLoc0 (button) folded before Flop (didn't bet)



PokerStars Hand #254639151672:  Hold'em No Limit ($0.50/$1.00 USD) - 2025/01/31 17:36:43 WET [2025/01/31 12:36:43 ET]
Table 'Adria' 6-max Seat #1 is the button
Seat 1: Ysiven ($100 in chips) 
Seat 2: chelsea16730 ($44.29 in chips) 
Seat 3: MaikonAll ($112.65 in chips) 
Seat 4: Oli3579 ($100 in chips) 
Seat 5: KuningasRane ($128.14 in chips) 
Seat 6: BoyLoc0 ($176.72 in chips) 
chelsea16730: posts small blind $0.50
MaikonAll: posts big blind $1
*** HOLE CARDS ***
Oli3579: folds 
KuningasRane: folds 
BoyLoc0: raises $1.50 to $2.50
Ysiven: folds 
chelsea16730: calls $2
MaikonAll: folds 
*** FLOP *** [8s Jh 3h]
chelsea16730: checks 
BoyLoc0: bets $4.28
chelsea16730: calls $4.28
*** TURN *** [8s Jh 3h] [3d]
chelsea16730: checks 
BoyLoc0: bets $10.37
chelsea16730: raises $27.14 to $37.51 and is all-in
BoyLoc0: folds 
Uncalled bet ($27.14) returned to chelsea16730
chelsea16730 collected $33.54 from pot
*** SUMMARY ***
Total pot $35.30 | Rake $1.76 
Board [8s Jh 3h 3d]
Seat 1: Ysiven (button) folded before Flop (didn't bet)
Seat 2: chelsea16730 (small blind) collected ($33.54)
Seat 3: MaikonAll (big blind) folded before Flop
Seat 4: Oli3579 folded before Flop (didn't bet)
Seat 5: KuningasRane folded before Flop (didn't bet)
Seat 6: BoyLoc0 folded on the Turn



PokerStars Hand #254639161647:  Hold'em No Limit ($0.50/$1.00 USD) - 2025/01/31 17:37:24 WET [2025/01/31 12:37:24 ET]
Table 'Adria' 6-max Seat #2 is the button
Seat 1: Ysiven ($100 in chips) 
Seat 2: chelsea16730 ($60.68 in chips) 
Seat 3: MaikonAll ($111.65 in chips) 
Seat 4: Oli3579 ($100 in chips) 
Seat 5: KuningasRane ($128.14 in chips) 
Seat 6: BoyLoc0 ($159.57 in chips) 
MaikonAll: posts small blind $0.50
Oli3579: posts big blind $1
*** HOLE CARDS ***
KuningasRane: raises $1.50 to $2.50
BoyLoc0: raises $5 to $7.50
Ysiven: folds 
chelsea16730: folds 
MaikonAll: folds 
Oli3579: folds 
KuningasRane: calls $5
*** FLOP *** [Kc 9h Qh]
KuningasRane: checks 
BoyLoc0: bets $5.17
KuningasRane: folds 
Uncalled bet ($5.17) returned to BoyLoc0
BoyLoc0 collected $15.68 from pot
BoyLoc0: doesn't show hand 
*** SUMMARY ***
Total pot $16.50 | Rake $0.82 
Board [Kc 9h Qh]
Seat 1: Ysiven folded before Flop (didn't bet)
Seat 2: chelsea16730 (button) folded before Flop (didn't bet)
Seat 3: MaikonAll (small blind) folded before Flop
Seat 4: Oli3579 (big blind) folded before Flop
Seat 5: KuningasRane folded on the Flop
Seat 6: BoyLoc0 collected ($15.68)



PokerStars Hand #254639172141:  Hold'em No Limit ($0.50/$1.00 USD) - 2025/01/31 17:38:07 WET [2025/01/31 12:38:07 ET]
Table 'Adria' 6-max Seat #3 is the button
Seat 5: KuningasRane ($120.64 in chips) is sitting out
Seat 1: Ysiven ($100 in chips) 
Seat 2: chelsea16730 ($60.68 in chips) 
Seat 3: MaikonAll ($111.15 in chips) 
Seat 4: Oli3579 ($100 in chips) 
Seat 6: BoyLoc0 ($167.75 in chips) 
Oli3579: posts small blind $0.50
KuningasRane: is sitting out 
BoyLoc0: posts big blind $1
*** HOLE CARDS ***
Ysiven: folds 
chelsea16730: folds 
MaikonAll: raises $1.50 to $2.50
Oli3579: folds 
BoyLoc0: raises $10.50 to $13
MaikonAll: folds 
Uncalled bet ($10.50) returned to BoyLoc0
BoyLoc0 collected $5.50 from pot
BoyLoc0: doesn't show hand 
*** SUMMARY ***
Total pot $5.50 | Rake $0 
Seat 5: KuningasRane
Seat 1: Ysiven folded before Flop (didn't bet)
Seat 2: chelsea16730 folded before Flop (didn't bet)
Seat 3: MaikonAll (button) folded before Flop
Seat 4: Oli3579 (small blind) folded before Flop
Seat 6: BoyLoc0 (big blind) collected ($5.50)



PokerStars Hand #254639178882:  Hold'em No Limit ($0.50/$1.00 USD) - 2025/01/31 17:38:34 WET [2025/01/31 12:38:34 ET]
Table 'Adria' 6-max Seat #4 is the button
Seat 5: KuningasRane ($120.64 in chips) is sitting out
Seat 1: Ysiven ($100 in chips) 
Seat 2: chelsea16730 ($60.68 in chips) 
Seat 3: MaikonAll ($108.65 in chips) 
Seat 4: Oli3579 ($100 in chips) 
Seat 6: BoyLoc0 ($170.75 in chips) 
BoyLoc0: posts small blind $0.50
Ysiven: posts big blind $1
*** HOLE CARDS ***
chelsea16730: folds 
MaikonAll: folds 
Oli3579: folds 
BoyLoc0: raises $2 to $3
Ysiven: raises $7 to $10
BoyLoc0: raises $11 to $21
Ysiven: raises $79 to $100 and is all-in
BoyLoc0: folds 
Uncalled bet ($79) returned to Ysiven
Ysiven collected $42 from pot
Ysiven: doesn't show hand 
*** SUMMARY ***
Total pot $42 | Rake $0 
Seat 5: KuningasRane
Seat 1: Ysiven (big blind) collected ($42)
Seat 2: chelsea16730 folded before Flop (didn't bet)
Seat 3: MaikonAll folded before Flop (didn't bet)
Seat 4: Oli3579 (button) folded before Flop (didn't bet)
Seat 6: BoyLoc0 (small blind) folded before Flop



PokerStars Hand #254639188709:  Hold'em No Limit ($0.50/$1.00 USD) - 2025/01/31 17:39:15 WET [2025/01/31 12:39:15 ET]
Table 'Adria' 6-max Seat #6 is the button
Seat 1: Ysiven ($121 in chips) 
Seat 2: chelsea16730 ($60.68 in chips) 
Seat 3: MaikonAll ($108.65 in chips) 
Seat 4: Oli3579 ($100 in chips) 
Seat 5: KuningasRane ($120.64 in chips) 
Seat 6: BoyLoc0 ($149.75 in chips) 
Ysiven: posts small blind $0.50
chelsea16730: posts big blind $1
KuningasRane: posts small & big blinds $1.50
*** HOLE CARDS ***
MaikonAll: folds 
Oli3579: folds 
KuningasRane: raises $1.50 to $2.50
BoyLoc0: folds 
Ysiven: folds 
chelsea16730: calls $1.50
*** FLOP *** [2c Qd 7c]
chelsea16730: checks 
KuningasRane: bets $3.99
chelsea16730: calls $3.99
*** TURN *** [2c Qd 7c] [2d]
chelsea16730: checks 
KuningasRane: bets $9.30
chelsea16730: calls $9.30
*** RIVER *** [2c Qd 7c 2d] [6c]
chelsea16730: checks 
KuningasRane: bets $30.95
chelsea16730: calls $30.95
*** SHOW DOWN ***
KuningasRane: shows [2s 7d] (a full house, Deuces full of Sevens)
chelsea16730: mucks hand 
KuningasRane collected $91.98 from pot
*** SUMMARY ***
Total pot $94.48 | Rake $2.50 
Board [2c Qd 7c 2d 6c]
Seat 1: Ysiven (small blind) folded before Flop
Seat 2: chelsea16730 (big blind) mucked
Seat 3: MaikonAll folded before Flop (didn't bet)
Seat 4: Oli3579 folded before Flop (didn't bet)
Seat 5: KuningasRane showed [2s 7d] and won ($91.98) with a full house, Deuces full of Sevens
Seat 6: BoyLoc0 (button) folded before Flop (didn't bet)



PokerStars Hand #254639199212:  Hold'em No Limit ($0.50/$1.00 USD) - 2025/01/31 17:39:58 WET [2025/01/31 12:39:58 ET]
Table 'Adria' 6-max Seat #1 is the button
Seat 1: Ysiven ($120.50 in chips) 
Seat 2: chelsea16730 ($13.94 in chips) 
Seat 3: MaikonAll ($108.65 in chips) 
Seat 4: Oli3579 ($100 in chips) 
Seat 5: KuningasRane ($165.38 in chips) 
Seat 6: BoyLoc0 ($149.75 in chips) 
chelsea16730: posts small blind $0.50
MaikonAll: posts big blind $1
*** HOLE CARDS ***
Oli3579: folds 
KuningasRane: folds 
BoyLoc0: raises $1.50 to $2.50
Ysiven: raises $5 to $7.50
chelsea16730: folds 
MaikonAll: folds 
BoyLoc0: folds 
Uncalled bet ($5) returned to Ysiven
chelsea16730 leaves the table
Ysiven collected $6.50 from pot
Ysiven: doesn't show hand 
*** SUMMARY ***
Total pot $6.50 | Rake $0 
Seat 1: Ysiven (button) collected ($6.50)
Seat 2: chelsea16730 (small blind) folded before Flop
Seat 3: MaikonAll (big blind) folded before Flop
Seat 4: Oli3579 folded before Flop (didn't bet)
Seat 5: KuningasRane folded before Flop (didn't bet)
Seat 6: BoyLoc0 folded before Flop



PokerStars Hand #254639205025:  Hold'em No Limit ($0.50/$1.00 USD) - 2025/01/31 17:40:22 WET [2025/01/31 12:40:22 ET]
Table 'Adria' 6-max Seat #3 is the button
Seat 1: Ysiven ($124.50 in chips) 
Seat 3: MaikonAll ($107.65 in chips) 
Seat 4: Oli3579 ($100 in chips) 
Seat 5: KuningasRane ($165.38 in chips) 
Seat 6: BoyLoc0 ($147.25 in chips) 
Oli3579: posts small blind $0.50
KuningasRane: posts big blind $1
*** HOLE CARDS ***
BoyLoc0: folds 
Ysiven: folds 
MaikonAll: folds 
Oli3579: folds 
Uncalled bet ($0.50) returned to KuningasRane
KuningasRane collected $1 from pot
KuningasRane: doesn't show hand 
*** SUMMARY ***
Total pot $1 | Rake $0 
Seat 1: Ysiven folded before Flop (didn't bet)
Seat 3: MaikonAll (button) folded before Flop (didn't bet)
Seat 4: Oli3579 (small blind) folded before Flop
Seat 5: KuningasRane (big blind) collected ($1)
Seat 6: BoyLoc0 folded before Flop (didn't bet)



PokerStars Hand #254639207896:  Hold'em No Limit ($0.50/$1.00 USD) - 2025/01/31 17:40:34 WET [2025/01/31 12:40:34 ET]
Table 'Adria' 6-max Seat #4 is the button
Seat 1: Ysiven ($124.50 in chips) 
Seat 3: MaikonAll ($107.65 in chips) 
Seat 4: Oli3579 ($100 in chips) 
Seat 5: KuningasRane ($165.88 in chips) 
Seat 6: BoyLoc0 ($147.25 in chips) 
KuningasRane: posts small blind $0.50
BoyLoc0: posts big blind $1
*** HOLE CARDS ***
Ysiven: raises $1 to $2
MaikonAll: folds 
Oli3579: folds 
KuningasRane: folds 
BoyLoc0: calls $1
*** FLOP *** [Ac Jc 3d]
BoyLoc0: checks 
Ysiven: bets $2.57
BoyLoc0: folds 
Uncalled bet ($2.57) returned to Ysiven
Ysiven collected $4.28 from pot
Ysiven: doesn't show hand 
*** SUMMARY ***
Total pot $4.50 | Rake $0.22 
Board [Ac Jc 3d]
Seat 1: Ysiven collected ($4.28)
Seat 3: MaikonAll folded before Flop (didn't bet)
Seat 4: Oli3579 (button) folded before Flop (didn't bet)
Seat 5: KuningasRane (small blind) folded before Flop
Seat 6: BoyLoc0 (big blind) folded on the Flop



PokerStars Hand #254639214983:  Hold'em No Limit ($0.50/$1.00 USD) - 2025/01/31 17:41:03 WET [2025/01/31 12:41:03 ET]
Table 'Adria' 6-max Seat #5 is the button
Seat 1: Ysiven ($126.78 in chips) 
Seat 3: MaikonAll ($107.65 in chips) 
Seat 4: Oli3579 ($100 in chips) 
Seat 5: KuningasRane ($165.38 in chips) 
Seat 6: BoyLoc0 ($145.25 in chips) 
BoyLoc0: posts small blind $0.50
Ysiven: posts big blind $1
*** HOLE CARDS ***
MaikonAll: raises $1.30 to $2.30
Oli3579: folds 
KuningasRane: folds 
BoyLoc0: raises $7.70 to $10
Ysiven: folds 
rossieboy222 joins the table at seat #2 
MaikonAll: folds 
Uncalled bet ($7.70) returned to BoyLoc0
BoyLoc0 collected $5.60 from pot
BoyLoc0: doesn't show hand 
*** SUMMARY ***
Total pot $5.60 | Rake $0 
Seat 1: Ysiven (big blind) folded before Flop
Seat 3: MaikonAll folded before Flop
Seat 4: Oli3579 folded before Flop (didn't bet)
Seat 5: KuningasRane (button) folded before Flop (didn't bet)
Seat 6: BoyLoc0 (small blind) collected ($5.60)



PokerStars Hand #254639219535:  Hold'em No Limit ($0.50/$1.00 USD) - 2025/01/31 17:41:21 WET [2025/01/31 12:41:21 ET]
Table 'Adria' 6-max Seat #6 is the button
Seat 1: Ysiven ($125.78 in chips) 
Seat 2: rossieboy222 ($30 in chips) 
Seat 3: MaikonAll ($105.35 in chips) 
Seat 4: Oli3579 ($100 in chips) 
Seat 5: KuningasRane ($165.38 in chips) 
Seat 6: BoyLoc0 ($148.55 in chips) 
Ysiven: posts small blind $0.50
rossieboy222: posts big blind $1
*** HOLE CARDS ***
MaikonAll: folds 
Oli3579: folds 
KuningasRane: folds 
BoyLoc0: folds 
Ysiven: folds 
Uncalled bet ($0.50) returned to rossieboy222
rossieboy222 collected $1 from pot
rossieboy222: doesn't show hand 
*** SUMMARY ***
Total pot $1 | Rake $0 
Seat 1: Ysiven (small blind) folded before Flop
Seat 2: rossieboy222 (big blind) collected ($1)
Seat 3: MaikonAll folded before Flop (didn't bet)
Seat 4: Oli3579 folded before Flop (didn't bet)
Seat 5: KuningasRane folded before Flop (didn't bet)
Seat 6: BoyLoc0 (button) folded before Flop (didn't bet)



PokerStars Hand #254639224098:  Hold'em No Limit ($0.50/$1.00 USD) - 2025/01/31 17:41:40 WET [2025/01/31 12:41:40 ET]
Table 'Adria' 6-max Seat #1 is the button
Seat 1: Ysiven ($125.28 in chips) 
Seat 2: rossieboy222 ($30.50 in chips) 
Seat 3: MaikonAll ($105.35 in chips) 
Seat 4: Oli3579 ($100 in chips) 
Seat 5: KuningasRane ($165.38 in chips) 
Seat 6: BoyLoc0 ($148.55 in chips) 
rossieboy222: posts small blind $0.50
MaikonAll: posts big blind $1
*** HOLE CARDS ***
Oli3579: folds 
KuningasRane: raises $1.50 to $2.50
BoyLoc0: raises $6 to $8.50
Ysiven: folds 
rossieboy222: folds 
MaikonAll: folds 
KuningasRane: folds 
Uncalled bet ($6) returned to BoyLoc0
BoyLoc0 collected $6.50 from pot
BoyLoc0: doesn't show hand 
*** SUMMARY ***
Total pot $6.50 | Rake $0 
Seat 1: Ysiven (button) folded before Flop (didn't bet)
Seat 2: rossieboy222 (small blind) folded before Flop
Seat 3: MaikonAll (big blind) folded before Flop
Seat 4: Oli3579 folded before Flop (didn't bet)
Seat 5: KuningasRane folded before Flop
Seat 6: BoyLoc0 collected ($6.50)



PokerStars Hand #254639228263:  Hold'em No Limit ($0.50/$1.00 USD) - 2025/01/31 17:41:57 WET [2025/01/31 12:41:57 ET]
Table 'Adria' 6-max Seat #2 is the button
Seat 1: Ysiven ($125.28 in chips) 
Seat 2: rossieboy222 ($30 in chips) 
Seat 3: MaikonAll ($104.35 in chips) 
Seat 4: Oli3579 ($100 in chips) 
Seat 5: KuningasRane ($162.88 in chips) 
Seat 6: BoyLoc0 ($152.55 in chips) 
MaikonAll: posts small blind $0.50
Oli3579: posts big blind $1
*** HOLE CARDS ***
KuningasRane: folds 
BoyLoc0: raises $1.50 to $2.50
Ysiven: folds 
rossieboy222: folds 
MaikonAll: folds 
Oli3579: folds 
Uncalled bet ($1.50) returned to BoyLoc0
BoyLoc0 collected $2.50 from pot
BoyLoc0: doesn't show hand 
*** SUMMARY ***
Total pot $2.50 | Rake $0 
Seat 1: Ysiven folded before Flop (didn't bet)
Seat 2: rossieboy222 (button) folded before Flop (didn't bet)
Seat 3: MaikonAll (small blind) folded before Flop
Seat 4: Oli3579 (big blind) folded before Flop
Seat 5: KuningasRane folded before Flop (didn't bet)
Seat 6: BoyLoc0 collected ($2.50)



PokerStars Hand #254639236728:  Hold'em No Limit ($0.50/$1.00 USD) - 2025/01/31 17:42:32 WET [2025/01/31 12:42:32 ET]
Table 'Adria' 6-max Seat #3 is the button
Seat 1: Ysiven ($125.28 in chips) 
Seat 2: rossieboy222 ($30 in chips) 
Seat 3: MaikonAll ($103.85 in chips) 
Seat 4: Oli3579 ($100 in chips) 
Seat 5: KuningasRane ($162.88 in chips) 
Seat 6: BoyLoc0 ($154.05 in chips) 
Oli3579: posts small blind $0.50
KuningasRane: posts big blind $1
*** HOLE CARDS ***
BoyLoc0: folds 
Ysiven: folds 
rossieboy222: folds 
MaikonAll: folds 
Oli3579: raises $2 to $3
KuningasRane: folds 
Uncalled bet ($2) returned to Oli3579
Oli3579 collected $2 from pot
Oli3579: doesn't show hand 
*** SUMMARY ***
Total pot $2 | Rake $0 
Seat 1: Ysiven folded before Flop (didn't bet)
Seat 2: rossieboy222 folded before Flop (didn't bet)
Seat 3: MaikonAll (button) folded before Flop (didn't bet)
Seat 4: Oli3579 (small blind) collected ($2)
Seat 5: KuningasRane (big blind) folded before Flop
Seat 6: BoyLoc0 folded before Flop (didn't bet)



PokerStars Hand #254639241861:  Hold'em No Limit ($0.50/$1.00 USD) - 2025/01/31 17:42:53 WET [2025/01/31 12:42:53 ET]
Table 'Adria' 6-max Seat #4 is the button
Seat 1: Ysiven ($125.28 in chips) 
Seat 2: rossieboy222 ($30 in chips) 
Seat 3: MaikonAll ($103.85 in chips) 
Seat 4: Oli3579 ($101 in chips) 
Seat 5: KuningasRane ($161.88 in chips) 
Seat 6: BoyLoc0 ($154.05 in chips) 
KuningasRane: posts small blind $0.50
BoyLoc0: posts big blind $1
*** HOLE CARDS ***
Ysiven: folds 
rossieboy222: folds 
MaikonAll: folds 
Oli3579: folds 
KuningasRane: folds 
Uncalled bet ($0.50) returned to BoyLoc0
BoyLoc0 collected $1 from pot
BoyLoc0: doesn't show hand 
*** SUMMARY ***
Total pot $1 | Rake $0 
Seat 1: Ysiven folded before Flop (didn't bet)
Seat 2: rossieboy222 folded before Flop (didn't bet)
Seat 3: MaikonAll folded before Flop (didn't bet)
Seat 4: Oli3579 (button) folded before Flop (didn't bet)
Seat 5: KuningasRane (small blind) folded before Flop
Seat 6: BoyLoc0 (big blind) collected ($1)



PokerStars Hand #254639243877:  Hold'em No Limit ($0.50/$1.00 USD) - 2025/01/31 17:43:01 WET [2025/01/31 12:43:01 ET]
Table 'Adria' 6-max Seat #5 is the button
Seat 1: Ysiven ($125.28 in chips) 
Seat 2: rossieboy222 ($30 in chips) 
Seat 3: MaikonAll ($103.85 in chips) 
Seat 4: Oli3579 ($101 in chips) 
Seat 5: KuningasRane ($161.38 in chips) 
Seat 6: BoyLoc0 ($154.55 in chips) 
BoyLoc0: posts small blind $0.50
Ysiven: posts big blind $1
*** HOLE CARDS ***
rossieboy222: folds 
MaikonAll: folds 
Oli3579: raises $1.25 to $2.25
KuningasRane: calls $2.25
BoyLoc0: folds 
Ysiven: folds 
*** FLOP *** [2d 6h Ks]
Oli3579: bets $1.88
KuningasRane: calls $1.88
*** TURN *** [2d 6h Ks] [Kh]
Oli3579: checks 
KuningasRane: bets $3.71
Oli3579: folds 
Uncalled bet ($3.71) returned to KuningasRane
KuningasRane collected $9.27 from pot
KuningasRane: doesn't show hand 
*** SUMMARY ***
Total pot $9.76 | Rake $0.49 
Board [2d 6h Ks Kh]
Seat 1: Ysiven (big blind) folded before Flop
Seat 2: rossieboy222 folded before Flop (didn't bet)
Seat 3: MaikonAll folded before Flop (didn't bet)
Seat 4: Oli3579 folded on the Turn
Seat 5: KuningasRane (button) collected ($9.27)
Seat 6: BoyLoc0 (small blind) folded before Flop



PokerStars Hand #254639259731:  Hold'em No Limit ($0.50/$1.00 USD) - 2025/01/31 17:44:07 WET [2025/01/31 12:44:07 ET]
Table 'Adria' 6-max Seat #6 is the button
Seat 1: Ysiven ($124.28 in chips) 
Seat 2: rossieboy222 ($30 in chips) 
Seat 3: MaikonAll ($103.85 in chips) 
Seat 4: Oli3579 ($100 in chips) 
Seat 5: KuningasRane ($166.52 in chips) 
Seat 6: BoyLoc0 ($154.05 in chips) 
Ysiven: posts small blind $0.50
rossieboy222: posts big blind $1
*** HOLE CARDS ***
MaikonAll: folds 
Oli3579: folds 
KuningasRane: folds 
BoyLoc0: folds 
Ysiven: raises $1 to $2
rossieboy222: raises $28 to $30 and is all-in
Ysiven: folds 
Uncalled bet ($28) returned to rossieboy222
rossieboy222 collected $4 from pot
rossieboy222: doesn't show hand 
*** SUMMARY ***
Total pot $4 | Rake $0 
Seat 1: Ysiven (small blind) folded before Flop
Seat 2: rossieboy222 (big blind) collected ($4)
Seat 3: MaikonAll folded before Flop (didn't bet)
Seat 4: Oli3579 folded before Flop (didn't bet)
Seat 5: KuningasRane folded before Flop (didn't bet)
Seat 6: BoyLoc0 (button) folded before Flop (didn't bet)



PokerStars Hand #254639265319:  Hold'em No Limit ($0.50/$1.00 USD) - 2025/01/31 17:44:30 WET [2025/01/31 12:44:30 ET]
Table 'Adria' 6-max Seat #1 is the button
Seat 1: Ysiven ($122.28 in chips) 
Seat 2: rossieboy222 ($32 in chips) 
Seat 3: MaikonAll ($103.85 in chips) 
Seat 4: Oli3579 ($100 in chips) 
Seat 5: KuningasRane ($166.52 in chips) 
Seat 6: BoyLoc0 ($154.05 in chips) 
rossieboy222: posts small blind $0.50
MaikonAll: posts big blind $1
*** HOLE CARDS ***
Oli3579: folds 
KuningasRane: folds 
BoyLoc0: folds 
Ysiven: folds 
rossieboy222: folds 
Uncalled bet ($0.50) returned to MaikonAll
MaikonAll collected $1 from pot
MaikonAll: doesn't show hand 
*** SUMMARY ***
Total pot $1 | Rake $0 
Seat 1: Ysiven (button) folded before Flop (didn't bet)
Seat 2: rossieboy222 (small blind) folded before Flop
Seat 3: MaikonAll (big blind) collected ($1)
Seat 4: Oli3579 folded before Flop (didn't bet)
Seat 5: KuningasRane folded before Flop (didn't bet)
Seat 6: BoyLoc0 folded before Flop (didn't bet)



PokerStars Hand #254639268682:  Hold'em No Limit ($0.50/$1.00 USD) - 2025/01/31 17:44:43 WET [2025/01/31 12:44:43 ET]
Table 'Adria' 6-max Seat #2 is the button
Seat 1: Ysiven ($122.28 in chips) 
Seat 2: rossieboy222 ($31.50 in chips) 
Seat 3: MaikonAll ($104.35 in chips) 
Seat 4: Oli3579 ($100 in chips) 
Seat 5: KuningasRane ($166.52 in chips) 
Seat 6: BoyLoc0 ($154.05 in chips) 
MaikonAll: posts small blind $0.50
Oli3579: posts big blind $1
*** HOLE CARDS ***
KuningasRane: folds 
BoyLoc0: folds 
Ysiven: folds 
rossieboy222: folds 
MaikonAll: raises $2 to $3
Oli3579: calls $2
*** FLOP *** [Jh Ad Ah]
MaikonAll: bets $1.43
rossieboy222 leaves the table
Oli3579: calls $1.43
*** TURN *** [Jh Ad Ah] [7c]
MaikonAll: bets $6.32
Oli3579: calls $6.32
*** RIVER *** [Jh Ad Ah 7c] [6c]
MaikonAll: checks 
Oli3579: checks 
*** SHOW DOWN ***
MaikonAll: shows [9s Th] (a pair of Aces)
Oli3579: shows [Qh Kc] (a pair of Aces - King kicker)
Oli3579 collected $20.42 from pot
*** SUMMARY ***
Total pot $21.50 | Rake $1.08 
Board [Jh Ad Ah 7c 6c]
Seat 1: Ysiven folded before Flop (didn't bet)
Seat 2: rossieboy222 (button) folded before Flop (didn't bet)
Seat 3: MaikonAll (small blind) showed [9s Th] and lost with a pair of Aces
Seat 4: Oli3579 (big blind) showed [Qh Kc] and won ($20.42) with a pair of Aces
Seat 5: KuningasRane folded before Flop (didn't bet)
Seat 6: BoyLoc0 folded before Flop (didn't bet)



PokerStars Hand #254639287638:  Hold'em No Limit ($0.50/$1.00 USD) - 2025/01/31 17:46:01 WET [2025/01/31 12:46:01 ET]
Table 'Adria' 6-max Seat #3 is the button
Seat 1: Ysiven ($122.28 in chips) 
Seat 3: MaikonAll ($100 in chips) 
Seat 4: Oli3579 ($109.67 in chips) 
Seat 5: KuningasRane ($166.52 in chips) 
Seat 6: BoyLoc0 ($154.05 in chips) 
Oli3579: posts small blind $0.50
KuningasRane: posts big blind $1
*** HOLE CARDS ***
BoyLoc0: folds 
Ysiven: raises $1.30 to $2.30
MaikonAll: folds 
Oli3579: folds 
KuningasRane: folds 
Uncalled bet ($1.30) returned to Ysiven
Ysiven collected $2.50 from pot
Ysiven: doesn't show hand 
*** SUMMARY ***
Total pot $2.50 | Rake $0 
Seat 1: Ysiven collected ($2.50)
Seat 3: MaikonAll (button) folded before Flop (didn't bet)
Seat 4: Oli3579 (small blind) folded before Flop
Seat 5: KuningasRane (big blind) folded before Flop
Seat 6: BoyLoc0 folded before Flop (didn't bet)



PokerStars Hand #254639291013:  Hold'em No Limit ($0.50/$1.00 USD) - 2025/01/31 17:46:14 WET [2025/01/31 12:46:14 ET]
Table 'Adria' 6-max Seat #4 is the button
Seat 1: Ysiven ($123.78 in chips) 
Seat 3: MaikonAll ($100 in chips) 
Seat 4: Oli3579 ($109.17 in chips) 
Seat 5: KuningasRane ($165.52 in chips) 
Seat 6: BoyLoc0 ($154.05 in chips) 
KuningasRane: posts small blind $0.50
BoyLoc0: posts big blind $1
*** HOLE CARDS ***
Ysiven: folds 
MaikonAll: folds 
Oli3579: folds 
KuningasRane: folds 
Uncalled bet ($0.50) returned to BoyLoc0
BoyLoc0 collected $1 from pot
BoyLoc0: doesn't show hand 
*** SUMMARY ***
Total pot $1 | Rake $0 
Seat 1: Ysiven folded before Flop (didn't bet)
Seat 3: MaikonAll folded before Flop (didn't bet)
Seat 4: Oli3579 (button) folded before Flop (didn't bet)
Seat 5: KuningasRane (small blind) folded before Flop
Seat 6: BoyLoc0 (big blind) collected ($1)



PokerStars Hand #254639293277:  Hold'em No Limit ($0.50/$1.00 USD) - 2025/01/31 17:46:24 WET [2025/01/31 12:46:24 ET]
Table 'Adria' 6-max Seat #5 is the button
Seat 1: Ysiven ($123.78 in chips) 
Seat 3: MaikonAll ($100 in chips) 
Seat 4: Oli3579 ($109.17 in chips) 
Seat 5: KuningasRane ($165.02 in chips) 
Seat 6: BoyLoc0 ($154.55 in chips) 
BoyLoc0: posts small blind $0.50
Ysiven: posts big blind $1
*** HOLE CARDS ***
S3MPR3IGUAL joins the table at seat #2 
MaikonAll: raises $1.30 to $2.30
Oli3579: folds 
KuningasRane: folds 
BoyLoc0: folds 
Ysiven: folds 
Uncalled bet ($1.30) returned to MaikonAll
MaikonAll collected $2.50 from pot
MaikonAll: doesn't show hand 
*** SUMMARY ***
Total pot $2.50 | Rake $0 
Seat 1: Ysiven (big blind) folded before Flop
Seat 3: MaikonAll collected ($2.50)
Seat 4: Oli3579 folded before Flop (didn't bet)
Seat 5: KuningasRane (button) folded before Flop (didn't bet)
Seat 6: BoyLoc0 (small blind) folded before Flop



PokerStars Hand #254639296407:  Hold'em No Limit ($0.50/$1.00 USD) - 2025/01/31 17:46:36 WET [2025/01/31 12:46:36 ET]
Table 'Adria' 6-max Seat #6 is the button
Seat 1: Ysiven ($122.78 in chips) 
Seat 2: S3MPR3IGUAL ($100 in chips) 
Seat 3: MaikonAll ($101.50 in chips) 
Seat 4: Oli3579 ($109.17 in chips) 
Seat 5: KuningasRane ($165.02 in chips) 
Seat 6: BoyLoc0 ($154.05 in chips) 
Ysiven: posts small blind $0.50
S3MPR3IGUAL: posts big blind $1
*** HOLE CARDS ***
MaikonAll: folds 
Oli3579: folds 
KuningasRane: raises $1.50 to $2.50
BoyLoc0: folds 
Ysiven: folds 
S3MPR3IGUAL: calls $1.50
*** FLOP *** [Td 6h 4d]
S3MPR3IGUAL: checks 
KuningasRane: bets $3.65
S3MPR3IGUAL: folds 
Uncalled bet ($3.65) returned to KuningasRane
KuningasRane collected $5.22 from pot
KuningasRane: doesn't show hand 
*** SUMMARY ***
Total pot $5.50 | Rake $0.28 
Board [Td 6h 4d]
Seat 1: Ysiven (small blind) folded before Flop
Seat 2: S3MPR3IGUAL (big blind) folded on the Flop
Seat 3: MaikonAll folded before Flop (didn't bet)
Seat 4: Oli3579 folded before Flop (didn't bet)
Seat 5: KuningasRane collected ($5.22)
Seat 6: BoyLoc0 (button) folded before Flop (didn't bet)



PokerStars Hand #254639302671:  Hold'em No Limit ($0.50/$1.00 USD) - 2025/01/31 17:47:01 WET [2025/01/31 12:47:01 ET]
Table 'Adria' 6-max Seat #1 is the button
Seat 1: Ysiven ($122.28 in chips) 
Seat 2: S3MPR3IGUAL ($100 in chips) 
Seat 3: MaikonAll ($101.50 in chips) 
Seat 4: Oli3579 ($109.17 in chips) 
Seat 5: KuningasRane ($167.74 in chips) 
Seat 6: BoyLoc0 ($154.05 in chips) 
S3MPR3IGUAL: posts small blind $0.50
MaikonAll: posts big blind $1
*** HOLE CARDS ***
Oli3579: folds 
KuningasRane: folds 
BoyLoc0: raises $1.50 to $2.50
Ysiven: raises $5 to $7.50
S3MPR3IGUAL: folds 
MaikonAll: folds 
BoyLoc0: calls $5
*** FLOP *** [6s Ac Tc]
BoyLoc0: checks 
Ysiven: checks 
*** TURN *** [6s Ac Tc] [4s]
BoyLoc0: checks 
Ysiven: bets $20.85
BoyLoc0: calls $20.85
*** RIVER *** [6s Ac Tc 4s] [5h]
BoyLoc0: checks 
Ysiven: checks 
*** SHOW DOWN ***
BoyLoc0: shows [5d Ad] (two pair, Aces and Fives)
Ysiven: mucks hand 
BoyLoc0 collected $55.70 from pot
*** SUMMARY ***
Total pot $58.20 | Rake $2.50 
Board [6s Ac Tc 4s 5h]
Seat 1: Ysiven (button) mucked
Seat 2: S3MPR3IGUAL (small blind) folded before Flop
Seat 3: MaikonAll (big blind) folded before Flop
Seat 4: Oli3579 folded before Flop (didn't bet)
Seat 5: KuningasRane folded before Flop (didn't bet)
Seat 6: BoyLoc0 showed [5d Ad] and won ($55.70) with two pair, Aces and Fives



PokerStars Hand #254639324212:  Hold'em No Limit ($0.50/$1.00 USD) - 2025/01/31 17:48:28 WET [2025/01/31 12:48:28 ET]
Table 'Adria' 6-max Seat #2 is the button
Seat 1: Ysiven ($100 in chips) 
Seat 2: S3MPR3IGUAL ($100 in chips) 
Seat 3: MaikonAll ($100.50 in chips) 
Seat 4: Oli3579 ($109.17 in chips) 
Seat 5: KuningasRane ($167.74 in chips) 
Seat 6: BoyLoc0 ($181.40 in chips) 
MaikonAll: posts small blind $0.50
Oli3579: posts big blind $1
*** HOLE CARDS ***
KuningasRane: raises $1.50 to $2.50
BoyLoc0: raises $6 to $8.50
Ysiven: folds 
S3MPR3IGUAL: folds 
MaikonAll: folds 
Oli3579: folds 
KuningasRane: raises $20.50 to $29
BoyLoc0: calls $20.50
*** FLOP *** [2d 8c 7d]
KuningasRane: bets $39.90
BoyLoc0: folds 
Uncalled bet ($39.90) returned to KuningasRane
KuningasRane collected $57 from pot
KuningasRane: doesn't show hand 
*** SUMMARY ***
Total pot $59.50 | Rake $2.50 
Board [2d 8c 7d]
Seat 1: Ysiven folded before Flop (didn't bet)
Seat 2: S3MPR3IGUAL (button) folded before Flop (didn't bet)
Seat 3: MaikonAll (small blind) folded before Flop
Seat 4: Oli3579 (big blind) folded before Flop
Seat 5: KuningasRane collected ($57)
Seat 6: BoyLoc0 folded on the Flop



PokerStars Hand #254639332581:  Hold'em No Limit ($0.50/$1.00 USD) - 2025/01/31 17:49:01 WET [2025/01/31 12:49:01 ET]
Table 'Adria' 6-max Seat #3 is the button
Seat 1: Ysiven ($100 in chips) 
Seat 2: S3MPR3IGUAL ($100 in chips) 
Seat 3: MaikonAll ($100 in chips) 
Seat 4: Oli3579 ($108.17 in chips) 
Seat 5: KuningasRane ($195.74 in chips) 
Seat 6: BoyLoc0 ($152.40 in chips) 
Oli3579: posts small blind $0.50
KuningasRane: posts big blind $1
*** HOLE CARDS ***
BoyLoc0: folds 
Ysiven: folds 
S3MPR3IGUAL: folds 
MaikonAll: folds 
Oli3579: folds 
Uncalled bet ($0.50) returned to KuningasRane
KuningasRane collected $1 from pot
KuningasRane: doesn't show hand 
*** SUMMARY ***
Total pot $1 | Rake $0 
Seat 1: Ysiven folded before Flop (didn't bet)
Seat 2: S3MPR3IGUAL folded before Flop (didn't bet)
Seat 3: MaikonAll (button) folded before Flop (didn't bet)
Seat 4: Oli3579 (small blind) folded before Flop
Seat 5: KuningasRane (big blind) collected ($1)
Seat 6: BoyLoc0 folded before Flop (didn't bet)



PokerStars Hand #254639335644:  Hold'em No Limit ($0.50/$1.00 USD) - 2025/01/31 17:49:14 WET [2025/01/31 12:49:14 ET]
Table 'Adria' 6-max Seat #4 is the button
Seat 1: Ysiven ($100 in chips) 
Seat 2: S3MPR3IGUAL ($100 in chips) 
Seat 3: MaikonAll ($100 in chips) 
Seat 4: Oli3579 ($107.67 in chips) 
Seat 5: KuningasRane ($196.24 in chips) 
Seat 6: BoyLoc0 ($152.40 in chips) 
KuningasRane: posts small blind $0.50
BoyLoc0: posts big blind $1
*** HOLE CARDS ***
Ysiven: folds 
S3MPR3IGUAL: raises $1.20 to $2.20
MaikonAll: folds 
Oli3579: folds 
KuningasRane: folds 
BoyLoc0: folds 
Uncalled bet ($1.20) returned to S3MPR3IGUAL
S3MPR3IGUAL collected $2.50 from pot
S3MPR3IGUAL: doesn't show hand 
*** SUMMARY ***
Total pot $2.50 | Rake $0 
Seat 1: Ysiven folded before Flop (didn't bet)
Seat 2: S3MPR3IGUAL collected ($2.50)
Seat 3: MaikonAll folded before Flop (didn't bet)
Seat 4: Oli3579 (button) folded before Flop (didn't bet)
Seat 5: KuningasRane (small blind) folded before Flop
Seat 6: BoyLoc0 (big blind) folded before Flop



PokerStars Hand #254639340717:  Hold'em No Limit ($0.50/$1.00 USD) - 2025/01/31 17:49:34 WET [2025/01/31 12:49:34 ET]
Table 'Adria' 6-max Seat #5 is the button
Seat 1: Ysiven ($100 in chips) 
Seat 2: S3MPR3IGUAL ($101.50 in chips) 
Seat 3: MaikonAll ($100 in chips) 
Seat 4: Oli3579 ($107.67 in chips) 
Seat 5: KuningasRane ($195.74 in chips) 
Seat 6: BoyLoc0 ($151.40 in chips) 
BoyLoc0: posts small blind $0.50
Ysiven: posts big blind $1
*** HOLE CARDS ***
S3MPR3IGUAL: raises $1.20 to $2.20
MaikonAll: folds 
Oli3579: folds 
KuningasRane: raises $5.90 to $8.10
BoyLoc0: folds 
Ysiven: folds 
S3MPR3IGUAL: folds 
Uncalled bet ($5.90) returned to KuningasRane
KuningasRane collected $5.90 from pot
KuningasRane: doesn't show hand 
*** SUMMARY ***
Total pot $5.90 | Rake $0 
Seat 1: Ysiven (big blind) folded before Flop
Seat 2: S3MPR3IGUAL folded before Flop
Seat 3: MaikonAll folded before Flop (didn't bet)
Seat 4: Oli3579 folded before Flop (didn't bet)
Seat 5: KuningasRane (button) collected ($5.90)
Seat 6: BoyLoc0 (small blind) folded before Flop



PokerStars Hand #254639345006:  Hold'em No Limit ($0.50/$1.00 USD) - 2025/01/31 17:49:51 WET [2025/01/31 12:49:51 ET]
Table 'Adria' 6-max Seat #6 is the button
Seat 1: Ysiven ($100 in chips) 
Seat 2: S3MPR3IGUAL ($100 in chips) 
Seat 3: MaikonAll ($100 in chips) 
Seat 4: Oli3579 ($107.67 in chips) 
Seat 5: KuningasRane ($199.44 in chips) 
Seat 6: BoyLoc0 ($150.90 in chips) 
Ysiven: posts small blind $0.50
S3MPR3IGUAL: posts big blind $1
*** HOLE CARDS ***
MaikonAll: folds 
Oli3579: folds 
KuningasRane: folds 
BoyLoc0: raises $1.50 to $2.50
Ysiven: raises $9.50 to $12
S3MPR3IGUAL: folds 
BoyLoc0: folds 
Uncalled bet ($9.50) returned to Ysiven
Ysiven collected $6 from pot
Ysiven: doesn't show hand 
*** SUMMARY ***
Total pot $6 | Rake $0 
Seat 1: Ysiven (small blind) collected ($6)
Seat 2: S3MPR3IGUAL (big blind) folded before Flop
Seat 3: MaikonAll folded before Flop (didn't bet)
Seat 4: Oli3579 folded before Flop (didn't bet)
Seat 5: KuningasRane folded before Flop (didn't bet)
Seat 6: BoyLoc0 (button) folded before Flop



PokerStars Hand #254639351428:  Hold'em No Limit ($0.50/$1.00 USD) - 2025/01/31 17:50:17 WET [2025/01/31 12:50:17 ET]
Table 'Adria' 6-max Seat #1 is the button
Seat 1: Ysiven ($103.50 in chips) 
Seat 2: S3MPR3IGUAL ($100 in chips) 
Seat 3: MaikonAll ($100 in chips) 
Seat 4: Oli3579 ($107.67 in chips) 
Seat 5: KuningasRane ($199.44 in chips) 
Seat 6: BoyLoc0 ($148.40 in chips) 
S3MPR3IGUAL: posts small blind $0.50
MaikonAll: posts big blind $1
*** HOLE CARDS ***
Oli3579: folds 
KuningasRane: folds 
BoyLoc0: raises $1.50 to $2.50
Ysiven: folds 
S3MPR3IGUAL: folds 
MaikonAll: folds 
Uncalled bet ($1.50) returned to BoyLoc0
BoyLoc0 collected $2.50 from pot
BoyLoc0: doesn't show hand 
*** SUMMARY ***
Total pot $2.50 | Rake $0 
Seat 1: Ysiven (button) folded before Flop (didn't bet)
Seat 2: S3MPR3IGUAL (small blind) folded before Flop
Seat 3: MaikonAll (big blind) folded before Flop
Seat 4: Oli3579 folded before Flop (didn't bet)
Seat 5: KuningasRane folded before Flop (didn't bet)
Seat 6: BoyLoc0 collected ($2.50)



PokerStars Hand #254639355283:  Hold'em No Limit ($0.50/$1.00 USD) - 2025/01/31 17:50:33 WET [2025/01/31 12:50:33 ET]
Table 'Adria' 6-max Seat #2 is the button
Seat 1: Ysiven ($103.50 in chips) 
Seat 2: S3MPR3IGUAL ($100 in chips) 
Seat 3: MaikonAll ($100 in chips) 
Seat 4: Oli3579 ($107.67 in chips) 
Seat 5: KuningasRane ($199.44 in chips) 
Seat 6: BoyLoc0 ($149.90 in chips) 
MaikonAll: posts small blind $0.50
Oli3579: posts big blind $1
*** HOLE CARDS ***
KuningasRane: raises $1.50 to $2.50
BoyLoc0: folds 
Ysiven: folds 
S3MPR3IGUAL: folds 
MaikonAll: folds 
Oli3579: folds 
Uncalled bet ($1.50) returned to KuningasRane
KuningasRane collected $2.50 from pot
KuningasRane: doesn't show hand 
*** SUMMARY ***
Total pot $2.50 | Rake $0 
Seat 1: Ysiven folded before Flop (didn't bet)
Seat 2: S3MPR3IGUAL (button) folded before Flop (didn't bet)
Seat 3: MaikonAll (small blind) folded before Flop
Seat 4: Oli3579 (big blind) folded before Flop
Seat 5: KuningasRane collected ($2.50)
Seat 6: BoyLoc0 folded before Flop (didn't bet)



PokerStars Hand #254639357987:  Hold'em No Limit ($0.50/$1.00 USD) - 2025/01/31 17:50:44 WET [2025/01/31 12:50:44 ET]
Table 'Adria' 6-max Seat #3 is the button
Seat 1: Ysiven ($103.50 in chips) 
Seat 2: S3MPR3IGUAL ($100 in chips) 
Seat 3: MaikonAll ($100 in chips) 
Seat 4: Oli3579 ($106.67 in chips) 
Seat 5: KuningasRane ($200.94 in chips) 
Seat 6: BoyLoc0 ($149.90 in chips) 
Oli3579: posts small blind $0.50
KuningasRane: posts big blind $1
*** HOLE CARDS ***
BoyLoc0: folds 
Ysiven: folds 
S3MPR3IGUAL: folds 
MaikonAll: raises $1.50 to $2.50
Oli3579: folds 
KuningasRane: folds 
Uncalled bet ($1.50) returned to MaikonAll
MaikonAll collected $2.50 from pot
MaikonAll: doesn't show hand 
*** SUMMARY ***
Total pot $2.50 | Rake $0 
Seat 1: Ysiven folded before Flop (didn't bet)
Seat 2: S3MPR3IGUAL folded before Flop (didn't bet)
Seat 3: MaikonAll (button) collected ($2.50)
Seat 4: Oli3579 (small blind) folded before Flop
Seat 5: KuningasRane (big blind) folded before Flop
Seat 6: BoyLoc0 folded before Flop (didn't bet)



PokerStars Hand #254639362854:  Hold'em No Limit ($0.50/$1.00 USD) - 2025/01/31 17:51:03 WET [2025/01/31 12:51:03 ET]
Table 'Adria' 6-max Seat #4 is the button
Seat 1: Ysiven ($103.50 in chips) 
Seat 2: S3MPR3IGUAL ($100 in chips) 
Seat 3: MaikonAll ($101.50 in chips) 
Seat 4: Oli3579 ($106.17 in chips) 
Seat 5: KuningasRane ($199.94 in chips) 
Seat 6: BoyLoc0 ($149.90 in chips) 
KuningasRane: posts small blind $0.50
BoyLoc0: posts big blind $1
*** HOLE CARDS ***
Ysiven: folds 
S3MPR3IGUAL: folds 
MaikonAll: folds 
Oli3579: folds 
KuningasRane: folds 
Uncalled bet ($0.50) returned to BoyLoc0
BoyLoc0 collected $1 from pot
BoyLoc0: doesn't show hand 
*** SUMMARY ***
Total pot $1 | Rake $0 
Seat 1: Ysiven folded before Flop (didn't bet)
Seat 2: S3MPR3IGUAL folded before Flop (didn't bet)
Seat 3: MaikonAll folded before Flop (didn't bet)
Seat 4: Oli3579 (button) folded before Flop (didn't bet)
Seat 5: KuningasRane (small blind) folded before Flop
Seat 6: BoyLoc0 (big blind) collected ($1)



PokerStars Hand #254639366164:  Hold'em No Limit ($0.50/$1.00 USD) - 2025/01/31 17:51:16 WET [2025/01/31 12:51:16 ET]
Table 'Adria' 6-max Seat #5 is the button
Seat 1: Ysiven ($103.50 in chips) 
Seat 2: S3MPR3IGUAL ($100 in chips) 
Seat 3: MaikonAll ($101.50 in chips) 
Seat 4: Oli3579 ($106.17 in chips) 
Seat 5: KuningasRane ($199.44 in chips) 
Seat 6: BoyLoc0 ($150.40 in chips) 
BoyLoc0: posts small blind $0.50
Ysiven: posts big blind $1
*** HOLE CARDS ***
S3MPR3IGUAL: folds 
MaikonAll: folds 
Oli3579: folds 
KuningasRane: raises $1.50 to $2.50
BoyLoc0: folds 
Ysiven: folds 
Uncalled bet ($1.50) returned to KuningasRane
KuningasRane collected $2.50 from pot
KuningasRane: doesn't show hand 
*** SUMMARY ***
Total pot $2.50 | Rake $0 
Seat 1: Ysiven (big blind) folded before Flop
Seat 2: S3MPR3IGUAL folded before Flop (didn't bet)
Seat 3: MaikonAll folded before Flop (didn't bet)
Seat 4: Oli3579 folded before Flop (didn't bet)
Seat 5: KuningasRane (button) collected ($2.50)
Seat 6: BoyLoc0 (small blind) folded before Flop



PokerStars Hand #254639369788:  Hold'em No Limit ($0.50/$1.00 USD) - 2025/01/31 17:51:31 WET [2025/01/31 12:51:31 ET]
Table 'Adria' 6-max Seat #6 is the button
Seat 1: Ysiven ($102.50 in chips) 
Seat 2: S3MPR3IGUAL ($100 in chips) 
Seat 3: MaikonAll ($101.50 in chips) 
Seat 4: Oli3579 ($106.17 in chips) 
Seat 5: KuningasRane ($200.94 in chips) 
Seat 6: BoyLoc0 ($149.90 in chips) 
Ysiven: posts small blind $0.50
S3MPR3IGUAL: posts big blind $1
*** HOLE CARDS ***
MaikonAll: folds 
Oli3579: folds 
KuningasRane: folds 
BoyLoc0: raises $1.50 to $2.50
Ysiven: folds 
S3MPR3IGUAL: folds 
Uncalled bet ($1.50) returned to BoyLoc0
BoyLoc0 collected $2.50 from pot
BoyLoc0: doesn't show hand 
*** SUMMARY ***
Total pot $2.50 | Rake $0 
Seat 1: Ysiven (small blind) folded before Flop
Seat 2: S3MPR3IGUAL (big blind) folded before Flop
Seat 3: MaikonAll folded before Flop (didn't bet)
Seat 4: Oli3579 folded before Flop (didn't bet)
Seat 5: KuningasRane folded before Flop (didn't bet)
Seat 6: BoyLoc0 (button) collected ($2.50)



PokerStars Hand #254639372828:  Hold'em No Limit ($0.50/$1.00 USD) - 2025/01/31 17:51:43 WET [2025/01/31 12:51:43 ET]
Table 'Adria' 6-max Seat #1 is the button
Seat 1: Ysiven ($102 in chips) 
Seat 2: S3MPR3IGUAL ($100 in chips) 
Seat 3: MaikonAll ($101.50 in chips) 
Seat 4: Oli3579 ($106.17 in chips) 
Seat 5: KuningasRane ($200.94 in chips) 
Seat 6: BoyLoc0 ($151.40 in chips) 
S3MPR3IGUAL: posts small blind $0.50
MaikonAll: posts big blind $1
*** HOLE CARDS ***
Oli3579: folds 
KuningasRane: folds 
BoyLoc0: folds 
Ysiven: raises $1.50 to $2.50
S3MPR3IGUAL: folds 
MaikonAll: folds 
Uncalled bet ($1.50) returned to Ysiven
Ysiven collected $2.50 from pot
Ysiven: doesn't show hand 
*** SUMMARY ***
Total pot $2.50 | Rake $0 
Seat 1: Ysiven (button) collected ($2.50)
Seat 2: S3MPR3IGUAL (small blind) folded before Flop
Seat 3: MaikonAll (big blind) folded before Flop
Seat 4: Oli3579 folded before Flop (didn't bet)
Seat 5: KuningasRane folded before Flop (didn't bet)
Seat 6: BoyLoc0 folded before Flop (didn't bet)



PokerStars Hand #254639377077:  Hold'em No Limit ($0.50/$1.00 USD) - 2025/01/31 17:52:00 WET [2025/01/31 12:52:00 ET]
Table 'Adria' 6-max Seat #2 is the button
Seat 1: Ysiven ($103.50 in chips) 
Seat 2: S3MPR3IGUAL ($100 in chips) 
Seat 3: MaikonAll ($100.50 in chips) 
Seat 4: Oli3579 ($106.17 in chips) 
Seat 5: KuningasRane ($200.94 in chips) 
Seat 6: BoyLoc0 ($151.40 in chips) 
MaikonAll: posts small blind $0.50
Oli3579: posts big blind $1
*** HOLE CARDS ***
KuningasRane: folds 
BoyLoc0: folds 
Ysiven: raises $1.30 to $2.30
S3MPR3IGUAL: folds 
MaikonAll: folds 
Oli3579: folds 
Uncalled bet ($1.30) returned to Ysiven
Ysiven collected $2.50 from pot
Ysiven: doesn't show hand 
*** SUMMARY ***
Total pot $2.50 | Rake $0 
Seat 1: Ysiven collected ($2.50)
Seat 2: S3MPR3IGUAL (button) folded before Flop (didn't bet)
Seat 3: MaikonAll (small blind) folded before Flop
Seat 4: Oli3579 (big blind) folded before Flop
Seat 5: KuningasRane folded before Flop (didn't bet)
Seat 6: BoyLoc0 folded before Flop (didn't bet)



PokerStars Hand #254639380252:  Hold'em No Limit ($0.50/$1.00 USD) - 2025/01/31 17:52:13 WET [2025/01/31 12:52:13 ET]
Table 'Adria' 6-max Seat #3 is the button
Seat 1: Ysiven ($105 in chips) 
Seat 2: S3MPR3IGUAL ($100 in chips) 
Seat 3: MaikonAll ($100 in chips) 
Seat 4: Oli3579 ($105.17 in chips) 
Seat 5: KuningasRane ($200.94 in chips) 
Seat 6: BoyLoc0 ($151.40 in chips) 
Oli3579: posts small blind $0.50
KuningasRane: posts big blind $1
*** HOLE CARDS ***
BoyLoc0: raises $1.50 to $2.50
Ysiven: folds 
S3MPR3IGUAL: folds 
MaikonAll: folds 
Oli3579: raises $8.50 to $11
KuningasRane: folds 
BoyLoc0: calls $8.50
*** FLOP *** [8s 4s Ks]
Oli3579: bets $2.19
BoyLoc0: calls $2.19
*** TURN *** [8s 4s Ks] [3s]
Oli3579: checks 
BoyLoc0: checks 
*** RIVER *** [8s 4s Ks 3s] [Th]
Oli3579: checks 
BoyLoc0: bets $19.51
Oli3579: folds 
Uncalled bet ($19.51) returned to BoyLoc0
BoyLoc0 collected $26.01 from pot
BoyLoc0: doesn't show hand 
*** SUMMARY ***
Total pot $27.38 | Rake $1.37 
Board [8s 4s Ks 3s Th]
Seat 1: Ysiven folded before Flop (didn't bet)
Seat 2: S3MPR3IGUAL folded before Flop (didn't bet)
Seat 3: MaikonAll (button) folded before Flop (didn't bet)
Seat 4: Oli3579 (small blind) folded on the River
Seat 5: KuningasRane (big blind) folded before Flop
Seat 6: BoyLoc0 collected ($26.01)



PokerStars Hand #254639398905:  Hold'em No Limit ($0.50/$1.00 USD) - 2025/01/31 17:53:27 WET [2025/01/31 12:53:27 ET]
Table 'Adria' 6-max Seat #4 is the button
Seat 1: Ysiven ($105 in chips) 
Seat 2: S3MPR3IGUAL ($100 in chips) 
Seat 3: MaikonAll ($100 in chips) 
Seat 4: Oli3579 ($100 in chips) 
Seat 5: KuningasRane ($199.94 in chips) 
Seat 6: BoyLoc0 ($164.22 in chips) 
KuningasRane: posts small blind $0.50
BoyLoc0: posts big blind $1
*** HOLE CARDS ***
Ysiven: folds 
S3MPR3IGUAL: folds 
MaikonAll: raises $1.30 to $2.30
Oli3579: folds 
KuningasRane: folds 
BoyLoc0: folds 
Uncalled bet ($1.30) returned to MaikonAll
MaikonAll collected $2.50 from pot
MaikonAll: doesn't show hand 
*** SUMMARY ***
Total pot $2.50 | Rake $0 
Seat 1: Ysiven folded before Flop (didn't bet)
Seat 2: S3MPR3IGUAL folded before Flop (didn't bet)
Seat 3: MaikonAll collected ($2.50)
Seat 4: Oli3579 (button) folded before Flop (didn't bet)
Seat 5: KuningasRane (small blind) folded before Flop
Seat 6: BoyLoc0 (big blind) folded before Flop



PokerStars Hand #254639403507:  Hold'em No Limit ($0.50/$1.00 USD) - 2025/01/31 17:53:46 WET [2025/01/31 12:53:46 ET]
Table 'Adria' 6-max Seat #5 is the button
Seat 1: Ysiven ($105 in chips) 
Seat 2: S3MPR3IGUAL ($100 in chips) 
Seat 3: MaikonAll ($101.50 in chips) 
Seat 4: Oli3579 ($100 in chips) 
Seat 5: KuningasRane ($199.44 in chips) 
Seat 6: BoyLoc0 ($163.22 in chips) 
BoyLoc0: posts small blind $0.50
Ysiven: posts big blind $1
*** HOLE CARDS ***
S3MPR3IGUAL: folds 
MaikonAll: folds 
Oli3579: folds 
KuningasRane: raises $1.50 to $2.50
BoyLoc0: folds 
Ysiven: folds 
Uncalled bet ($1.50) returned to KuningasRane
KuningasRane collected $2.50 from pot
KuningasRane: doesn't show hand 
*** SUMMARY ***
Total pot $2.50 | Rake $0 
Seat 1: Ysiven (big blind) folded before Flop
Seat 2: S3MPR3IGUAL folded before Flop (didn't bet)
Seat 3: MaikonAll folded before Flop (didn't bet)
Seat 4: Oli3579 folded before Flop (didn't bet)
Seat 5: KuningasRane (button) collected ($2.50)
Seat 6: BoyLoc0 (small blind) folded before Flop



PokerStars Hand #254639407730:  Hold'em No Limit ($0.50/$1.00 USD) - 2025/01/31 17:54:02 WET [2025/01/31 12:54:02 ET]
Table 'Adria' 6-max Seat #6 is the button
Seat 1: Ysiven ($104 in chips) 
Seat 2: S3MPR3IGUAL ($100 in chips) 
Seat 3: MaikonAll ($101.50 in chips) 
Seat 4: Oli3579 ($100 in chips) 
Seat 5: KuningasRane ($200.94 in chips) 
Seat 6: BoyLoc0 ($162.72 in chips) 
Ysiven: posts small blind $0.50
S3MPR3IGUAL: posts big blind $1
*** HOLE CARDS ***
MaikonAll: folds 
Oli3579: folds 
KuningasRane: folds 
BoyLoc0: folds 
Ysiven: raises $2 to $3
S3MPR3IGUAL: calls $2
*** FLOP *** [9h Qh 7h]
Ysiven: checks 
S3MPR3IGUAL: checks 
*** TURN *** [9h Qh 7h] [5s]
Ysiven: bets $1.88
S3MPR3IGUAL: calls $1.88
*** RIVER *** [9h Qh 7h 5s] [Jc]
Ysiven: bets $3.06
S3MPR3IGUAL: calls $3.06
*** SHOW DOWN ***
Ysiven: shows [Js Jd] (three of a kind, Jacks)
S3MPR3IGUAL: mucks hand 
Ysiven collected $15.09 from pot
*** SUMMARY ***
Total pot $15.88 | Rake $0.79 
Board [9h Qh 7h 5s Jc]
Seat 1: Ysiven (small blind) showed [Js Jd] and won ($15.09) with three of a kind, Jacks
Seat 2: S3MPR3IGUAL (big blind) mucked
Seat 3: MaikonAll folded before Flop (didn't bet)
Seat 4: Oli3579 folded before Flop (didn't bet)
Seat 5: KuningasRane folded before Flop (didn't bet)
Seat 6: BoyLoc0 (button) folded before Flop (didn't bet)



PokerStars Hand #254639426998:  Hold'em No Limit ($0.50/$1.00 USD) - 2025/01/31 17:55:21 WET [2025/01/31 12:55:21 ET]
Table 'Adria' 6-max Seat #1 is the button
Seat 3: MaikonAll ($101.50 in chips) is sitting out
Seat 1: Ysiven ($111.15 in chips) 
Seat 2: S3MPR3IGUAL ($100 in chips) 
Seat 4: Oli3579 ($100 in chips) 
Seat 5: KuningasRane ($200.94 in chips) 
Seat 6: BoyLoc0 ($162.72 in chips) 
S3MPR3IGUAL: posts small blind $0.50
MaikonAll: is sitting out 
Oli3579: posts big blind $1
*** HOLE CARDS ***
KuningasRane: folds 
BoyLoc0: folds 
BoyLoc0 leaves the table
Ysiven: folds 
MaikonAll leaves the table
S3MPR3IGUAL: raises $2 to $3
Oli3579: raises $6.50 to $9.50
S3MPR3IGUAL: folds 
Uncalled bet ($6.50) returned to Oli3579
Oli3579 collected $6 from pot
Oli3579: doesn't show hand 
*** SUMMARY ***
Total pot $6 | Rake $0 
Seat 3: MaikonAll
Seat 1: Ysiven (button) folded before Flop (didn't bet)
Seat 2: S3MPR3IGUAL (small blind) folded before Flop
Seat 4: Oli3579 (big blind) collected ($6)
Seat 5: KuningasRane folded before Flop (didn't bet)
Seat 6: BoyLoc0 folded before Flop (didn't bet)



PokerStars Hand #254639434145:  Hold'em No Limit ($0.50/$1.00 USD) - 2025/01/31 17:56:00 WET [2025/01/31 12:56:00 ET]
Table 'Adria' 6-max Seat #2 is the button
Seat 1: Ysiven ($111.15 in chips) 
Seat 2: S3MPR3IGUAL ($100 in chips) 
Seat 4: Oli3579 ($103 in chips) 
Seat 5: KuningasRane ($200.94 in chips) 
Oli3579: posts small blind $0.50
KuningasRane: posts big blind $1
*** HOLE CARDS ***
Ysiven: folds 
S3MPR3IGUAL: raises $1.20 to $2.20
Oli3579: folds 
KuningasRane: folds 
Uncalled bet ($1.20) returned to S3MPR3IGUAL
S3MPR3IGUAL collected $2.50 from pot
S3MPR3IGUAL: doesn't show hand 
*** SUMMARY ***
Total pot $2.50 | Rake $0 
Seat 1: Ysiven folded before Flop (didn't bet)
Seat 2: S3MPR3IGUAL (button) collected ($2.50)
Seat 4: Oli3579 (small blind) folded before Flop
Seat 5: KuningasRane (big blind) folded before Flop



PokerStars Hand #254639437433:  Hold'em No Limit ($0.50/$1.00 USD) - 2025/01/31 17:56:18 WET [2025/01/31 12:56:18 ET]
Table 'Adria' 6-max Seat #4 is the button
Seat 1: Ysiven ($111.15 in chips) 
Seat 2: S3MPR3IGUAL ($101.50 in chips) 
Seat 4: Oli3579 ($102.50 in chips) 
Seat 5: KuningasRane ($199.94 in chips) 
KuningasRane: posts small blind $0.50
Ysiven: posts big blind $1
*** HOLE CARDS ***
S3MPR3IGUAL: folds 
Oli3579: folds 
KuningasRane: raises $1.50 to $2.50
Ysiven: folds 
Uncalled bet ($1.50) returned to KuningasRane
KuningasRane collected $2 from pot
KuningasRane: doesn't show hand 
*** SUMMARY ***
Total pot $2 | Rake $0 
Seat 1: Ysiven (big blind) folded before Flop
Seat 2: S3MPR3IGUAL folded before Flop (didn't bet)
Seat 4: Oli3579 (button) folded before Flop (didn't bet)
Seat 5: KuningasRane (small blind) collected ($2)



PokerStars Hand #254639439512:  Hold'em No Limit ($0.50/$1.00 USD) - 2025/01/31 17:56:29 WET [2025/01/31 12:56:29 ET]
Table 'Adria' 6-max Seat #5 is the button
Seat 1: Ysiven ($110.15 in chips) 
Seat 2: S3MPR3IGUAL ($101.50 in chips) 
Seat 4: Oli3579 ($102.50 in chips) 
Seat 5: KuningasRane ($200.94 in chips) 
Ysiven: posts small blind $0.50
S3MPR3IGUAL: posts big blind $1
*** HOLE CARDS ***
Oli3579: folds 
KuningasRane: raises $1.50 to $2.50
Ysiven: folds 
S3MPR3IGUAL: folds 
Uncalled bet ($1.50) returned to KuningasRane
KuningasRane collected $2.50 from pot
KuningasRane: doesn't show hand 
*** SUMMARY ***
Total pot $2.50 | Rake $0 
Seat 1: Ysiven (small blind) folded before Flop
Seat 2: S3MPR3IGUAL (big blind) folded before Flop
Seat 4: Oli3579 folded before Flop (didn't bet)
Seat 5: KuningasRane (button) collected ($2.50)



PokerStars Hand #254639442074:  Hold'em No Limit ($0.50/$1.00 USD) - 2025/01/31 17:56:43 WET [2025/01/31 12:56:43 ET]
Table 'Adria' 6-max Seat #1 is the button
Seat 1: Ysiven ($109.65 in chips) 
Seat 2: S3MPR3IGUAL ($100.50 in chips) 
Seat 4: Oli3579 ($102.50 in chips) 
Seat 5: KuningasRane ($202.44 in chips) 
S3MPR3IGUAL: posts small blind $0.50
Oli3579: posts big blind $1
*** HOLE CARDS ***
KuningasRane: folds 
Ysiven: folds 
S3MPR3IGUAL: folds 
Uncalled bet ($0.50) returned to Oli3579
Oli3579 collected $1 from pot
Oli3579: doesn't show hand 
*** SUMMARY ***
Total pot $1 | Rake $0 
Seat 1: Ysiven (button) folded before Flop (didn't bet)
Seat 2: S3MPR3IGUAL (small blind) folded before Flop
Seat 4: Oli3579 (big blind) collected ($1)
Seat 5: KuningasRane folded before Flop (didn't bet)



PokerStars Hand #254639444200:  Hold'em No Limit ($0.50/$1.00 USD) - 2025/01/31 17:56:55 WET [2025/01/31 12:56:55 ET]
Table 'Adria' 6-max Seat #2 is the button
Seat 1: Ysiven ($109.65 in chips) 
Seat 2: S3MPR3IGUAL ($100 in chips) 
Seat 4: Oli3579 ($103 in chips) 
Seat 5: KuningasRane ($202.44 in chips) 
Oli3579: posts small blind $0.50
KuningasRane: posts big blind $1
*** HOLE CARDS ***
zoliver2011 joins the table at seat #6 
Ysiven: folds 
michasia joins the table at seat #3 
S3MPR3IGUAL: raises $1.20 to $2.20
Oli3579: folds 
KuningasRane: folds 
Uncalled bet ($1.20) returned to S3MPR3IGUAL
S3MPR3IGUAL collected $2.50 from pot
S3MPR3IGUAL: doesn't show hand 
*** SUMMARY ***
Total pot $2.50 | Rake $0 
Seat 1: Ysiven folded before Flop (didn't bet)
Seat 2: S3MPR3IGUAL (button) collected ($2.50)
Seat 4: Oli3579 (small blind) folded before Flop
Seat 5: KuningasRane (big blind) folded before Flop



PokerStars Hand #254639446924:  Hold'em No Limit ($0.50/$1.00 USD) - 2025/01/31 17:57:10 WET [2025/01/31 12:57:10 ET]
Table 'Adria' 6-max Seat #4 is the button
Seat 3: michasia ($100 in chips) is sitting out
Seat 1: Ysiven ($109.65 in chips) 
Seat 2: S3MPR3IGUAL ($101.50 in chips) 
Seat 4: Oli3579 ($102.50 in chips) 
Seat 5: KuningasRane ($201.44 in chips) 
Seat 6: zoliver2011 ($100 in chips) 
KuningasRane: posts small blind $0.50
zoliver2011: posts big blind $1
michasia: sits out 
*** HOLE CARDS ***
Ysiven: raises $1 to $2
S3MPR3IGUAL: folds 
Oli3579: folds 
KuningasRane: folds 
zoliver2011: raises $4.50 to $6.50
Ysiven: calls $4.50
*** FLOP *** [6c 4h Td]
zoliver2011: bets $12.82
Ysiven: calls $12.82
*** TURN *** [6c 4h Td] [As]
zoliver2011: bets $37.18
Ysiven: calls $37.18
*** RIVER *** [6c 4h Td As] [Ah]
zoliver2011: bets $43.50 and is all-in
Ysiven: calls $43.50
*** SHOW DOWN ***
zoliver2011: shows [Ac 3s] (three of a kind, Aces)
Ysiven: shows [Tc Th] (a full house, Tens full of Aces)
Ysiven collected $198 from pot
*** SUMMARY ***
Total pot $200.50 | Rake $2.50 
Board [6c 4h Td As Ah]
Seat 3: michasia
Seat 1: Ysiven showed [Tc Th] and won ($198) with a full house, Tens full of Aces
Seat 2: S3MPR3IGUAL folded before Flop (didn't bet)
Seat 4: Oli3579 (button) folded before Flop (didn't bet)
Seat 5: KuningasRane (small blind) folded before Flop
Seat 6: zoliver2011 (big blind) showed [Ac 3s] and lost with three of a kind, Aces



PokerStars Hand #254639457341:  Hold'em No Limit ($0.50/$1.00 USD) - 2025/01/31 17:58:05 WET [2025/01/31 12:58:05 ET]
Table 'Adria' 6-max Seat #5 is the button
Seat 3: michasia ($100 in chips) is sitting out
Seat 6: zoliver2011 ($0 in chips) is sitting out
Seat 1: Ysiven ($207.65 in chips) 
Seat 2: S3MPR3IGUAL ($101.50 in chips) 
Seat 4: Oli3579 ($102.50 in chips) 
Seat 5: KuningasRane ($200.94 in chips) 
Ysiven: posts small blind $0.50
S3MPR3IGUAL: posts big blind $1
michasia: sits out 
*** HOLE CARDS ***
Oli3579: folds 
KuningasRane: folds 
Ysiven: folds 
Uncalled bet ($0.50) returned to S3MPR3IGUAL
S3MPR3IGUAL collected $1 from pot
S3MPR3IGUAL: doesn't show hand 
*** SUMMARY ***
Total pot $1 | Rake $0 
Seat 3: michasia
Seat 6: zoliver2011
Seat 1: Ysiven (small blind) folded before Flop
Seat 2: S3MPR3IGUAL (big blind) collected ($1)
Seat 4: Oli3579 folded before Flop (didn't bet)
Seat 5: KuningasRane (button) folded before Flop (didn't bet)



PokerStars Hand #254639458969:  Hold'em No Limit ($0.50/$1.00 USD) - 2025/01/31 17:58:13 WET [2025/01/31 12:58:13 ET]
Table 'Adria' 6-max Seat #1 is the button
Seat 1: Ysiven ($207.15 in chips) 
Seat 2: S3MPR3IGUAL ($102 in chips) 
Seat 3: michasia ($100 in chips) 
Seat 4: Oli3579 ($102.50 in chips) 
Seat 5: KuningasRane ($200.94 in chips) 
Seat 6: zoliver2011 ($100 in chips) 
S3MPR3IGUAL: posts small blind $0.50
michasia: posts big blind $1
zoliver2011: posts small blind $0.50
*** HOLE CARDS ***
Oli3579: folds 
KuningasRane: raises $1.50 to $2.50
zoliver2011: folds 
Ysiven: folds 
S3MPR3IGUAL: folds 
michasia: folds 
Uncalled bet ($1.50) returned to KuningasRane
KuningasRane collected $3 from pot
KuningasRane: doesn't show hand 
*** SUMMARY ***
Total pot $3 | Rake $0 
Seat 1: Ysiven (button) folded before Flop (didn't bet)
Seat 2: S3MPR3IGUAL (small blind) folded before Flop
Seat 3: michasia (big blind) folded before Flop
Seat 4: Oli3579 folded before Flop (didn't bet)
Seat 5: KuningasRane collected ($3)
Seat 6: zoliver2011 folded before Flop (didn't bet)



PokerStars Hand #254639462728:  Hold'em No Limit ($0.50/$1.00 USD) - 2025/01/31 17:58:33 WET [2025/01/31 12:58:33 ET]
Table 'Adria' 6-max Seat #2 is the button
Seat 1: Ysiven ($207.15 in chips) 
Seat 2: S3MPR3IGUAL ($101.50 in chips) 
Seat 3: michasia ($100 in chips) 
Seat 4: Oli3579 ($102.50 in chips) 
Seat 5: KuningasRane ($202.94 in chips) 
Seat 6: zoliver2011 ($99.50 in chips) 
michasia: posts small blind $0.50
Oli3579: posts big blind $1
*** HOLE CARDS ***
KuningasRane: folds 
zoliver2011: calls $1
Ysiven: raises $3 to $4
S3MPR3IGUAL: folds 
michasia: folds 
Oli3579: folds 
zoliver2011: calls $3
*** FLOP *** [7d Js Kc]
zoliver2011: checks 
Ysiven: bets $2.98
zoliver2011: folds 
Uncalled bet ($2.98) returned to Ysiven
Ysiven collected $9.02 from pot
Ysiven: doesn't show hand 
*** SUMMARY ***
Total pot $9.50 | Rake $0.48 
Board [7d Js Kc]
Seat 1: Ysiven collected ($9.02)
Seat 2: S3MPR3IGUAL (button) folded before Flop (didn't bet)
Seat 3: michasia (small blind) folded before Flop
Seat 4: Oli3579 (big blind) folded before Flop
Seat 5: KuningasRane folded before Flop (didn't bet)
Seat 6: zoliver2011 folded on the Flop



PokerStars Hand #254639470228:  Hold'em No Limit ($0.50/$1.00 USD) - 2025/01/31 17:59:14 WET [2025/01/31 12:59:14 ET]
Table 'Adria' 6-max Seat #3 is the button
Seat 1: Ysiven ($212.17 in chips) 
Seat 2: S3MPR3IGUAL ($101.50 in chips) 
Seat 3: michasia ($100 in chips) 
Seat 4: Oli3579 ($101.50 in chips) 
Seat 5: KuningasRane ($202.94 in chips) 
Seat 6: zoliver2011 ($95.50 in chips) 
Oli3579: posts small blind $0.50
KuningasRane: posts big blind $1
*** HOLE CARDS ***
zoliver2011: folds 
Ysiven: folds 
S3MPR3IGUAL: folds 
michasia: folds 
Oli3579: raises $2 to $3
KuningasRane: folds 
Uncalled bet ($2) returned to Oli3579
Oli3579 collected $2 from pot
Oli3579: doesn't show hand 
*** SUMMARY ***
Total pot $2 | Rake $0 
Seat 1: Ysiven folded before Flop (didn't bet)
Seat 2: S3MPR3IGUAL folded before Flop (didn't bet)
Seat 3: michasia (button) folded before Flop (didn't bet)
Seat 4: Oli3579 (small blind) collected ($2)
Seat 5: KuningasRane (big blind) folded before Flop
Seat 6: zoliver2011 folded before Flop (didn't bet)



PokerStars Hand #254639473471:  Hold'em No Limit ($0.50/$1.00 USD) - 2025/01/31 17:59:31 WET [2025/01/31 12:59:31 ET]
Table 'Adria' 6-max Seat #4 is the button
Seat 1: Ysiven ($212.17 in chips) 
Seat 2: S3MPR3IGUAL ($101.50 in chips) 
Seat 3: michasia ($100 in chips) 
Seat 4: Oli3579 ($102.50 in chips) 
Seat 5: KuningasRane ($201.94 in chips) 
Seat 6: zoliver2011 ($95.50 in chips) 
KuningasRane: posts small blind $0.50
zoliver2011: posts big blind $1
*** HOLE CARDS ***
Ysiven: folds 
S3MPR3IGUAL: folds 
michasia: folds 
Oli3579: raises $1.25 to $2.25
KuningasRane: folds 
zoliver2011: calls $1.25
*** FLOP *** [4h 9c Kh]
zoliver2011: checks 
Oli3579: bets $1.57
zoliver2011: folds 
Uncalled bet ($1.57) returned to Oli3579
Oli3579 collected $4.75 from pot
Oli3579: doesn't show hand 
*** SUMMARY ***
Total pot $5 | Rake $0.25 
Board [4h 9c Kh]
Seat 1: Ysiven folded before Flop (didn't bet)
Seat 2: S3MPR3IGUAL folded before Flop (didn't bet)
Seat 3: michasia folded before Flop (didn't bet)
Seat 4: Oli3579 (button) collected ($4.75)
Seat 5: KuningasRane (small blind) folded before Flop
Seat 6: zoliver2011 (big blind) folded on the Flop



PokerStars Hand #254639480074:  Hold'em No Limit ($0.50/$1.00 USD) - 2025/01/31 18:00:06 WET [2025/01/31 13:00:06 ET]
Table 'Adria' 6-max Seat #5 is the button
Seat 1: Ysiven ($212.17 in chips) 
Seat 2: S3MPR3IGUAL ($101.50 in chips) 
Seat 3: michasia ($100 in chips) 
Seat 4: Oli3579 ($105 in chips) 
Seat 5: KuningasRane ($201.44 in chips) 
Seat 6: zoliver2011 ($93.25 in chips) 
zoliver2011: posts small blind $0.50
Ysiven: posts big blind $1
*** HOLE CARDS ***
S3MPR3IGUAL: raises $1.20 to $2.20
michasia: folds 
Oli3579: folds 
KuningasRane: folds 
zoliver2011: folds 
Ysiven: folds 
Uncalled bet ($1.20) returned to S3MPR3IGUAL
S3MPR3IGUAL collected $2.50 from pot
S3MPR3IGUAL: doesn't show hand 
*** SUMMARY ***
Total pot $2.50 | Rake $0 
Seat 1: Ysiven (big blind) folded before Flop
Seat 2: S3MPR3IGUAL collected ($2.50)
Seat 3: michasia folded before Flop (didn't bet)
Seat 4: Oli3579 folded before Flop (didn't bet)
Seat 5: KuningasRane (button) folded before Flop (didn't bet)
Seat 6: zoliver2011 (small blind) folded before Flop



PokerStars Hand #254639483427:  Hold'em No Limit ($0.50/$1.00 USD) - 2025/01/31 18:00:24 WET [2025/01/31 13:00:24 ET]
Table 'Adria' 6-max Seat #6 is the button
Seat 1: Ysiven ($211.17 in chips) 
Seat 2: S3MPR3IGUAL ($103 in chips) 
Seat 3: michasia ($100 in chips) 
Seat 4: Oli3579 ($105 in chips) 
Seat 5: KuningasRane ($201.44 in chips) 
Seat 6: zoliver2011 ($92.75 in chips) 
Ysiven: posts small blind $0.50
S3MPR3IGUAL: posts big blind $1
*** HOLE CARDS ***
michasia: raises $1.60 to $2.60
Oli3579: folds 
KuningasRane: folds 
zoliver2011: folds 
Ysiven: folds 
S3MPR3IGUAL: folds 
Uncalled bet ($1.60) returned to michasia
michasia collected $2.50 from pot
michasia: doesn't show hand 
*** SUMMARY ***
Total pot $2.50 | Rake $0 
Seat 1: Ysiven (small blind) folded before Flop
Seat 2: S3MPR3IGUAL (big blind) folded before Flop
Seat 3: michasia collected ($2.50)
Seat 4: Oli3579 folded before Flop (didn't bet)
Seat 5: KuningasRane folded before Flop (didn't bet)
Seat 6: zoliver2011 (button) folded before Flop (didn't bet)



PokerStars Hand #254639488378:  Hold'em No Limit ($0.50/$1.00 USD) - 2025/01/31 18:00:49 WET [2025/01/31 13:00:49 ET]
Table 'Adria' 6-max Seat #1 is the button
Seat 1: Ysiven ($210.67 in chips) 
Seat 2: S3MPR3IGUAL ($102 in chips) 
Seat 3: michasia ($101.50 in chips) 
Seat 4: Oli3579 ($105 in chips) 
Seat 5: KuningasRane ($201.44 in chips) 
Seat 6: zoliver2011 ($92.75 in chips) 
S3MPR3IGUAL: posts small blind $0.50
michasia: posts big blind $1
*** HOLE CARDS ***
Oli3579: folds 
KuningasRane: folds 
zoliver2011: raises $2.50 to $3.50
Ysiven: folds 
S3MPR3IGUAL: folds 
michasia: folds 
Uncalled bet ($2.50) returned to zoliver2011
zoliver2011 collected $2.50 from pot
zoliver2011: doesn't show hand 
*** SUMMARY ***
Total pot $2.50 | Rake $0 
Seat 1: Ysiven (button) folded before Flop (didn't bet)
Seat 2: S3MPR3IGUAL (small blind) folded before Flop
Seat 3: michasia (big blind) folded before Flop
Seat 4: Oli3579 folded before Flop (didn't bet)
Seat 5: KuningasRane folded before Flop (didn't bet)
Seat 6: zoliver2011 collected ($2.50)



PokerStars Hand #254639494533:  Hold'em No Limit ($0.50/$1.00 USD) - 2025/01/31 18:01:18 WET [2025/01/31 13:01:18 ET]
Table 'Adria' 6-max Seat #2 is the button
Seat 1: Ysiven ($210.67 in chips) 
Seat 2: S3MPR3IGUAL ($101.50 in chips) 
Seat 3: michasia ($100.50 in chips) 
Seat 4: Oli3579 ($105 in chips) 
Seat 5: KuningasRane ($201.44 in chips) 
Seat 6: zoliver2011 ($94.25 in chips) 
michasia: posts small blind $0.50
Oli3579: posts big blind $1
*** HOLE CARDS ***
KuningasRane: raises $1.50 to $2.50
zoliver2011: calls $2.50
Ysiven: folds 
S3MPR3IGUAL: folds 
michasia: folds 
Oli3579: folds 
*** FLOP *** [6h 8h Qc]
KuningasRane: bets $2.47
zoliver2011: calls $2.47
*** TURN *** [6h 8h Qc] [7d]
KuningasRane: bets $4.35
zoliver2011: calls $4.35
*** RIVER *** [6h 8h Qc 7d] [Qh]
KuningasRane: checks 
zoliver2011: bets $9.57
KuningasRane: calls $9.57
*** SHOW DOWN ***
zoliver2011: shows [Jd 7h] (two pair, Queens and Sevens)
KuningasRane: shows [Qs Ts] (three of a kind, Queens)
KuningasRane collected $37.32 from pot
*** SUMMARY ***
Total pot $39.28 | Rake $1.96 
Board [6h 8h Qc 7d Qh]
Seat 1: Ysiven folded before Flop (didn't bet)
Seat 2: S3MPR3IGUAL (button) folded before Flop (didn't bet)
Seat 3: michasia (small blind) folded before Flop
Seat 4: Oli3579 (big blind) folded before Flop
Seat 5: KuningasRane showed [Qs Ts] and won ($37.32) with three of a kind, Queens
Seat 6: zoliver2011 showed [Jd 7h] and lost with two pair, Queens and Sevens



PokerStars Hand #254639502611:  Hold'em No Limit ($0.50/$1.00 USD) - 2025/01/31 18:01:53 WET [2025/01/31 13:01:53 ET]
Table 'Adria' 6-max Seat #3 is the button
Seat 1: Ysiven ($210.67 in chips) 
Seat 2: S3MPR3IGUAL ($101.50 in chips) 
Seat 3: michasia ($100 in chips) 
Seat 4: Oli3579 ($104 in chips) 
Seat 5: KuningasRane ($219.87 in chips) 
Seat 6: zoliver2011 ($75.36 in chips) 
Oli3579: posts small blind $0.50
KuningasRane: posts big blind $1
*** HOLE CARDS ***
zoliver2011: folds 
Ysiven: folds 
S3MPR3IGUAL: folds 
michasia: folds 
Oli3579: folds 
Uncalled bet ($0.50) returned to KuningasRane
KuningasRane collected $1 from pot
KuningasRane: doesn't show hand 
*** SUMMARY ***
Total pot $1 | Rake $0 
Seat 1: Ysiven folded before Flop (didn't bet)
Seat 2: S3MPR3IGUAL folded before Flop (didn't bet)
Seat 3: michasia (button) folded before Flop (didn't bet)
Seat 4: Oli3579 (small blind) folded before Flop
Seat 5: KuningasRane (big blind) collected ($1)
Seat 6: zoliver2011 folded before Flop (didn't bet)



PokerStars Hand #254639505265:  Hold'em No Limit ($0.50/$1.00 USD) - 2025/01/31 18:02:05 WET [2025/01/31 13:02:05 ET]
Table 'Adria' 6-max Seat #4 is the button
Seat 1: Ysiven ($210.67 in chips) 
Seat 2: S3MPR3IGUAL ($101.50 in chips) 
Seat 3: michasia ($100 in chips) 
Seat 4: Oli3579 ($103.50 in chips) 
Seat 5: KuningasRane ($220.37 in chips) 
Seat 6: zoliver2011 ($75.36 in chips) 
KuningasRane: posts small blind $0.50
zoliver2011: posts big blind $1
*** HOLE CARDS ***
Ysiven: folds 
S3MPR3IGUAL: raises $1.20 to $2.20
michasia: folds 
Oli3579: folds 
KuningasRane: calls $1.70
zoliver2011: calls $1.20
*** FLOP *** [6d Js Jd]
KuningasRane: checks 
zoliver2011: checks 
S3MPR3IGUAL: bets $1.76
KuningasRane: folds 
zoliver2011: calls $1.76
*** TURN *** [6d Js Jd] [8d]
zoliver2011: checks 
S3MPR3IGUAL: bets $6.34
zoliver2011: calls $6.34
*** RIVER *** [6d Js Jd 8d] [6h]
zoliver2011: bets $21.66
S3MPR3IGUAL: calls $21.66
*** SHOW DOWN ***
zoliver2011: shows [Qd Td] (a flush, Queen high)
S3MPR3IGUAL: shows [6s 8s] (a full house, Sixes full of Jacks)
S3MPR3IGUAL collected $63.62 from pot
*** SUMMARY ***
Total pot $66.12 | Rake $2.50 
Board [6d Js Jd 8d 6h]
Seat 1: Ysiven folded before Flop (didn't bet)
Seat 2: S3MPR3IGUAL showed [6s 8s] and won ($63.62) with a full house, Sixes full of Jacks
Seat 3: michasia folded before Flop (didn't bet)
Seat 4: Oli3579 (button) folded before Flop (didn't bet)
Seat 5: KuningasRane (small blind) folded on the Flop
Seat 6: zoliver2011 (big blind) showed [Qd Td] and lost with a flush, Queen high



PokerStars Hand #254639521811:  Hold'em No Limit ($0.50/$1.00 USD) - 2025/01/31 18:03:12 WET [2025/01/31 13:03:12 ET]
Table 'Adria' 6-max Seat #5 is the button
Seat 1: Ysiven ($210.67 in chips) 
Seat 2: S3MPR3IGUAL ($133.16 in chips) 
Seat 3: michasia ($100 in chips) 
Seat 4: Oli3579 ($103.50 in chips) 
Seat 5: KuningasRane ($218.17 in chips) 
Seat 6: zoliver2011 ($43.40 in chips) 
zoliver2011: posts small blind $0.50
Ysiven: posts big blind $1
*** HOLE CARDS ***
S3MPR3IGUAL has timed out
S3MPR3IGUAL: folds 
michasia: folds 
Oli3579: folds 
KuningasRane: folds 
zoliver2011: raises $2 to $3
Ysiven: calls $2
*** FLOP *** [8h 4d Qh]
zoliver2011: bets $2.85
Ysiven: folds 
Uncalled bet ($2.85) returned to zoliver2011
zoliver2011 collected $5.70 from pot
zoliver2011: doesn't show hand 
*** SUMMARY ***
Total pot $6 | Rake $0.30 
Board [8h 4d Qh]
Seat 1: Ysiven (big blind) folded on the Flop
Seat 2: S3MPR3IGUAL folded before Flop (didn't bet)
Seat 3: michasia folded before Flop (didn't bet)
Seat 4: Oli3579 folded before Flop (didn't bet)
Seat 5: KuningasRane (button) folded before Flop (didn't bet)
Seat 6: zoliver2011 (small blind) collected ($5.70)



PokerStars Hand #254639531583:  Hold'em No Limit ($0.50/$1.00 USD) - 2025/01/31 18:03:51 WET [2025/01/31 13:03:51 ET]
Table 'Adria' 6-max Seat #6 is the button
Seat 1: Ysiven ($207.67 in chips) 
Seat 2: S3MPR3IGUAL ($133.16 in chips) 
Seat 3: michasia ($100 in chips) 
Seat 4: Oli3579 ($103.50 in chips) 
Seat 5: KuningasRane ($218.17 in chips) 
Seat 6: zoliver2011 ($46.10 in chips) 
Ysiven: posts small blind $0.50
S3MPR3IGUAL: posts big blind $1
*** HOLE CARDS ***
michasia: folds 
Oli3579: raises $1.25 to $2.25
KuningasRane: folds 
zoliver2011: calls $2.25
Ysiven: raises $10.75 to $13
S3MPR3IGUAL: folds 
Oli3579: folds 
zoliver2011: folds 
Uncalled bet ($10.75) returned to Ysiven
Ysiven collected $7.75 from pot
Ysiven: doesn't show hand 
*** SUMMARY ***
Total pot $7.75 | Rake $0 
Seat 1: Ysiven (small blind) collected ($7.75)
Seat 2: S3MPR3IGUAL (big blind) folded before Flop
Seat 3: michasia folded before Flop (didn't bet)
Seat 4: Oli3579 folded before Flop
Seat 5: KuningasRane folded before Flop (didn't bet)
Seat 6: zoliver2011 (button) folded before Flop



PokerStars Hand #254639539344:  Hold'em No Limit ($0.50/$1.00 USD) - 2025/01/31 18:04:22 WET [2025/01/31 13:04:22 ET]
Table 'Adria' 6-max Seat #1 is the button
Seat 1: Ysiven ($213.17 in chips) 
Seat 2: S3MPR3IGUAL ($132.16 in chips) 
Seat 3: michasia ($100 in chips) 
Seat 4: Oli3579 ($101.25 in chips) 
Seat 5: KuningasRane ($218.17 in chips) 
Seat 6: zoliver2011 ($43.85 in chips) 
S3MPR3IGUAL: posts small blind $0.50
michasia: posts big blind $1
*** HOLE CARDS ***
Oli3579: folds 
KuningasRane: folds 
zoliver2011: folds 
Ysiven: folds 
S3MPR3IGUAL: folds 
Uncalled bet ($0.50) returned to michasia
michasia collected $1 from pot
michasia: doesn't show hand 
*** SUMMARY ***
Total pot $1 | Rake $0 
Seat 1: Ysiven (button) folded before Flop (didn't bet)
Seat 2: S3MPR3IGUAL (small blind) folded before Flop
Seat 3: michasia (big blind) collected ($1)
Seat 4: Oli3579 folded before Flop (didn't bet)
Seat 5: KuningasRane folded before Flop (didn't bet)
Seat 6: zoliver2011 folded before Flop (didn't bet)



PokerStars Hand #254639541778:  Hold'em No Limit ($0.50/$1.00 USD) - 2025/01/31 18:04:32 WET [2025/01/31 13:04:32 ET]
Table 'Adria' 6-max Seat #2 is the button
Seat 1: Ysiven ($213.17 in chips) 
Seat 2: S3MPR3IGUAL ($131.66 in chips) 
Seat 3: michasia ($100.50 in chips) 
Seat 4: Oli3579 ($101.25 in chips) 
Seat 5: KuningasRane ($218.17 in chips) 
Seat 6: zoliver2011 ($43.85 in chips) 
michasia: posts small blind $0.50
Oli3579: posts big blind $1
*** HOLE CARDS ***
KuningasRane: folds 
zoliver2011: raises $1 to $2
Ysiven: folds 
S3MPR3IGUAL: folds 
michasia: folds 
Oli3579: folds 
Uncalled bet ($1) returned to zoliver2011
zoliver2011 collected $2.50 from pot
zoliver2011: doesn't show hand 
*** SUMMARY ***
Total pot $2.50 | Rake $0 
Seat 1: Ysiven folded before Flop (didn't bet)
Seat 2: S3MPR3IGUAL (button) folded before Flop (didn't bet)
Seat 3: michasia (small blind) folded before Flop
Seat 4: Oli3579 (big blind) folded before Flop
Seat 5: KuningasRane folded before Flop (didn't bet)
Seat 6: zoliver2011 collected ($2.50)



PokerStars Hand #254639545994:  Hold'em No Limit ($0.50/$1.00 USD) - 2025/01/31 18:04:48 WET [2025/01/31 13:04:48 ET]
Table 'Adria' 6-max Seat #3 is the button
Seat 1: Ysiven ($213.17 in chips) 
Seat 2: S3MPR3IGUAL ($131.66 in chips) 
Seat 3: michasia ($100 in chips) 
Seat 4: Oli3579 ($100.25 in chips) 
Seat 5: KuningasRane ($218.17 in chips) 
Seat 6: zoliver2011 ($45.35 in chips) 
Oli3579: posts small blind $0.50
KuningasRane: posts big blind $1
*** HOLE CARDS ***
zoliver2011: raises $2 to $3
Ysiven: folds 
S3MPR3IGUAL: folds 
michasia: raises $6 to $9
Oli3579: folds 
KuningasRane: folds 
zoliver2011: calls $6
*** FLOP *** [6d 3d Tc]
zoliver2011: checks 
michasia: bets $6.11
zoliver2011: calls $6.11
*** TURN *** [6d 3d Tc] [9d]
zoliver2011: checks 
michasia: bets $30.13
zoliver2011: raises $0.11 to $30.24 and is all-in
michasia: calls $0.11
*** RIVER *** [6d 3d Tc 9d] [Ad]
*** SHOW DOWN ***
zoliver2011: shows [6s 9s] (two pair, Nines and Sixes)
michasia: shows [Qh Qc] (a pair of Queens)
zoliver2011 collected $89.70 from pot
*** SUMMARY ***
Total pot $92.20 | Rake $2.50 
Board [6d 3d Tc 9d Ad]
Seat 1: Ysiven folded before Flop (didn't bet)
Seat 2: S3MPR3IGUAL folded before Flop (didn't bet)
Seat 3: michasia (button) showed [Qh Qc] and lost with a pair of Queens
Seat 4: Oli3579 (small blind) folded before Flop
Seat 5: KuningasRane (big blind) folded before Flop
Seat 6: zoliver2011 showed [6s 9s] and won ($89.70) with two pair, Nines and Sixes



PokerStars Hand #254639557697:  Hold'em No Limit ($0.50/$1.00 USD) - 2025/01/31 18:05:35 WET [2025/01/31 13:05:35 ET]
Table 'Adria' 6-max Seat #4 is the button
Seat 1: Ysiven ($213.17 in chips) 
Seat 2: S3MPR3IGUAL ($131.66 in chips) 
Seat 3: michasia ($100 in chips) 
Seat 4: Oli3579 ($100 in chips) 
Seat 5: KuningasRane ($217.17 in chips) 
Seat 6: zoliver2011 ($89.70 in chips) 
KuningasRane: posts small blind $0.50
zoliver2011: posts big blind $1
*** HOLE CARDS ***
Ysiven: raises $1 to $2
S3MPR3IGUAL: folds 
michasia: folds 
Oli3579: raises $5 to $7
KuningasRane: folds 
zoliver2011: calls $6
Ysiven: calls $5
*** FLOP *** [Tc 8c 6d]
zoliver2011: checks 
Ysiven: checks 
Oli3579: checks 
*** TURN *** [Tc 8c 6d] [Qc]
zoliver2011: bets $10.21
Ysiven: folds 
Oli3579: calls $10.21
*** RIVER *** [Tc 8c 6d Qc] [Qd]
zoliver2011: bets $39.82
Oli3579: calls $39.82
*** SHOW DOWN ***
zoliver2011: shows [Ts Td] (a full house, Tens full of Queens)
Oli3579: mucks hand 
zoliver2011 collected $119.06 from pot
*** SUMMARY ***
Total pot $121.56 | Rake $2.50 
Board [Tc 8c 6d Qc Qd]
Seat 1: Ysiven folded on the Turn
Seat 2: S3MPR3IGUAL folded before Flop (didn't bet)
Seat 3: michasia folded before Flop (didn't bet)
Seat 4: Oli3579 (button) mucked
Seat 5: KuningasRane (small blind) folded before Flop
Seat 6: zoliver2011 (big blind) showed [Ts Td] and won ($119.06) with a full house, Tens full of Queens



PokerStars Hand #254639574253:  Hold'em No Limit ($0.50/$1.00 USD) - 2025/01/31 18:06:39 WET [2025/01/31 13:06:39 ET]
Table 'Adria' 6-max Seat #5 is the button
Seat 1: Ysiven ($206.17 in chips) 
Seat 2: S3MPR3IGUAL ($131.66 in chips) 
Seat 3: michasia ($100 in chips) 
Seat 4: Oli3579 ($100 in chips) 
Seat 5: KuningasRane ($216.67 in chips) 
Seat 6: zoliver2011 ($151.73 in chips) 
zoliver2011: posts small blind $0.50
Ysiven: posts big blind $1
*** HOLE CARDS ***
S3MPR3IGUAL: folds 
michasia: raises $1.60 to $2.60
Oli3579: folds 
KuningasRane: calls $2.60
zoliver2011: calls $2.10
Ysiven: folds 
*** FLOP *** [9c Jh Ah]
zoliver2011: checks 
michasia: checks 
KuningasRane: bets $3.34
zoliver2011: calls $3.34
michasia: folds 
*** TURN *** [9c Jh Ah] [Kd]
zoliver2011: checks 
KuningasRane: checks 
*** RIVER *** [9c Jh Ah Kd] [Ks]
zoliver2011: checks 
KuningasRane: checks 
*** SHOW DOWN ***
zoliver2011: shows [9s Td] (two pair, Kings and Nines)
KuningasRane: shows [Qd Jc] (two pair, Kings and Jacks)
KuningasRane collected $14.71 from pot
*** SUMMARY ***
Total pot $15.48 | Rake $0.77 
Board [9c Jh Ah Kd Ks]
Seat 1: Ysiven (big blind) folded before Flop
Seat 2: S3MPR3IGUAL folded before Flop (didn't bet)
Seat 3: michasia folded on the Flop
Seat 4: Oli3579 folded before Flop (didn't bet)
Seat 5: KuningasRane (button) showed [Qd Jc] and won ($14.71) with two pair, Kings and Jacks
Seat 6: zoliver2011 (small blind) showed [9s Td] and lost with two pair, Kings and Nines



PokerStars Hand #254639588770:  Hold'em No Limit ($0.50/$1.00 USD) - 2025/01/31 18:07:36 WET [2025/01/31 13:07:36 ET]
Table 'Adria' 6-max Seat #6 is the button
Seat 1: Ysiven ($205.17 in chips) 
Seat 2: S3MPR3IGUAL ($131.66 in chips) 
Seat 3: michasia ($100 in chips) 
Seat 4: Oli3579 ($100 in chips) 
Seat 5: KuningasRane ($225.44 in chips) 
Seat 6: zoliver2011 ($145.79 in chips) 
Ysiven: posts small blind $0.50
S3MPR3IGUAL: posts big blind $1
*** HOLE CARDS ***
michasia: folds 
Oli3579: folds 
KuningasRane: folds 
zoliver2011: folds 
Ysiven: folds 
Uncalled bet ($0.50) returned to S3MPR3IGUAL
S3MPR3IGUAL collected $1 from pot
S3MPR3IGUAL: doesn't show hand 
*** SUMMARY ***
Total pot $1 | Rake $0 
Seat 1: Ysiven (small blind) folded before Flop
Seat 2: S3MPR3IGUAL (big blind) collected ($1)
Seat 3: michasia folded before Flop (didn't bet)
Seat 4: Oli3579 folded before Flop (didn't bet)
Seat 5: KuningasRane folded before Flop (didn't bet)
Seat 6: zoliver2011 (button) folded before Flop (didn't bet)



PokerStars Hand #254639591668:  Hold'em No Limit ($0.50/$1.00 USD) - 2025/01/31 18:07:48 WET [2025/01/31 13:07:48 ET]
Table 'Adria' 6-max Seat #1 is the button
Seat 1: Ysiven ($204.67 in chips) 
Seat 2: S3MPR3IGUAL ($132.16 in chips) 
Seat 3: michasia ($100 in chips) 
Seat 4: Oli3579 ($100 in chips) 
Seat 5: KuningasRane ($225.44 in chips) 
Seat 6: zoliver2011 ($145.79 in chips) 
S3MPR3IGUAL: posts small blind $0.50
michasia: posts big blind $1
*** HOLE CARDS ***
Oli3579: folds 
KuningasRane: folds 
zoliver2011: folds 
Ysiven: folds 
S3MPR3IGUAL: raises $2 to $3
michasia: calls $2
*** FLOP *** [Js Ac 4d]
S3MPR3IGUAL: bets $1.60
michasia: folds 
Uncalled bet ($1.60) returned to S3MPR3IGUAL
S3MPR3IGUAL collected $5.70 from pot
S3MPR3IGUAL: doesn't show hand 
*** SUMMARY ***
Total pot $6 | Rake $0.30 
Board [Js Ac 4d]
Seat 1: Ysiven (button) folded before Flop (didn't bet)
Seat 2: S3MPR3IGUAL (small blind) collected ($5.70)
Seat 3: michasia (big blind) folded on the Flop
Seat 4: Oli3579 folded before Flop (didn't bet)
Seat 5: KuningasRane folded before Flop (didn't bet)
Seat 6: zoliver2011 folded before Flop (didn't bet)



PokerStars Hand #254639724771:  Hold'em No Limit ($0.50/$1.00 USD) - 2025/01/31 18:16:23 WET [2025/01/31 13:16:23 ET]
Table 'Adria' 6-max Seat #1 is the button
Seat 1: Ysiven ($218.67 in chips) 
Seat 2: S3MPR3IGUAL ($100 in chips) 
Seat 3: michasia ($188.03 in chips) 
Seat 4: Oli3579 ($120.25 in chips) 
Seat 5: KuningasRane ($232.66 in chips) 
Seat 6: zoliver2011 ($78.06 in chips) 
S3MPR3IGUAL: posts small blind $0.50
michasia: posts big blind $1
*** HOLE CARDS ***
Oli3579: folds 
KuningasRane: folds 
zoliver2011: raises $2 to $3
Ysiven: folds 
S3MPR3IGUAL: raises $6 to $9
michasia: folds 
zoliver2011: calls $6
*** FLOP *** [3s Qs 7h]
S3MPR3IGUAL: bets $9.05
zoliver2011: folds 
Uncalled bet ($9.05) returned to S3MPR3IGUAL
S3MPR3IGUAL collected $18.05 from pot
S3MPR3IGUAL: doesn't show hand 
*** SUMMARY ***
Total pot $19 | Rake $0.95 
Board [3s Qs 7h]
Seat 1: Ysiven (button) folded before Flop (didn't bet)
Seat 2: S3MPR3IGUAL (small blind) collected ($18.05)
Seat 3: michasia (big blind) folded before Flop
Seat 4: Oli3579 folded before Flop (didn't bet)
Seat 5: KuningasRane folded before Flop (didn't bet)
Seat 6: zoliver2011 folded on the Flop



PokerStars Hand #254639731366:  Hold'em No Limit ($0.50/$1.00 USD) - 2025/01/31 18:16:49 WET [2025/01/31 13:16:49 ET]
Table 'Adria' 6-max Seat #2 is the button
Seat 1: Ysiven ($218.67 in chips) 
Seat 2: S3MPR3IGUAL ($109.05 in chips) 
Seat 3: michasia ($187.03 in chips) 
Seat 4: Oli3579 ($120.25 in chips) 
Seat 5: KuningasRane ($232.66 in chips) 
Seat 6: zoliver2011 ($69.06 in chips) 
michasia: posts small blind $0.50
Oli3579: posts big blind $1
*** HOLE CARDS ***
KuningasRane: folds 
zoliver2011: raises $2.50 to $3.50
Ysiven: folds 
S3MPR3IGUAL: folds 
michasia: folds 
Oli3579: raises $8.50 to $12
zoliver2011: raises $57.06 to $69.06 and is all-in
Oli3579: calls $57.06
*** FLOP *** [2h 6s Qs]
*** TURN *** [2h 6s Qs] [5c]
*** RIVER *** [2h 6s Qs 5c] [8s]
*** SHOW DOWN ***
Oli3579: shows [Kh Kd] (a pair of Kings)
zoliver2011: shows [Ah Ks] (high card Ace)
Oli3579 collected $136.12 from pot
*** SUMMARY ***
Total pot $138.62 | Rake $2.50 
Board [2h 6s Qs 5c 8s]
Seat 1: Ysiven folded before Flop (didn't bet)
Seat 2: S3MPR3IGUAL (button) folded before Flop (didn't bet)
Seat 3: michasia (small blind) folded before Flop
Seat 4: Oli3579 (big blind) showed [Kh Kd] and won ($136.12) with a pair of Kings
Seat 5: KuningasRane folded before Flop (didn't bet)
Seat 6: zoliver2011 showed [Ah Ks] and lost with high card Ace



PokerStars Hand #254639739637:  Hold'em No Limit ($0.50/$1.00 USD) - 2025/01/31 18:17:21 WET [2025/01/31 13:17:21 ET]
Table 'Adria' 6-max Seat #3 is the button
Seat 6: zoliver2011 ($0 in chips) is sitting out
Seat 1: Ysiven ($218.67 in chips) 
Seat 2: S3MPR3IGUAL ($109.05 in chips) 
Seat 3: michasia ($186.53 in chips) 
Seat 4: Oli3579 ($187.31 in chips) 
Seat 5: KuningasRane ($232.66 in chips) 
Oli3579: posts small blind $0.50
KuningasRane: posts big blind $1
*** HOLE CARDS ***
zoliver2011 leaves the table
Ysiven: folds 
S3MPR3IGUAL: raises $1.20 to $2.20
michasia: folds 
BoyLoc0 joins the table at seat #6 
Oli3579: folds 
KuningasRane: calls $1.20
*** FLOP *** [2h Ac Kc]
KuningasRane: checks 
S3MPR3IGUAL: bets $1.30
BoyLoc0 leaves the table
KuningasRane: folds 
Uncalled bet ($1.30) returned to S3MPR3IGUAL
S3MPR3IGUAL collected $4.66 from pot
S3MPR3IGUAL: doesn't show hand 
*** SUMMARY ***
Total pot $4.90 | Rake $0.24 
Board [2h Ac Kc]
Seat 6: zoliver2011
Seat 1: Ysiven folded before Flop (didn't bet)
Seat 2: S3MPR3IGUAL collected ($4.66)
Seat 3: michasia (button) folded before Flop (didn't bet)
Seat 4: Oli3579 (small blind) folded before Flop
Seat 5: KuningasRane (big blind) folded on the Flop



PokerStars Hand #254639746032:  Hold'em No Limit ($0.50/$1.00 USD) - 2025/01/31 18:17:46 WET [2025/01/31 13:17:46 ET]
Table 'Adria' 6-max Seat #4 is the button
Seat 1: Ysiven ($218.67 in chips) 
Seat 2: S3MPR3IGUAL ($111.51 in chips) 
Seat 3: michasia ($186.53 in chips) 
Seat 4: Oli3579 ($186.81 in chips) 
Seat 5: KuningasRane ($230.46 in chips) 
KuningasRane: posts small blind $0.50
Ysiven: posts big blind $1
*** HOLE CARDS ***
S3MPR3IGUAL: folds 
sta$igk joins the table at seat #6 
michasia: raises $1.80 to $2.80
Oli3579: folds 
KuningasRane: folds 
Ysiven: folds 
Uncalled bet ($1.80) returned to michasia
michasia collected $2.50 from pot
michasia: doesn't show hand 
*** SUMMARY ***
Total pot $2.50 | Rake $0 
Seat 1: Ysiven (big blind) folded before Flop
Seat 2: S3MPR3IGUAL folded before Flop (didn't bet)
Seat 3: michasia collected ($2.50)
Seat 4: Oli3579 (button) folded before Flop (didn't bet)
Seat 5: KuningasRane (small blind) folded before Flop



PokerStars Hand #254639749341:  Hold'em No Limit ($0.50/$1.00 USD) - 2025/01/31 18:17:59 WET [2025/01/31 13:17:59 ET]
Table 'Adria' 6-max Seat #5 is the button
Seat 2: S3MPR3IGUAL ($111.51 in chips) is sitting out
Seat 3: michasia ($188.03 in chips) is sitting out
Seat 6: sta$igk ($100 in chips) is sitting out
Seat 1: Ysiven ($217.67 in chips) 
Seat 4: Oli3579 ($186.81 in chips) 
Seat 5: KuningasRane ($229.96 in chips) 
Ysiven: posts small blind $0.50
S3MPR3IGUAL: is sitting out 
michasia: is sitting out 
Oli3579: posts big blind $1
*** HOLE CARDS ***
michasia leaves the table
KuningasRane: raises $1.50 to $2.50
Ysiven: folds 
Oli3579: calls $1.50
*** FLOP *** [Th 7h Jd]
Oli3579: checks 
KuningasRane: checks 
*** TURN *** [Th 7h Jd] [9s]
Oli3579: checks 
KuningasRane: checks 
*** RIVER *** [Th 7h Jd 9s] [3c]
Oli3579: bets $1.72
KuningasRane: folds 
Uncalled bet ($1.72) returned to Oli3579
Oli3579 collected $5.22 from pot
Oli3579: doesn't show hand 
*** SUMMARY ***
Total pot $5.50 | Rake $0.28 
Board [Th 7h Jd 9s 3c]
Seat 2: S3MPR3IGUAL
Seat 3: michasia
Seat 6: sta$igk
Seat 1: Ysiven (small blind) folded before Flop
Seat 4: Oli3579 (big blind) collected ($5.22)
Seat 5: KuningasRane (button) folded on the River



PokerStars Hand #254639760190:  Hold'em No Limit ($0.50/$1.00 USD) - 2025/01/31 18:18:41 WET [2025/01/31 13:18:41 ET]
Table 'Adria' 6-max Seat #1 is the button
Seat 2: S3MPR3IGUAL ($111.51 in chips) is sitting out
Seat 6: sta$igk ($100 in chips) is sitting out
Seat 1: Ysiven ($217.17 in chips) 
Seat 4: Oli3579 ($189.53 in chips) 
Seat 5: KuningasRane ($227.46 in chips) 
Oli3579: posts small blind $0.50
KuningasRane: posts big blind $1
sta$igk: sits out 
*** HOLE CARDS ***
Ysiven: raises $1.50 to $2.50
Oli3579: folds 
KuningasRane: folds 
Uncalled bet ($1.50) returned to Ysiven
Ysiven collected $2.50 from pot
Ysiven: doesn't show hand 
*** SUMMARY ***
Total pot $2.50 | Rake $0 
Seat 2: S3MPR3IGUAL
Seat 6: sta$igk
Seat 1: Ysiven (button) collected ($2.50)
Seat 4: Oli3579 (small blind) folded before Flop
Seat 5: KuningasRane (big blind) folded before Flop



PokerStars Hand #254639763358:  Hold'em No Limit ($0.50/$1.00 USD) - 2025/01/31 18:18:53 WET [2025/01/31 13:18:53 ET]
Table 'Adria' 6-max Seat #4 is the button
Seat 2: S3MPR3IGUAL ($111.51 in chips) is sitting out
Seat 1: Ysiven ($218.67 in chips) 
Seat 4: Oli3579 ($189.03 in chips) 
Seat 5: KuningasRane ($226.46 in chips) 
Seat 6: sta$igk ($100 in chips) 
KuningasRane: posts small blind $0.50
sta$igk: posts big blind $1
*** HOLE CARDS ***
Ysiven: raises $1.30 to $2.30
Oli3579: raises $5.70 to $8
KuningasRane: folds 
sta$igk: folds 
Ysiven: folds 
Uncalled bet ($5.70) returned to Oli3579
Oli3579 collected $6.10 from pot
Oli3579: doesn't show hand 
*** SUMMARY ***
Total pot $6.10 | Rake $0 
Seat 2: S3MPR3IGUAL
Seat 1: Ysiven folded before Flop
Seat 4: Oli3579 (button) collected ($6.10)
Seat 5: KuningasRane (small blind) folded before Flop
Seat 6: sta$igk (big blind) folded before Flop



PokerStars Hand #254639768297:  Hold'em No Limit ($0.50/$1.00 USD) - 2025/01/31 18:19:12 WET [2025/01/31 13:19:12 ET]
Table 'Adria' 6-max Seat #5 is the button
Seat 2: S3MPR3IGUAL ($111.51 in chips) is sitting out
Seat 1: Ysiven ($216.37 in chips) 
Seat 4: Oli3579 ($192.83 in chips) 
Seat 5: KuningasRane ($225.96 in chips) 
Seat 6: sta$igk ($100 in chips) 
sta$igk: posts small blind $0.50
Ysiven: posts big blind $1
*** HOLE CARDS ***
Oli3579: folds 
KuningasRane: folds 
sta$igk: raises $2 to $3
Ysiven: calls $2
*** FLOP *** [Th Jc 3s]
sta$igk: checks 
Ysiven: checks 
*** TURN *** [Th Jc 3s] [7c]
BMStef joins the table at seat #3 
BMStef is disconnected 
sta$igk: bets $8.55
Ysiven: folds 
Uncalled bet ($8.55) returned to sta$igk
sta$igk collected $5.70 from pot
sta$igk: doesn't show hand 
*** SUMMARY ***
Total pot $6 | Rake $0.30 
Board [Th Jc 3s 7c]
Seat 2: S3MPR3IGUAL
Seat 1: Ysiven (big blind) folded on the Turn
Seat 4: Oli3579 folded before Flop (didn't bet)
Seat 5: KuningasRane (button) folded before Flop (didn't bet)
Seat 6: sta$igk (small blind) collected ($5.70)



PokerStars Hand #254639784857:  Hold'em No Limit ($0.50/$1.00 USD) - 2025/01/31 18:20:17 WET [2025/01/31 13:20:17 ET]
Table 'Adria' 6-max Seat #6 is the button
Seat 3: BMStef ($32.54 in chips) is sitting out
Seat 1: Ysiven ($213.37 in chips) 
Seat 2: S3MPR3IGUAL ($111.51 in chips) 
Seat 4: Oli3579 ($192.83 in chips) 
Seat 5: KuningasRane ($225.96 in chips) 
Seat 6: sta$igk ($102.70 in chips) 
Ysiven: posts small blind $0.50
S3MPR3IGUAL: posts big blind $1
BMStef: sits out 
*** HOLE CARDS ***
Oli3579: folds 
KuningasRane: raises $1.50 to $2.50
sta$igk: folds 
Ysiven: folds 
S3MPR3IGUAL: folds 
Uncalled bet ($1.50) returned to KuningasRane
KuningasRane collected $2.50 from pot
KuningasRane: doesn't show hand 
*** SUMMARY ***
Total pot $2.50 | Rake $0 
Seat 3: BMStef
Seat 1: Ysiven (small blind) folded before Flop
Seat 2: S3MPR3IGUAL (big blind) folded before Flop
Seat 4: Oli3579 folded before Flop (didn't bet)
Seat 5: KuningasRane collected ($2.50)
Seat 6: sta$igk (button) folded before Flop (didn't bet)



PokerStars Hand #254639789080:  Hold'em No Limit ($0.50/$1.00 USD) - 2025/01/31 18:20:33 WET [2025/01/31 13:20:33 ET]
Table 'Adria' 6-max Seat #1 is the button
Seat 1: Ysiven ($212.87 in chips) 
Seat 2: S3MPR3IGUAL ($110.51 in chips) 
Seat 3: BMStef ($32.54 in chips) 
Seat 4: Oli3579 ($192.83 in chips) 
Seat 5: KuningasRane ($227.46 in chips) 
Seat 6: sta$igk ($102.70 in chips) 
S3MPR3IGUAL: posts small blind $0.50
BMStef: posts big blind $1
*** HOLE CARDS ***
Oli3579: folds 
KuningasRane: folds 
sta$igk: folds 
Ysiven: raises $1.50 to $2.50
S3MPR3IGUAL: folds 
BMStef: folds 
Uncalled bet ($1.50) returned to Ysiven
Ysiven collected $2.50 from pot
Ysiven: doesn't show hand 
*** SUMMARY ***
Total pot $2.50 | Rake $0 
Seat 1: Ysiven (button) collected ($2.50)
Seat 2: S3MPR3IGUAL (small blind) folded before Flop
Seat 3: BMStef (big blind) folded before Flop
Seat 4: Oli3579 folded before Flop (didn't bet)
Seat 5: KuningasRane folded before Flop (didn't bet)
Seat 6: sta$igk folded before Flop (didn't bet)



PokerStars Hand #254639795955:  Hold'em No Limit ($0.50/$1.00 USD) - 2025/01/31 18:20:59 WET [2025/01/31 13:20:59 ET]
Table 'Adria' 6-max Seat #2 is the button
Seat 4: Oli3579 ($192.83 in chips) is sitting out
Seat 1: Ysiven ($214.37 in chips) 
Seat 2: S3MPR3IGUAL ($110.01 in chips) 
Seat 3: BMStef ($31.54 in chips) 
Seat 5: KuningasRane ($227.46 in chips) 
Seat 6: sta$igk ($102.70 in chips) 
BMStef: posts small blind $0.50
Oli3579: is sitting out 
KuningasRane: posts big blind $1
*** HOLE CARDS ***
sta$igk: folds 
Ysiven: folds 
S3MPR3IGUAL: folds 
BMStef: raises $2 to $3
KuningasRane: folds 
Uncalled bet ($2) returned to BMStef
BMStef collected $2 from pot
*** SUMMARY ***
Total pot $2 | Rake $0 
Seat 4: Oli3579
Seat 1: Ysiven folded before Flop (didn't bet)
Seat 2: S3MPR3IGUAL (button) folded before Flop (didn't bet)
Seat 3: BMStef (small blind) collected ($2)
Seat 5: KuningasRane (big blind) folded before Flop
Seat 6: sta$igk folded before Flop (didn't bet)



PokerStars Hand #254639800342:  Hold'em No Limit ($0.50/$1.00 USD) - 2025/01/31 18:21:16 WET [2025/01/31 13:21:16 ET]
Table 'Adria' 6-max Seat #3 is the button
Seat 4: Oli3579 ($192.83 in chips) is sitting out
Seat 6: sta$igk ($102.70 in chips) is sitting out
Seat 1: Ysiven ($214.37 in chips) 
Seat 2: S3MPR3IGUAL ($110.01 in chips) 
Seat 3: BMStef ($32.54 in chips) 
Seat 5: KuningasRane ($226.46 in chips) 
KuningasRane: posts small blind $0.50
sta$igk: is sitting out 
Ysiven: posts big blind $1
*** HOLE CARDS ***
S3MPR3IGUAL: raises $1.20 to $2.20
BMStef: folds 
KuningasRane: raises $6.40 to $8.60
Ysiven: folds 
sta$igk leaves the table
S3MPR3IGUAL: calls $6.40
*** FLOP *** [9d Kh 6d]
J0SHB0SH joins the table at seat #6 
Oli3579 leaves the table
KuningasRane: checks 
S3MPR3IGUAL: bets $4.33
KuningasRane: calls $4.33
*** TURN *** [9d Kh 6d] [8c]
KuningasRane: checks 
S3MPR3IGUAL: checks 
*** RIVER *** [9d Kh 6d 8c] [6c]
KuningasRane: bets $11.34
S3MPR3IGUAL: calls $11.34
*** SHOW DOWN ***
KuningasRane: shows [Tc Ad] (a pair of Sixes)
S3MPR3IGUAL: shows [Kd Td] (two pair, Kings and Sixes)
S3MPR3IGUAL collected $48.54 from pot
*** SUMMARY ***
Total pot $49.54 | Rake $1 
Board [9d Kh 6d 8c 6c]
Seat 4: Oli3579
Seat 6: sta$igk
Seat 1: Ysiven (big blind) folded before Flop
Seat 2: S3MPR3IGUAL showed [Kd Td] and won ($48.54) with two pair, Kings and Sixes
Seat 3: BMStef (button) folded before Flop (didn't bet)
Seat 5: KuningasRane (small blind) showed [Tc Ad] and lost with a pair of Sixes



PokerStars Hand #254639812730:  Hold'em No Limit ($0.50/$1.00 USD) - 2025/01/31 18:22:03 WET [2025/01/31 13:22:03 ET]
Table 'Adria' 6-max Seat #5 is the button
Seat 6: J0SHB0SH ($100 in chips) is sitting out
Seat 1: Ysiven ($213.37 in chips) 
Seat 2: S3MPR3IGUAL ($134.28 in chips) 
Seat 3: BMStef ($32.54 in chips) 
Seat 5: KuningasRane ($202.19 in chips) 
Ysiven: posts small blind $0.50
S3MPR3IGUAL: posts big blind $1
*** HOLE CARDS ***
reiyser joins the table at seat #4 
BMStef: raises $2 to $3
KuningasRane: folds 
Ysiven: folds 
S3MPR3IGUAL: folds 
Uncalled bet ($2) returned to BMStef
BMStef collected $2.50 from pot
*** SUMMARY ***
Total pot $2.50 | Rake $0 
Seat 6: J0SHB0SH
Seat 1: Ysiven (small blind) folded before Flop
Seat 2: S3MPR3IGUAL (big blind) folded before Flop
Seat 3: BMStef collected ($2.50)
Seat 5: KuningasRane (button) folded before Flop (didn't bet)



PokerStars Hand #254639817239:  Hold'em No Limit ($0.50/$1.00 USD) - 2025/01/31 18:22:20 WET [2025/01/31 13:22:20 ET]
Table 'Adria' 6-max Seat #1 is the button
Seat 3: BMStef ($34.04 in chips) is sitting out
Seat 6: J0SHB0SH ($100 in chips) is sitting out
Seat 1: Ysiven ($212.87 in chips) 
Seat 2: S3MPR3IGUAL ($133.28 in chips) 
Seat 4: reiyser ($100 in chips) 
Seat 5: KuningasRane ($202.19 in chips) 
S3MPR3IGUAL: posts small blind $0.50
BMStef: is sitting out 
reiyser: posts big blind $1
J0SHB0SH: sits out 
*** HOLE CARDS ***
KuningasRane: folds 
Ysiven: folds 
BMStef leaves the table
S3MPR3IGUAL: folds 
Uncalled bet ($0.50) returned to reiyser
reiyser collected $1 from pot
reiyser: doesn't show hand 
*** SUMMARY ***
Total pot $1 | Rake $0 
Seat 3: BMStef
Seat 6: J0SHB0SH
Seat 1: Ysiven (button) folded before Flop (didn't bet)
Seat 2: S3MPR3IGUAL (small blind) folded before Flop
Seat 4: reiyser (big blind) collected ($1)
Seat 5: KuningasRane folded before Flop (didn't bet)



PokerStars Hand #254639819792:  Hold'em No Limit ($0.50/$1.00 USD) - 2025/01/31 18:22:30 WET [2025/01/31 13:22:30 ET]
Table 'Adria' 6-max Seat #2 is the button
Seat 6: J0SHB0SH ($100 in chips) is sitting out
Seat 1: Ysiven ($212.87 in chips) 
Seat 2: S3MPR3IGUAL ($132.78 in chips) 
Seat 4: reiyser ($100.50 in chips) 
Seat 5: KuningasRane ($202.19 in chips) 
reiyser: posts small blind $0.50
KuningasRane: posts big blind $1
ozstrike88 joins the table at seat #3 
J0SHB0SH: sits out 
*** HOLE CARDS ***
ozstrike88 is disconnected 
Ysiven: folds 
S3MPR3IGUAL: raises $1.20 to $2.20
reiyser: folds 
KuningasRane: folds 
Uncalled bet ($1.20) returned to S3MPR3IGUAL
S3MPR3IGUAL collected $2.50 from pot
S3MPR3IGUAL: doesn't show hand 
*** SUMMARY ***
Total pot $2.50 | Rake $0 
Seat 6: J0SHB0SH
Seat 1: Ysiven folded before Flop (didn't bet)
Seat 2: S3MPR3IGUAL (button) collected ($2.50)
Seat 4: reiyser (small blind) folded before Flop
Seat 5: KuningasRane (big blind) folded before Flop



PokerStars Hand #254639822483:  Hold'em No Limit ($0.50/$1.00 USD) - 2025/01/31 18:22:40 WET [2025/01/31 13:22:40 ET]
Table 'Adria' 6-max Seat #4 is the button
Seat 1: Ysiven ($212.87 in chips) 
Seat 2: S3MPR3IGUAL ($134.28 in chips) 
Seat 3: ozstrike88 ($100 in chips) 
Seat 4: reiyser ($100 in chips) 
Seat 5: KuningasRane ($201.19 in chips) 
Seat 6: J0SHB0SH ($100 in chips) 
KuningasRane: posts small blind $0.50
J0SHB0SH: posts big blind $1
ozstrike88: posts big blind $1
*** HOLE CARDS ***
Ysiven: folds 
S3MPR3IGUAL: folds 
ozstrike88: checks 
reiyser: folds 
KuningasRane: folds 
J0SHB0SH: checks 
*** FLOP *** [Kc 9h 3c]
J0SHB0SH: checks 
ozstrike88: checks 
*** TURN *** [Kc 9h 3c] [Kh]
J0SHB0SH: bets $1.57
ozstrike88: calls $1.57
*** RIVER *** [Kc 9h 3c Kh] [2c]
J0SHB0SH: bets $1.77
ozstrike88: raises $5.45 to $7.22
J0SHB0SH: calls $5.45
*** SHOW DOWN ***
ozstrike88: shows [Ks 2d] (a full house, Kings full of Deuces)
J0SHB0SH: mucks hand 
ozstrike88 collected $19.08 from pot
*** SUMMARY ***
Total pot $20.08 | Rake $1 
Board [Kc 9h 3c Kh 2c]
Seat 1: Ysiven folded before Flop (didn't bet)
Seat 2: S3MPR3IGUAL folded before Flop (didn't bet)
Seat 3: ozstrike88 showed [Ks 2d] and won ($19.08) with a full house, Kings full of Deuces
Seat 4: reiyser (button) folded before Flop (didn't bet)
Seat 5: KuningasRane (small blind) folded before Flop
Seat 6: J0SHB0SH (big blind) mucked



PokerStars Hand #254639841686:  Hold'em No Limit ($0.50/$1.00 USD) - 2025/01/31 18:23:53 WET [2025/01/31 13:23:53 ET]
Table 'Adria' 6-max Seat #5 is the button
Seat 1: Ysiven ($212.87 in chips) 
Seat 2: S3MPR3IGUAL ($134.28 in chips) 
Seat 3: ozstrike88 ($109.29 in chips) 
Seat 4: reiyser ($100 in chips) 
Seat 5: KuningasRane ($200.69 in chips) 
Seat 6: J0SHB0SH ($100 in chips) 
J0SHB0SH: posts small blind $0.50
Ysiven: posts big blind $1
*** HOLE CARDS ***
S3MPR3IGUAL: folds 
ozstrike88: raises $3 to $4
reiyser: folds 
KuningasRane: folds 
J0SHB0SH: folds 
Ysiven: folds 
Uncalled bet ($3) returned to ozstrike88
ozstrike88 collected $2.50 from pot
*** SUMMARY ***
Total pot $2.50 | Rake $0 
Seat 1: Ysiven (big blind) folded before Flop
Seat 2: S3MPR3IGUAL folded before Flop (didn't bet)
Seat 3: ozstrike88 collected ($2.50)
Seat 4: reiyser folded before Flop (didn't bet)
Seat 5: KuningasRane (button) folded before Flop (didn't bet)
Seat 6: J0SHB0SH (small blind) folded before Flop



PokerStars Hand #254639845016:  Hold'em No Limit ($0.50/$1.00 USD) - 2025/01/31 18:24:06 WET [2025/01/31 13:24:06 ET]
Table 'Adria' 6-max Seat #6 is the button
Seat 1: Ysiven ($211.87 in chips) 
Seat 2: S3MPR3IGUAL ($134.28 in chips) 
Seat 3: ozstrike88 ($110.79 in chips) 
Seat 4: reiyser ($100 in chips) 
Seat 5: KuningasRane ($200.69 in chips) 
Seat 6: J0SHB0SH ($100 in chips) 
Ysiven: posts small blind $0.50
S3MPR3IGUAL: posts big blind $1
*** HOLE CARDS ***
ozstrike88: folds 
reiyser: folds 
KuningasRane: folds 
J0SHB0SH: raises $1.50 to $2.50
Ysiven: raises $9.50 to $12
S3MPR3IGUAL: folds 
J0SHB0SH: folds 
Uncalled bet ($9.50) returned to Ysiven
Ysiven collected $6 from pot
Ysiven: doesn't show hand 
*** SUMMARY ***
Total pot $6 | Rake $0 
Seat 1: Ysiven (small blind) collected ($6)
Seat 2: S3MPR3IGUAL (big blind) folded before Flop
Seat 3: ozstrike88 folded before Flop (didn't bet)
Seat 4: reiyser folded before Flop (didn't bet)
Seat 5: KuningasRane folded before Flop (didn't bet)
Seat 6: J0SHB0SH (button) folded before Flop



PokerStars Hand #254639854523:  Hold'em No Limit ($0.50/$1.00 USD) - 2025/01/31 18:24:42 WET [2025/01/31 13:24:42 ET]
Table 'Adria' 6-max Seat #1 is the button
Seat 1: Ysiven ($215.37 in chips) 
Seat 2: S3MPR3IGUAL ($133.28 in chips) 
Seat 3: ozstrike88 ($110.79 in chips) 
Seat 4: reiyser ($100 in chips) 
Seat 5: KuningasRane ($200.69 in chips) 
Seat 6: J0SHB0SH ($100 in chips) 
S3MPR3IGUAL: posts small blind $0.50
ozstrike88: posts big blind $1
*** HOLE CARDS ***
reiyser: folds 
KuningasRane: raises $1.50 to $2.50
J0SHB0SH: raises $5 to $7.50
Ysiven: folds 
S3MPR3IGUAL: folds 
ozstrike88: folds 
KuningasRane: folds 
Uncalled bet ($5) returned to J0SHB0SH
J0SHB0SH collected $6.50 from pot
J0SHB0SH: doesn't show hand 
*** SUMMARY ***
Total pot $6.50 | Rake $0 
Seat 1: Ysiven (button) folded before Flop (didn't bet)
Seat 2: S3MPR3IGUAL (small blind) folded before Flop
Seat 3: ozstrike88 (big blind) folded before Flop
Seat 4: reiyser folded before Flop (didn't bet)
Seat 5: KuningasRane folded before Flop
Seat 6: J0SHB0SH collected ($6.50)



PokerStars Hand #254639859103:  Hold'em No Limit ($0.50/$1.00 USD) - 2025/01/31 18:25:00 WET [2025/01/31 13:25:00 ET]
Table 'Adria' 6-max Seat #2 is the button
Seat 1: Ysiven ($215.37 in chips) 
Seat 2: S3MPR3IGUAL ($132.78 in chips) 
Seat 3: ozstrike88 ($109.79 in chips) 
Seat 4: reiyser ($100 in chips) 
Seat 5: KuningasRane ($198.19 in chips) 
Seat 6: J0SHB0SH ($104 in chips) 
ozstrike88: posts small blind $0.50
reiyser: posts big blind $1
*** HOLE CARDS ***
KuningasRane: folds 
J0SHB0SH: folds 
Ysiven: folds 
S3MPR3IGUAL: raises $1.20 to $2.20
ozstrike88: folds 
reiyser: calls $1.20
*** FLOP *** [Js Ts Qd]
reiyser: checks 
S3MPR3IGUAL: checks 
*** TURN *** [Js Ts Qd] [As]
reiyser: checks 
S3MPR3IGUAL: checks 
*** RIVER *** [Js Ts Qd As] [Kd]
reiyser: bets $18.15
S3MPR3IGUAL: folds 
Uncalled bet ($18.15) returned to reiyser
reiyser collected $4.66 from pot
reiyser: doesn't show hand 
*** SUMMARY ***
Total pot $4.90 | Rake $0.24 
Board [Js Ts Qd As Kd]
Seat 1: Ysiven folded before Flop (didn't bet)
Seat 2: S3MPR3IGUAL (button) folded on the River
Seat 3: ozstrike88 (small blind) folded before Flop
Seat 4: reiyser (big blind) collected ($4.66)
Seat 5: KuningasRane folded before Flop (didn't bet)
Seat 6: J0SHB0SH folded before Flop (didn't bet)



PokerStars Hand #254639870282:  Hold'em No Limit ($0.50/$1.00 USD) - 2025/01/31 18:25:43 WET [2025/01/31 13:25:43 ET]
Table 'Adria' 6-max Seat #3 is the button
Seat 1: Ysiven ($215.37 in chips) 
Seat 2: S3MPR3IGUAL ($130.58 in chips) 
Seat 3: ozstrike88 ($109.29 in chips) 
Seat 4: reiyser ($102.46 in chips) 
Seat 5: KuningasRane ($198.19 in chips) 
Seat 6: J0SHB0SH ($104 in chips) 
reiyser: posts small blind $0.50
KuningasRane: posts big blind $1
*** HOLE CARDS ***
J0SHB0SH: folds 
Ysiven: folds 
S3MPR3IGUAL: folds 
ozstrike88: raises $2.50 to $3.50
reiyser: folds 
KuningasRane: folds 
Uncalled bet ($2.50) returned to ozstrike88
ozstrike88 collected $2.50 from pot
*** SUMMARY ***
Total pot $2.50 | Rake $0 
Seat 1: Ysiven folded before Flop (didn't bet)
Seat 2: S3MPR3IGUAL folded before Flop (didn't bet)
Seat 3: ozstrike88 (button) collected ($2.50)
Seat 4: reiyser (small blind) folded before Flop
Seat 5: KuningasRane (big blind) folded before Flop
Seat 6: J0SHB0SH folded before Flop (didn't bet)



PokerStars Hand #254639875171:  Hold'em No Limit ($0.50/$1.00 USD) - 2025/01/31 18:26:02 WET [2025/01/31 13:26:02 ET]
Table 'Adria' 6-max Seat #4 is the button
Seat 1: Ysiven ($215.37 in chips) 
Seat 2: S3MPR3IGUAL ($130.58 in chips) 
Seat 3: ozstrike88 ($110.79 in chips) 
Seat 4: reiyser ($101.96 in chips) 
Seat 5: KuningasRane ($197.19 in chips) 
Seat 6: J0SHB0SH ($104 in chips) 
KuningasRane: posts small blind $0.50
J0SHB0SH: posts big blind $1
*** HOLE CARDS ***
Ysiven: folds 
S3MPR3IGUAL: folds 
ozstrike88: raises $1 to $2
reiyser: folds 
KuningasRane: raises $6 to $8
J0SHB0SH: raises $13 to $21
ozstrike88: folds 
KuningasRane: folds 
Uncalled bet ($13) returned to J0SHB0SH
J0SHB0SH collected $18 from pot
J0SHB0SH: doesn't show hand 
*** SUMMARY ***
Total pot $18 | Rake $0 
Seat 1: Ysiven folded before Flop (didn't bet)
Seat 2: S3MPR3IGUAL folded before Flop (didn't bet)
Seat 3: ozstrike88 folded before Flop
Seat 4: reiyser (button) folded before Flop (didn't bet)
Seat 5: KuningasRane (small blind) folded before Flop
Seat 6: J0SHB0SH (big blind) collected ($18)



PokerStars Hand #254639887701:  Hold'em No Limit ($0.50/$1.00 USD) - 2025/01/31 18:26:49 WET [2025/01/31 13:26:49 ET]
Table 'Adria' 6-max Seat #5 is the button
Seat 1: Ysiven ($215.37 in chips) 
Seat 2: S3MPR3IGUAL ($130.58 in chips) 
Seat 3: ozstrike88 ($108.79 in chips) 
Seat 4: reiyser ($101.96 in chips) 
Seat 5: KuningasRane ($189.19 in chips) 
Seat 6: J0SHB0SH ($114 in chips) 
J0SHB0SH: posts small blind $0.50
Ysiven: posts big blind $1
*** HOLE CARDS ***
S3MPR3IGUAL: folds 
ozstrike88: folds 
reiyser: folds 
KuningasRane: folds 
J0SHB0SH: raises $2 to $3
Ysiven: calls $2
*** FLOP *** [Ad 3d Kh]
J0SHB0SH: bets $1.88
Ysiven: raises $9.46 to $11.34
J0SHB0SH: folds 
Uncalled bet ($9.46) returned to Ysiven
Ysiven collected $9.27 from pot
Ysiven: doesn't show hand 
*** SUMMARY ***
Total pot $9.76 | Rake $0.49 
Board [Ad 3d Kh]
Seat 1: Ysiven (big blind) collected ($9.27)
Seat 2: S3MPR3IGUAL folded before Flop (didn't bet)
Seat 3: ozstrike88 folded before Flop (didn't bet)
Seat 4: reiyser folded before Flop (didn't bet)
Seat 5: KuningasRane (button) folded before Flop (didn't bet)
Seat 6: J0SHB0SH (small blind) folded on the Flop



PokerStars Hand #254639899055:  Hold'em No Limit ($0.50/$1.00 USD) - 2025/01/31 18:27:32 WET [2025/01/31 13:27:32 ET]
Table 'Adria' 6-max Seat #6 is the button
Seat 1: Ysiven ($219.76 in chips) 
Seat 2: S3MPR3IGUAL ($130.58 in chips) 
Seat 3: ozstrike88 ($108.79 in chips) 
Seat 4: reiyser ($101.96 in chips) 
Seat 5: KuningasRane ($189.19 in chips) 
Seat 6: J0SHB0SH ($109.12 in chips) 
Ysiven: posts small blind $0.50
S3MPR3IGUAL: posts big blind $1
*** HOLE CARDS ***
ozstrike88: folds 
reiyser: folds 
KuningasRane: raises $1.50 to $2.50
J0SHB0SH: folds 
Ysiven: folds 
S3MPR3IGUAL: folds 
Uncalled bet ($1.50) returned to KuningasRane
KuningasRane collected $2.50 from pot
KuningasRane: doesn't show hand 
*** SUMMARY ***
Total pot $2.50 | Rake $0 
Seat 1: Ysiven (small blind) folded before Flop
Seat 2: S3MPR3IGUAL (big blind) folded before Flop
Seat 3: ozstrike88 folded before Flop (didn't bet)
Seat 4: reiyser folded before Flop (didn't bet)
Seat 5: KuningasRane collected ($2.50)
Seat 6: J0SHB0SH (button) folded before Flop (didn't bet)



PokerStars Hand #254639903224:  Hold'em No Limit ($0.50/$1.00 USD) - 2025/01/31 18:27:48 WET [2025/01/31 13:27:48 ET]
Table 'Adria' 6-max Seat #1 is the button
Seat 1: Ysiven ($219.26 in chips) 
Seat 2: S3MPR3IGUAL ($129.58 in chips) 
Seat 3: ozstrike88 ($108.79 in chips) 
Seat 4: reiyser ($101.96 in chips) 
Seat 5: KuningasRane ($190.69 in chips) 
Seat 6: J0SHB0SH ($109.12 in chips) 
S3MPR3IGUAL: posts small blind $0.50
ozstrike88: posts big blind $1
*** HOLE CARDS ***
reiyser: folds 
KuningasRane: folds 
J0SHB0SH: raises $1.50 to $2.50
Ysiven: folds 
S3MPR3IGUAL: folds 
ozstrike88: folds 
Uncalled bet ($1.50) returned to J0SHB0SH
J0SHB0SH collected $2.50 from pot
J0SHB0SH: doesn't show hand 
*** SUMMARY ***
Total pot $2.50 | Rake $0 
Seat 1: Ysiven (button) folded before Flop (didn't bet)
Seat 2: S3MPR3IGUAL (small blind) folded before Flop
Seat 3: ozstrike88 (big blind) folded before Flop
Seat 4: reiyser folded before Flop (didn't bet)
Seat 5: KuningasRane folded before Flop (didn't bet)
Seat 6: J0SHB0SH collected ($2.50)



PokerStars Hand #254639907588:  Hold'em No Limit ($0.50/$1.00 USD) - 2025/01/31 18:28:05 WET [2025/01/31 13:28:05 ET]
Table 'Adria' 6-max Seat #2 is the button
Seat 1: Ysiven ($219.26 in chips) 
Seat 2: S3MPR3IGUAL ($129.08 in chips) 
Seat 3: ozstrike88 ($107.79 in chips) 
Seat 4: reiyser ($101.96 in chips) 
Seat 5: KuningasRane ($190.69 in chips) 
Seat 6: J0SHB0SH ($110.62 in chips) 
ozstrike88: posts small blind $0.50
reiyser: posts big blind $1
*** HOLE CARDS ***
KuningasRane: raises $1.50 to $2.50
J0SHB0SH: folds 
Ysiven: folds 
S3MPR3IGUAL: folds 
ozstrike88: calls $2
reiyser: folds 
*** FLOP *** [5c 3c 7c]
ozstrike88: checks 
KuningasRane: bets $3.99
ozstrike88: folds 
Uncalled bet ($3.99) returned to KuningasRane
KuningasRane collected $5.70 from pot
KuningasRane: doesn't show hand 
*** SUMMARY ***
Total pot $6 | Rake $0.30 
Board [5c 3c 7c]
Seat 1: Ysiven folded before Flop (didn't bet)
Seat 2: S3MPR3IGUAL (button) folded before Flop (didn't bet)
Seat 3: ozstrike88 (small blind) folded on the Flop
Seat 4: reiyser (big blind) folded before Flop
Seat 5: KuningasRane collected ($5.70)
Seat 6: J0SHB0SH folded before Flop (didn't bet)



PokerStars Hand #254639915038:  Hold'em No Limit ($0.50/$1.00 USD) - 2025/01/31 18:28:33 WET [2025/01/31 13:28:33 ET]
Table 'Adria' 6-max Seat #3 is the button
Seat 1: Ysiven ($219.26 in chips) 
Seat 2: S3MPR3IGUAL ($129.08 in chips) 
Seat 3: ozstrike88 ($105.29 in chips) 
Seat 4: reiyser ($100.96 in chips) 
Seat 5: KuningasRane ($193.89 in chips) 
Seat 6: J0SHB0SH ($110.62 in chips) 
reiyser: posts small blind $0.50
KuningasRane: posts big blind $1
*** HOLE CARDS ***
J0SHB0SH: folds 
Ysiven: folds 
S3MPR3IGUAL: folds 
ozstrike88: folds 
reiyser: folds 
Uncalled bet ($0.50) returned to KuningasRane
KuningasRane collected $1 from pot
KuningasRane: doesn't show hand 
*** SUMMARY ***
Total pot $1 | Rake $0 
Seat 1: Ysiven folded before Flop (didn't bet)
Seat 2: S3MPR3IGUAL folded before Flop (didn't bet)
Seat 3: ozstrike88 (button) folded before Flop (didn't bet)
Seat 4: reiyser (small blind) folded before Flop
Seat 5: KuningasRane (big blind) collected ($1)
Seat 6: J0SHB0SH folded before Flop (didn't bet)



PokerStars Hand #254639918277:  Hold'em No Limit ($0.50/$1.00 USD) - 2025/01/31 18:28:46 WET [2025/01/31 13:28:46 ET]
Table 'Adria' 6-max Seat #4 is the button
Seat 1: Ysiven ($219.26 in chips) 
Seat 2: S3MPR3IGUAL ($129.08 in chips) 
Seat 3: ozstrike88 ($105.29 in chips) 
Seat 4: reiyser ($100.46 in chips) 
Seat 5: KuningasRane ($194.39 in chips) 
Seat 6: J0SHB0SH ($110.62 in chips) 
KuningasRane: posts small blind $0.50
J0SHB0SH: posts big blind $1
*** HOLE CARDS ***
Ysiven: folds 
S3MPR3IGUAL: raises $1.20 to $2.20
ozstrike88: calls $2.20
reiyser: folds 
KuningasRane: folds 
J0SHB0SH: folds 
*** FLOP *** [Ah 3d 5d]
S3MPR3IGUAL: checks 
ozstrike88: checks 
*** TURN *** [Ah 3d 5d] [Qd]
S3MPR3IGUAL: checks 
ozstrike88: checks 
*** RIVER *** [Ah 3d 5d Qd] [Ks]
S3MPR3IGUAL: checks 
ozstrike88: bets $3.80
S3MPR3IGUAL: folds 
Uncalled bet ($3.80) returned to ozstrike88
ozstrike88 collected $5.60 from pot
*** SUMMARY ***
Total pot $5.90 | Rake $0.30 
Board [Ah 3d 5d Qd Ks]
Seat 1: Ysiven folded before Flop (didn't bet)
Seat 2: S3MPR3IGUAL folded on the River
Seat 3: ozstrike88 collected ($5.60)
Seat 4: reiyser (button) folded before Flop (didn't bet)
Seat 5: KuningasRane (small blind) folded before Flop
Seat 6: J0SHB0SH (big blind) folded before Flop



PokerStars Hand #254639927562:  Hold'em No Limit ($0.50/$1.00 USD) - 2025/01/31 18:29:22 WET [2025/01/31 13:29:22 ET]
Table 'Adria' 6-max Seat #5 is the button
Seat 1: Ysiven ($219.26 in chips) 
Seat 2: S3MPR3IGUAL ($126.88 in chips) 
Seat 3: ozstrike88 ($108.69 in chips) 
Seat 4: reiyser ($100.46 in chips) 
Seat 5: KuningasRane ($193.89 in chips) 
Seat 6: J0SHB0SH ($109.62 in chips) 
J0SHB0SH: posts small blind $0.50
Ysiven: posts big blind $1
*** HOLE CARDS ***
S3MPR3IGUAL: folds 
ozstrike88: folds 
reiyser: raises $1.23 to $2.23
KuningasRane: folds 
J0SHB0SH: folds 
Ysiven: folds 
Uncalled bet ($1.23) returned to reiyser
reiyser collected $2.50 from pot
reiyser: doesn't show hand 
*** SUMMARY ***
Total pot $2.50 | Rake $0 
Seat 1: Ysiven (big blind) folded before Flop
Seat 2: S3MPR3IGUAL folded before Flop (didn't bet)
Seat 3: ozstrike88 folded before Flop (didn't bet)
Seat 4: reiyser collected ($2.50)
Seat 5: KuningasRane (button) folded before Flop (didn't bet)
Seat 6: J0SHB0SH (small blind) folded before Flop



PokerStars Hand #254639932116:  Hold'em No Limit ($0.50/$1.00 USD) - 2025/01/31 18:29:39 WET [2025/01/31 13:29:39 ET]
Table 'Adria' 6-max Seat #6 is the button
Seat 1: Ysiven ($218.26 in chips) 
Seat 2: S3MPR3IGUAL ($126.88 in chips) 
Seat 3: ozstrike88 ($108.69 in chips) 
Seat 4: reiyser ($101.96 in chips) 
Seat 5: KuningasRane ($193.89 in chips) 
Seat 6: J0SHB0SH ($109.12 in chips) 
Ysiven: posts small blind $0.50
S3MPR3IGUAL: posts big blind $1
*** HOLE CARDS ***
ozstrike88: folds 
reiyser: folds 
KuningasRane: folds 
J0SHB0SH: raises $1.50 to $2.50
Ysiven: folds 
S3MPR3IGUAL: folds 
Uncalled bet ($1.50) returned to J0SHB0SH
J0SHB0SH collected $2.50 from pot
J0SHB0SH: doesn't show hand 
*** SUMMARY ***
Total pot $2.50 | Rake $0 
Seat 1: Ysiven (small blind) folded before Flop
Seat 2: S3MPR3IGUAL (big blind) folded before Flop
Seat 3: ozstrike88 folded before Flop (didn't bet)
Seat 4: reiyser folded before Flop (didn't bet)
Seat 5: KuningasRane folded before Flop (didn't bet)
Seat 6: J0SHB0SH (button) collected ($2.50)



PokerStars Hand #254639934692:  Hold'em No Limit ($0.50/$1.00 USD) - 2025/01/31 18:29:49 WET [2025/01/31 13:29:49 ET]
Table 'Adria' 6-max Seat #1 is the button
Seat 1: Ysiven ($217.76 in chips) 
Seat 2: S3MPR3IGUAL ($125.88 in chips) 
Seat 3: ozstrike88 ($108.69 in chips) 
Seat 4: reiyser ($101.96 in chips) 
Seat 5: KuningasRane ($193.89 in chips) 
Seat 6: J0SHB0SH ($110.62 in chips) 
S3MPR3IGUAL: posts small blind $0.50
ozstrike88: posts big blind $1
*** HOLE CARDS ***
reiyser: folds 
KuningasRane: raises $1.50 to $2.50
J0SHB0SH: folds 
Ysiven: folds 
S3MPR3IGUAL: folds 
ozstrike88: folds 
Uncalled bet ($1.50) returned to KuningasRane
KuningasRane collected $2.50 from pot
KuningasRane: doesn't show hand 
*** SUMMARY ***
Total pot $2.50 | Rake $0 
Seat 1: Ysiven (button) folded before Flop (didn't bet)
Seat 2: S3MPR3IGUAL (small blind) folded before Flop
Seat 3: ozstrike88 (big blind) folded before Flop
Seat 4: reiyser folded before Flop (didn't bet)
Seat 5: KuningasRane collected ($2.50)
Seat 6: J0SHB0SH folded before Flop (didn't bet)



PokerStars Hand #254639938555:  Hold'em No Limit ($0.50/$1.00 USD) - 2025/01/31 18:30:03 WET [2025/01/31 13:30:03 ET]
Table 'Adria' 6-max Seat #2 is the button
Seat 1: Ysiven ($217.76 in chips) 
Seat 2: S3MPR3IGUAL ($125.38 in chips) 
Seat 3: ozstrike88 ($107.69 in chips) 
Seat 4: reiyser ($101.96 in chips) 
Seat 5: KuningasRane ($195.39 in chips) 
Seat 6: J0SHB0SH ($110.62 in chips) 
ozstrike88: posts small blind $0.50
reiyser: posts big blind $1
*** HOLE CARDS ***
KuningasRane: folds 
J0SHB0SH: raises $1 to $2
Ysiven: folds 
S3MPR3IGUAL: folds 
ozstrike88: folds 
reiyser: folds 
Uncalled bet ($1) returned to J0SHB0SH
J0SHB0SH collected $2.50 from pot
J0SHB0SH: doesn't show hand 
*** SUMMARY ***
Total pot $2.50 | Rake $0 
Seat 1: Ysiven folded before Flop (didn't bet)
Seat 2: S3MPR3IGUAL (button) folded before Flop (didn't bet)
Seat 3: ozstrike88 (small blind) folded before Flop
Seat 4: reiyser (big blind) folded before Flop
Seat 5: KuningasRane folded before Flop (didn't bet)
Seat 6: J0SHB0SH collected ($2.50)



PokerStars Hand #254639942446:  Hold'em No Limit ($0.50/$1.00 USD) - 2025/01/31 18:30:18 WET [2025/01/31 13:30:18 ET]
Table 'Adria' 6-max Seat #3 is the button
Seat 1: Ysiven ($217.76 in chips) 
Seat 2: S3MPR3IGUAL ($125.38 in chips) 
Seat 3: ozstrike88 ($107.19 in chips) 
Seat 4: reiyser ($100.96 in chips) 
Seat 5: KuningasRane ($195.39 in chips) 
Seat 6: J0SHB0SH ($112.12 in chips) 
reiyser: posts small blind $0.50
KuningasRane: posts big blind $1
*** HOLE CARDS ***
J0SHB0SH: folds 
Ysiven: folds 
S3MPR3IGUAL: folds 
ozstrike88: folds 
reiyser: folds 
Uncalled bet ($0.50) returned to KuningasRane
KuningasRane collected $1 from pot
KuningasRane: doesn't show hand 
*** SUMMARY ***
Total pot $1 | Rake $0 
Seat 1: Ysiven folded before Flop (didn't bet)
Seat 2: S3MPR3IGUAL folded before Flop (didn't bet)
Seat 3: ozstrike88 (button) folded before Flop (didn't bet)
Seat 4: reiyser (small blind) folded before Flop
Seat 5: KuningasRane (big blind) collected ($1)
Seat 6: J0SHB0SH folded before Flop (didn't bet)



PokerStars Hand #254639946371:  Hold'em No Limit ($0.50/$1.00 USD) - 2025/01/31 18:30:33 WET [2025/01/31 13:30:33 ET]
Table 'Adria' 6-max Seat #4 is the button
Seat 1: Ysiven ($217.76 in chips) 
Seat 2: S3MPR3IGUAL ($125.38 in chips) 
Seat 3: ozstrike88 ($107.19 in chips) 
Seat 4: reiyser ($100.46 in chips) 
Seat 5: KuningasRane ($195.89 in chips) 
Seat 6: J0SHB0SH ($112.12 in chips) 
KuningasRane: posts small blind $0.50
J0SHB0SH: posts big blind $1
*** HOLE CARDS ***
Ysiven: folds 
S3MPR3IGUAL: raises $1.20 to $2.20
ozstrike88: calls $2.20
reiyser: calls $2.20
KuningasRane: folds 
J0SHB0SH: folds 
*** FLOP *** [6d 7h 7c]
S3MPR3IGUAL: checks 
ozstrike88: checks 
reiyser: checks 
*** TURN *** [6d 7h 7c] [Jh]
S3MPR3IGUAL: bets $5.08
ozstrike88: calls $5.08
reiyser: folds 
*** RIVER *** [6d 7h 7c Jh] [3s]
S3MPR3IGUAL: checks 
ozstrike88: checks 
*** SHOW DOWN ***
S3MPR3IGUAL: shows [8c 9c] (a pair of Sevens)
ozstrike88: shows [Kh 8h] (a pair of Sevens - King kicker)
ozstrike88 collected $17.35 from pot
*** SUMMARY ***
Total pot $18.26 | Rake $0.91 
Board [6d 7h 7c Jh 3s]
Seat 1: Ysiven folded before Flop (didn't bet)
Seat 2: S3MPR3IGUAL showed [8c 9c] and lost with a pair of Sevens
Seat 3: ozstrike88 showed [Kh 8h] and won ($17.35) with a pair of Sevens
Seat 4: reiyser (button) folded on the Turn
Seat 5: KuningasRane (small blind) folded before Flop
Seat 6: J0SHB0SH (big blind) folded before Flop



PokerStars Hand #254639967234:  Hold'em No Limit ($0.50/$1.00 USD) - 2025/01/31 18:31:51 WET [2025/01/31 13:31:51 ET]
Table 'Adria' 6-max Seat #5 is the button
Seat 1: Ysiven ($217.76 in chips) 
Seat 2: S3MPR3IGUAL ($118.10 in chips) 
Seat 3: ozstrike88 ($117.26 in chips) 
Seat 4: reiyser ($100 in chips) 
Seat 5: KuningasRane ($195.39 in chips) 
Seat 6: J0SHB0SH ($111.12 in chips) 
J0SHB0SH: posts small blind $0.50
Ysiven: posts big blind $1
*** HOLE CARDS ***
S3MPR3IGUAL: folds 
ozstrike88: raises $2 to $3
reiyser: folds 
KuningasRane: raises $7.50 to $10.50
J0SHB0SH: folds 
Ysiven: folds 
ozstrike88: folds 
Uncalled bet ($7.50) returned to KuningasRane
KuningasRane collected $7.50 from pot
KuningasRane: doesn't show hand 
*** SUMMARY ***
Total pot $7.50 | Rake $0 
Seat 1: Ysiven (big blind) folded before Flop
Seat 2: S3MPR3IGUAL folded before Flop (didn't bet)
Seat 3: ozstrike88 folded before Flop
Seat 4: reiyser folded before Flop (didn't bet)
Seat 5: KuningasRane (button) collected ($7.50)
Seat 6: J0SHB0SH (small blind) folded before Flop



PokerStars Hand #254639974166:  Hold'em No Limit ($0.50/$1.00 USD) - 2025/01/31 18:32:17 WET [2025/01/31 13:32:17 ET]
Table 'Adria' 6-max Seat #6 is the button
Seat 1: Ysiven ($216.76 in chips) 
Seat 2: S3MPR3IGUAL ($118.10 in chips) 
Seat 3: ozstrike88 ($114.26 in chips) 
Seat 4: reiyser ($100 in chips) 
Seat 5: KuningasRane ($199.89 in chips) 
Seat 6: J0SHB0SH ($110.62 in chips) 
Ysiven: posts small blind $0.50
S3MPR3IGUAL: posts big blind $1
*** HOLE CARDS ***
ozstrike88: folds 
reiyser: folds 
KuningasRane: folds 
J0SHB0SH: raises $1.50 to $2.50
Ysiven: folds 
S3MPR3IGUAL: folds 
Uncalled bet ($1.50) returned to J0SHB0SH
J0SHB0SH collected $2.50 from pot
J0SHB0SH: doesn't show hand 
*** SUMMARY ***
Total pot $2.50 | Rake $0 
Seat 1: Ysiven (small blind) folded before Flop
Seat 2: S3MPR3IGUAL (big blind) folded before Flop
Seat 3: ozstrike88 folded before Flop (didn't bet)
Seat 4: reiyser folded before Flop (didn't bet)
Seat 5: KuningasRane folded before Flop (didn't bet)
Seat 6: J0SHB0SH (button) collected ($2.50)



PokerStars Hand #254639979991:  Hold'em No Limit ($0.50/$1.00 USD) - 2025/01/31 18:32:39 WET [2025/01/31 13:32:39 ET]
Table 'Adria' 6-max Seat #1 is the button
Seat 1: Ysiven ($216.26 in chips) 
Seat 2: S3MPR3IGUAL ($117.10 in chips) 
Seat 3: ozstrike88 ($114.26 in chips) 
Seat 4: reiyser ($100 in chips) 
Seat 5: KuningasRane ($199.89 in chips) 
Seat 6: J0SHB0SH ($112.12 in chips) 
S3MPR3IGUAL: posts small blind $0.50
ozstrike88: posts big blind $1
*** HOLE CARDS ***
reiyser: folds 
KuningasRane: raises $1.50 to $2.50
J0SHB0SH: folds 
Ysiven: folds 
S3MPR3IGUAL: folds 
ozstrike88: folds 
Uncalled bet ($1.50) returned to KuningasRane
KuningasRane collected $2.50 from pot
KuningasRane: doesn't show hand 
*** SUMMARY ***
Total pot $2.50 | Rake $0 
Seat 1: Ysiven (button) folded before Flop (didn't bet)
Seat 2: S3MPR3IGUAL (small blind) folded before Flop
Seat 3: ozstrike88 (big blind) folded before Flop
Seat 4: reiyser folded before Flop (didn't bet)
Seat 5: KuningasRane collected ($2.50)
Seat 6: J0SHB0SH folded before Flop (didn't bet)



PokerStars Hand #254639984787:  Hold'em No Limit ($0.50/$1.00 USD) - 2025/01/31 18:32:57 WET [2025/01/31 13:32:57 ET]
Table 'Adria' 6-max Seat #2 is the button
Seat 1: Ysiven ($216.26 in chips) 
Seat 2: S3MPR3IGUAL ($116.60 in chips) 
Seat 3: ozstrike88 ($113.26 in chips) 
Seat 4: reiyser ($100 in chips) 
Seat 5: KuningasRane ($201.39 in chips) 
Seat 6: J0SHB0SH ($112.12 in chips) 
ozstrike88: posts small blind $0.50
reiyser: posts big blind $1
*** HOLE CARDS ***
KuningasRane: folds 
J0SHB0SH: raises $1.50 to $2.50
Ysiven: raises $5 to $7.50
S3MPR3IGUAL: folds 
ozstrike88: folds 
reiyser: folds 
J0SHB0SH: calls $5
*** FLOP *** [Tc 7d 6c]
J0SHB0SH: checks 
Ysiven: checks 
*** TURN *** [Tc 7d 6c] [Jd]
J0SHB0SH: checks 
Ysiven: bets $15.68
J0SHB0SH: calls $15.68
*** RIVER *** [Tc 7d 6c Jd] [9c]
J0SHB0SH: checks 
Ysiven: checks 
*** SHOW DOWN ***
J0SHB0SH: shows [As Ts] (a pair of Tens)
Ysiven: shows [Ad Td] (a pair of Tens)
J0SHB0SH collected $22.74 from pot
Ysiven collected $22.73 from pot
*** SUMMARY ***
Total pot $47.86 | Rake $2.39 
Board [Tc 7d 6c Jd 9c]
Seat 1: Ysiven showed [Ad Td] and won ($22.73) with a pair of Tens
Seat 2: S3MPR3IGUAL (button) folded before Flop (didn't bet)
Seat 3: ozstrike88 (small blind) folded before Flop
Seat 4: reiyser (big blind) folded before Flop
Seat 5: KuningasRane folded before Flop (didn't bet)
Seat 6: J0SHB0SH showed [As Ts] and won ($22.74) with a pair of Tens



PokerStars Hand #254640009460:  Hold'em No Limit ($0.50/$1.00 USD) - 2025/01/31 18:34:29 WET [2025/01/31 13:34:29 ET]
Table 'Adria' 6-max Seat #3 is the button
Seat 1: Ysiven ($215.81 in chips) 
Seat 2: S3MPR3IGUAL ($116.60 in chips) 
Seat 3: ozstrike88 ($112.76 in chips) 
Seat 4: reiyser ($100 in chips) 
Seat 5: KuningasRane ($201.39 in chips) 
Seat 6: J0SHB0SH ($111.68 in chips) 
reiyser: posts small blind $0.50
KuningasRane: posts big blind $1
*** HOLE CARDS ***
J0SHB0SH: raises $1 to $2
Ysiven: folds 
S3MPR3IGUAL: folds 
ozstrike88: folds 
reiyser: folds 
KuningasRane: calls $1
*** FLOP *** [3s 4c 8h]
KuningasRane: checks 
J0SHB0SH: checks 
*** TURN *** [3s 4c 8h] [Jh]
KuningasRane: bets $1.71
J0SHB0SH: raises $8.29 to $10
KuningasRane: folds 
Uncalled bet ($8.29) returned to J0SHB0SH
J0SHB0SH collected $7.52 from pot
J0SHB0SH: doesn't show hand 
*** SUMMARY ***
Total pot $7.92 | Rake $0.40 
Board [3s 4c 8h Jh]
Seat 1: Ysiven folded before Flop (didn't bet)
Seat 2: S3MPR3IGUAL folded before Flop (didn't bet)
Seat 3: ozstrike88 (button) folded before Flop (didn't bet)
Seat 4: reiyser (small blind) folded before Flop
Seat 5: KuningasRane (big blind) folded on the Turn
Seat 6: J0SHB0SH collected ($7.52)



PokerStars Hand #254640020340:  Hold'em No Limit ($0.50/$1.00 USD) - 2025/01/31 18:35:09 WET [2025/01/31 13:35:09 ET]
Table 'Adria' 6-max Seat #4 is the button
Seat 1: Ysiven ($215.81 in chips) 
Seat 2: S3MPR3IGUAL ($116.60 in chips) 
Seat 3: ozstrike88 ($112.76 in chips) 
Seat 4: reiyser ($100 in chips) 
Seat 5: KuningasRane ($197.68 in chips) 
Seat 6: J0SHB0SH ($115.49 in chips) 
KuningasRane: posts small blind $0.50
J0SHB0SH: posts big blind $1
*** HOLE CARDS ***
Ysiven: folds 
S3MPR3IGUAL: folds 
ozstrike88: folds 
reiyser: folds 
KuningasRane: folds 
Uncalled bet ($0.50) returned to J0SHB0SH
J0SHB0SH collected $1 from pot
J0SHB0SH: doesn't show hand 
*** SUMMARY ***
Total pot $1 | Rake $0 
Seat 1: Ysiven folded before Flop (didn't bet)
Seat 2: S3MPR3IGUAL folded before Flop (didn't bet)
Seat 3: ozstrike88 folded before Flop (didn't bet)
Seat 4: reiyser (button) folded before Flop (didn't bet)
Seat 5: KuningasRane (small blind) folded before Flop
Seat 6: J0SHB0SH (big blind) collected ($1)



PokerStars Hand #254640023738:  Hold'em No Limit ($0.50/$1.00 USD) - 2025/01/31 18:35:21 WET [2025/01/31 13:35:21 ET]
Table 'Adria' 6-max Seat #5 is the button
Seat 1: Ysiven ($215.81 in chips) 
Seat 2: S3MPR3IGUAL ($116.60 in chips) 
Seat 3: ozstrike88 ($112.76 in chips) 
Seat 4: reiyser ($100 in chips) 
Seat 5: KuningasRane ($197.18 in chips) 
Seat 6: J0SHB0SH ($115.99 in chips) 
J0SHB0SH: posts small blind $0.50
Ysiven: posts big blind $1
*** HOLE CARDS ***
S3MPR3IGUAL: folds 
ozstrike88: raises $2 to $3
reiyser: folds 
KuningasRane: folds 
J0SHB0SH: folds 
Ysiven: folds 
Uncalled bet ($2) returned to ozstrike88
ozstrike88 collected $2.50 from pot
*** SUMMARY ***
Total pot $2.50 | Rake $0 
Seat 1: Ysiven (big blind) folded before Flop
Seat 2: S3MPR3IGUAL folded before Flop (didn't bet)
Seat 3: ozstrike88 collected ($2.50)
Seat 4: reiyser folded before Flop (didn't bet)
Seat 5: KuningasRane (button) folded before Flop (didn't bet)
Seat 6: J0SHB0SH (small blind) folded before Flop



PokerStars Hand #254640032712:  Hold'em No Limit ($0.50/$1.00 USD) - 2025/01/31 18:35:54 WET [2025/01/31 13:35:54 ET]
Table 'Adria' 6-max Seat #6 is the button
Seat 1: Ysiven ($214.81 in chips) 
Seat 2: S3MPR3IGUAL ($116.60 in chips) 
Seat 3: ozstrike88 ($114.26 in chips) 
Seat 4: reiyser ($100 in chips) 
Seat 5: KuningasRane ($197.18 in chips) 
Seat 6: J0SHB0SH ($115.49 in chips) 
Ysiven: posts small blind $0.50
S3MPR3IGUAL: posts big blind $1
*** HOLE CARDS ***
ozstrike88: folds 
reiyser: folds 
KuningasRane: raises $1.50 to $2.50
J0SHB0SH: folds 
Ysiven: folds 
S3MPR3IGUAL: calls $1.50
*** FLOP *** [4s 2s 8c]
S3MPR3IGUAL: checks 
KuningasRane: bets $2.09
S3MPR3IGUAL: raises $5.91 to $8
KuningasRane: folds 
Uncalled bet ($5.91) returned to S3MPR3IGUAL
S3MPR3IGUAL collected $9.20 from pot
S3MPR3IGUAL: doesn't show hand 
*** SUMMARY ***
Total pot $9.68 | Rake $0.48 
Board [4s 2s 8c]
Seat 1: Ysiven (small blind) folded before Flop
Seat 2: S3MPR3IGUAL (big blind) collected ($9.20)
Seat 3: ozstrike88 folded before Flop (didn't bet)
Seat 4: reiyser folded before Flop (didn't bet)
Seat 5: KuningasRane folded on the Flop
Seat 6: J0SHB0SH (button) folded before Flop (didn't bet)



PokerStars Hand #254640042221:  Hold'em No Limit ($0.50/$1.00 USD) - 2025/01/31 18:36:29 WET [2025/01/31 13:36:29 ET]
Table 'Adria' 6-max Seat #1 is the button
Seat 1: Ysiven ($214.31 in chips) 
Seat 2: S3MPR3IGUAL ($121.21 in chips) 
Seat 3: ozstrike88 ($114.26 in chips) 
Seat 4: reiyser ($100 in chips) 
Seat 5: KuningasRane ($192.59 in chips) 
Seat 6: J0SHB0SH ($115.49 in chips) 
S3MPR3IGUAL: posts small blind $0.50
ozstrike88: posts big blind $1
*** HOLE CARDS ***
reiyser: folds 
KuningasRane: folds 
J0SHB0SH: folds 
Ysiven: folds 
S3MPR3IGUAL: raises $2 to $3
ozstrike88: folds 
Uncalled bet ($2) returned to S3MPR3IGUAL
S3MPR3IGUAL collected $2 from pot
S3MPR3IGUAL: doesn't show hand 
*** SUMMARY ***
Total pot $2 | Rake $0 
Seat 1: Ysiven (button) folded before Flop (didn't bet)
Seat 2: S3MPR3IGUAL (small blind) collected ($2)
Seat 3: ozstrike88 (big blind) folded before Flop
Seat 4: reiyser folded before Flop (didn't bet)
Seat 5: KuningasRane folded before Flop (didn't bet)
Seat 6: J0SHB0SH folded before Flop (didn't bet)



PokerStars Hand #254640046754:  Hold'em No Limit ($0.50/$1.00 USD) - 2025/01/31 18:36:46 WET [2025/01/31 13:36:46 ET]
Table 'Adria' 6-max Seat #2 is the button
Seat 1: Ysiven ($214.31 in chips) 
Seat 2: S3MPR3IGUAL ($122.21 in chips) 
Seat 3: ozstrike88 ($113.26 in chips) 
Seat 4: reiyser ($100 in chips) 
Seat 5: KuningasRane ($192.59 in chips) 
Seat 6: J0SHB0SH ($115.49 in chips) 
ozstrike88: posts small blind $0.50
reiyser: posts big blind $1
*** HOLE CARDS ***
KuningasRane: folds 
J0SHB0SH: folds 
Ysiven: folds 
S3MPR3IGUAL: raises $1.20 to $2.20
ozstrike88: calls $1.70
reiyser: raises $11.30 to $13.50
S3MPR3IGUAL: calls $11.30
ozstrike88: folds 
*** FLOP *** [Ts Td Jd]
reiyser: bets $8.04
S3MPR3IGUAL: calls $8.04
*** TURN *** [Ts Td Jd] [3c]
reiyser: checks 
S3MPR3IGUAL: bets $24
reiyser: raises $54.46 to $78.46 and is all-in
S3MPR3IGUAL: folds 
Uncalled bet ($54.46) returned to reiyser
reiyser collected $90.78 from pot
reiyser: doesn't show hand 
*** SUMMARY ***
Total pot $93.28 | Rake $2.50 
Board [Ts Td Jd 3c]
Seat 1: Ysiven folded before Flop (didn't bet)
Seat 2: S3MPR3IGUAL (button) folded on the Turn
Seat 3: ozstrike88 (small blind) folded before Flop
Seat 4: reiyser (big blind) collected ($90.78)
Seat 5: KuningasRane folded before Flop (didn't bet)
Seat 6: J0SHB0SH folded before Flop (didn't bet)



PokerStars Hand #254640064497:  Hold'em No Limit ($0.50/$1.00 USD) - 2025/01/31 18:37:53 WET [2025/01/31 13:37:53 ET]
Table 'Adria' 6-max Seat #3 is the button
Seat 1: Ysiven ($214.31 in chips) 
Seat 2: S3MPR3IGUAL ($100 in chips) 
Seat 3: ozstrike88 ($111.06 in chips) 
Seat 4: reiyser ($145.24 in chips) 
Seat 5: KuningasRane ($192.59 in chips) 
Seat 6: J0SHB0SH ($115.49 in chips) 
reiyser: posts small blind $0.50
KuningasRane: posts big blind $1
*** HOLE CARDS ***
J0SHB0SH: folds 
Ysiven: folds 
S3MPR3IGUAL: folds 
ozstrike88: raises $1 to $2
reiyser: folds 
KuningasRane: folds 
Uncalled bet ($1) returned to ozstrike88
ozstrike88 collected $2.50 from pot
*** SUMMARY ***
Total pot $2.50 | Rake $0 
Seat 1: Ysiven folded before Flop (didn't bet)
Seat 2: S3MPR3IGUAL folded before Flop (didn't bet)
Seat 3: ozstrike88 (button) collected ($2.50)
Seat 4: reiyser (small blind) folded before Flop
Seat 5: KuningasRane (big blind) folded before Flop
Seat 6: J0SHB0SH folded before Flop (didn't bet)



PokerStars Hand #254640068354:  Hold'em No Limit ($0.50/$1.00 USD) - 2025/01/31 18:38:07 WET [2025/01/31 13:38:07 ET]
Table 'Adria' 6-max Seat #4 is the button
Seat 1: Ysiven ($214.31 in chips) 
Seat 2: S3MPR3IGUAL ($100 in chips) 
Seat 3: ozstrike88 ($112.56 in chips) 
Seat 4: reiyser ($144.74 in chips) 
Seat 5: KuningasRane ($191.59 in chips) 
Seat 6: J0SHB0SH ($115.49 in chips) 
KuningasRane: posts small blind $0.50
J0SHB0SH: posts big blind $1
*** HOLE CARDS ***
Ysiven: raises $1 to $2
S3MPR3IGUAL: raises $5 to $7
ozstrike88: folds 
reiyser: folds 
KuningasRane: folds 
J0SHB0SH: raises $12 to $19
Ysiven: folds 
S3MPR3IGUAL: calls $12
*** FLOP *** [6h 8c 9h]
J0SHB0SH: bets $12.70
S3MPR3IGUAL: raises $68.30 to $81 and is all-in
J0SHB0SH: calls $68.30
*** TURN *** [6h 8c 9h] [3d]
*** RIVER *** [6h 8c 9h 3d] [4c]
*** SHOW DOWN ***
J0SHB0SH: shows [Kd Kh] (a pair of Kings)
S3MPR3IGUAL: shows [Qh Qd] (a pair of Queens)
J0SHB0SH collected $200 from pot
*** SUMMARY ***
Total pot $202.50 | Rake $2.50 
Board [6h 8c 9h 3d 4c]
Seat 1: Ysiven folded before Flop
Seat 2: S3MPR3IGUAL showed [Qh Qd] and lost with a pair of Queens
Seat 3: ozstrike88 folded before Flop (didn't bet)
Seat 4: reiyser (button) folded before Flop (didn't bet)
Seat 5: KuningasRane (small blind) folded before Flop
Seat 6: J0SHB0SH (big blind) showed [Kd Kh] and won ($200) with a pair of Kings



PokerStars Hand #254640083564:  Hold'em No Limit ($0.50/$1.00 USD) - 2025/01/31 18:39:04 WET [2025/01/31 13:39:04 ET]
Table 'Adria' 6-max Seat #5 is the button
Seat 1: Ysiven ($212.31 in chips) 
Seat 2: S3MPR3IGUAL ($100 in chips) 
Seat 3: ozstrike88 ($112.56 in chips) 
Seat 4: reiyser ($144.74 in chips) 
Seat 5: KuningasRane ($191.09 in chips) 
Seat 6: J0SHB0SH ($215.49 in chips) 
J0SHB0SH: posts small blind $0.50
Ysiven: posts big blind $1
*** HOLE CARDS ***
S3MPR3IGUAL: raises $1.20 to $2.20
ozstrike88: folds 
reiyser: folds 
KuningasRane: raises $5.90 to $8.10
J0SHB0SH: folds 
Ysiven: raises $18.40 to $26.50
S3MPR3IGUAL: folds 
KuningasRane: folds 
Uncalled bet ($18.40) returned to Ysiven
Ysiven collected $18.90 from pot
Ysiven: doesn't show hand 
*** SUMMARY ***
Total pot $18.90 | Rake $0 
Seat 1: Ysiven (big blind) collected ($18.90)
Seat 2: S3MPR3IGUAL folded before Flop
Seat 3: ozstrike88 folded before Flop (didn't bet)
Seat 4: reiyser folded before Flop (didn't bet)
Seat 5: KuningasRane (button) folded before Flop
Seat 6: J0SHB0SH (small blind) folded before Flop



PokerStars Hand #254640095293:  Hold'em No Limit ($0.50/$1.00 USD) - 2025/01/31 18:39:48 WET [2025/01/31 13:39:48 ET]
Table 'Adria' 6-max Seat #6 is the button
Seat 1: Ysiven ($223.11 in chips) 
Seat 2: S3MPR3IGUAL ($100 in chips) 
Seat 3: ozstrike88 ($112.56 in chips) 
Seat 4: reiyser ($144.74 in chips) 
Seat 5: KuningasRane ($182.99 in chips) 
Seat 6: J0SHB0SH ($214.99 in chips) 
Ysiven: posts small blind $0.50
S3MPR3IGUAL: posts big blind $1
*** HOLE CARDS ***
ozstrike88: folds 
reiyser: raises $1.23 to $2.23
KuningasRane: calls $2.23
J0SHB0SH: folds 
Ysiven: folds 
S3MPR3IGUAL: folds 
*** FLOP *** [6h 2s 7s]
reiyser: checks 
KuningasRane: bets $2.26
reiyser: raises $5.29 to $7.55
KuningasRane: calls $5.29
*** TURN *** [6h 2s 7s] [Ac]
reiyser: checks 
KuningasRane: bets $15.01
reiyser: folds 
Uncalled bet ($15.01) returned to KuningasRane
KuningasRane collected $20.01 from pot
KuningasRane: doesn't show hand 
*** SUMMARY ***
Total pot $21.06 | Rake $1.05 
Board [6h 2s 7s Ac]
Seat 1: Ysiven (small blind) folded before Flop
Seat 2: S3MPR3IGUAL (big blind) folded before Flop
Seat 3: ozstrike88 folded before Flop (didn't bet)
Seat 4: reiyser folded on the Turn
Seat 5: KuningasRane collected ($20.01)
Seat 6: J0SHB0SH (button) folded before Flop (didn't bet)



PokerStars Hand #254640115266:  Hold'em No Limit ($0.50/$1.00 USD) - 2025/01/31 18:41:03 WET [2025/01/31 13:41:03 ET]
Table 'Adria' 6-max Seat #1 is the button
Seat 1: Ysiven ($222.61 in chips) 
Seat 2: S3MPR3IGUAL ($100 in chips) 
Seat 3: ozstrike88 ($112.56 in chips) 
Seat 4: reiyser ($134.96 in chips) 
Seat 5: KuningasRane ($193.22 in chips) 
Seat 6: J0SHB0SH ($214.99 in chips) 
S3MPR3IGUAL: posts small blind $0.50
ozstrike88: posts big blind $1
*** HOLE CARDS ***
reiyser: folds 
KuningasRane: folds 
J0SHB0SH: folds 
Ysiven: folds 
S3MPR3IGUAL: folds 
Uncalled bet ($0.50) returned to ozstrike88
ozstrike88 collected $1 from pot
*** SUMMARY ***
Total pot $1 | Rake $0 
Seat 1: Ysiven (button) folded before Flop (didn't bet)
Seat 2: S3MPR3IGUAL (small blind) folded before Flop
Seat 3: ozstrike88 (big blind) collected ($1)
Seat 4: reiyser folded before Flop (didn't bet)
Seat 5: KuningasRane folded before Flop (didn't bet)
Seat 6: J0SHB0SH folded before Flop (didn't bet)



PokerStars Hand #254640118546:  Hold'em No Limit ($0.50/$1.00 USD) - 2025/01/31 18:41:15 WET [2025/01/31 13:41:15 ET]
Table 'Adria' 6-max Seat #2 is the button
Seat 1: Ysiven ($222.61 in chips) 
Seat 2: S3MPR3IGUAL ($100 in chips) 
Seat 3: ozstrike88 ($113.06 in chips) 
Seat 4: reiyser ($134.96 in chips) 
Seat 5: KuningasRane ($193.22 in chips) 
Seat 6: J0SHB0SH ($214.99 in chips) 
ozstrike88: posts small blind $0.50
reiyser: posts big blind $1
*** HOLE CARDS ***
KuningasRane: raises $1.50 to $2.50
J0SHB0SH: folds 
Ysiven: folds 
S3MPR3IGUAL: folds 
ozstrike88: folds 
reiyser: folds 
Uncalled bet ($1.50) returned to KuningasRane
KuningasRane collected $2.50 from pot
KuningasRane: doesn't show hand 
*** SUMMARY ***
Total pot $2.50 | Rake $0 
Seat 1: Ysiven folded before Flop (didn't bet)
Seat 2: S3MPR3IGUAL (button) folded before Flop (didn't bet)
Seat 3: ozstrike88 (small blind) folded before Flop
Seat 4: reiyser (big blind) folded before Flop
Seat 5: KuningasRane collected ($2.50)
Seat 6: J0SHB0SH folded before Flop (didn't bet)



PokerStars Hand #254640122343:  Hold'em No Limit ($0.50/$1.00 USD) - 2025/01/31 18:41:29 WET [2025/01/31 13:41:29 ET]
Table 'Adria' 6-max Seat #3 is the button
Seat 1: Ysiven ($222.61 in chips) 
Seat 2: S3MPR3IGUAL ($100 in chips) 
Seat 3: ozstrike88 ($112.56 in chips) 
Seat 4: reiyser ($133.96 in chips) 
Seat 5: KuningasRane ($194.72 in chips) 
Seat 6: J0SHB0SH ($214.99 in chips) 
reiyser: posts small blind $0.50
KuningasRane: posts big blind $1
*** HOLE CARDS ***
J0SHB0SH: raises $1 to $2
Ysiven: folds 
S3MPR3IGUAL: raises $4 to $6
ozstrike88: folds 
reiyser: folds 
KuningasRane: folds 
J0SHB0SH: calls $4
*** FLOP *** [6h Kh 8c]
J0SHB0SH: checks 
S3MPR3IGUAL: bets $3.20
J0SHB0SH: calls $3.20
*** TURN *** [6h Kh 8c] [5s]
J0SHB0SH: checks 
S3MPR3IGUAL: checks 
*** RIVER *** [6h Kh 8c 5s] [3s]
J0SHB0SH: checks 
S3MPR3IGUAL: checks 
*** SHOW DOWN ***
J0SHB0SH: shows [Jc Ac] (high card Ace)
S3MPR3IGUAL: shows [9h 9c] (a pair of Nines)
S3MPR3IGUAL collected $18.90 from pot
*** SUMMARY ***
Total pot $19.90 | Rake $1 
Board [6h Kh 8c 5s 3s]
Seat 1: Ysiven folded before Flop (didn't bet)
Seat 2: S3MPR3IGUAL showed [9h 9c] and won ($18.90) with a pair of Nines
Seat 3: ozstrike88 (button) folded before Flop (didn't bet)
Seat 4: reiyser (small blind) folded before Flop
Seat 5: KuningasRane (big blind) folded before Flop
Seat 6: J0SHB0SH showed [Jc Ac] and lost with high card Ace



PokerStars Hand #254640139278:  Hold'em No Limit ($0.50/$1.00 USD) - 2025/01/31 18:42:33 WET [2025/01/31 13:42:33 ET]
Table 'Adria' 6-max Seat #4 is the button
Seat 1: Ysiven ($222.61 in chips) 
Seat 2: S3MPR3IGUAL ($109.70 in chips) 
Seat 3: ozstrike88 ($112.56 in chips) 
Seat 4: reiyser ($133.46 in chips) 
Seat 5: KuningasRane ($193.72 in chips) 
Seat 6: J0SHB0SH ($205.79 in chips) 
KuningasRane: posts small blind $0.50
J0SHB0SH: posts big blind $1
*** HOLE CARDS ***
Ysiven: raises $1 to $2
S3MPR3IGUAL: folds 
ozstrike88: calls $2
reiyser: folds 
KuningasRane: raises $9 to $11
J0SHB0SH: folds 
Ysiven: folds 
ozstrike88: calls $9
*** FLOP *** [6c 8h 5h]
KuningasRane: bets $9.50
ozstrike88: calls $9.50
*** TURN *** [6c 8h 5h] [Qh]
KuningasRane: checks 
ozstrike88: checks 
*** RIVER *** [6c 8h 5h Qh] [2h]
KuningasRane: checks 
ozstrike88: bets $12
KuningasRane: calls $12
*** SHOW DOWN ***
ozstrike88: shows [Ah Th] (a flush, Ace high)
KuningasRane: mucks hand 
ozstrike88 collected $65.50 from pot
*** SUMMARY ***
Total pot $68 | Rake $2.50 
Board [6c 8h 5h Qh 2h]
Seat 1: Ysiven folded before Flop
Seat 2: S3MPR3IGUAL folded before Flop (didn't bet)
Seat 3: ozstrike88 showed [Ah Th] and won ($65.50) with a flush, Ace high
Seat 4: reiyser (button) folded before Flop (didn't bet)
Seat 5: KuningasRane (small blind) mucked
Seat 6: J0SHB0SH (big blind) folded before Flop



PokerStars Hand #254640160214:  Hold'em No Limit ($0.50/$1.00 USD) - 2025/01/31 18:43:51 WET [2025/01/31 13:43:51 ET]
Table 'Adria' 6-max Seat #5 is the button
Seat 1: Ysiven ($220.61 in chips) 
Seat 2: S3MPR3IGUAL ($109.70 in chips) 
Seat 3: ozstrike88 ($145.56 in chips) 
Seat 4: reiyser ($133.46 in chips) 
Seat 5: KuningasRane ($161.22 in chips) 
Seat 6: J0SHB0SH ($204.79 in chips) 
J0SHB0SH: posts small blind $0.50
Ysiven: posts big blind $1
*** HOLE CARDS ***
S3MPR3IGUAL: folds 
ozstrike88: folds 
reiyser: folds 
KuningasRane: raises $1.50 to $2.50
J0SHB0SH: folds 
Ysiven: folds 
Uncalled bet ($1.50) returned to KuningasRane
KuningasRane collected $2.50 from pot
KuningasRane: doesn't show hand 
*** SUMMARY ***
Total pot $2.50 | Rake $0 
Seat 1: Ysiven (big blind) folded before Flop
Seat 2: S3MPR3IGUAL folded before Flop (didn't bet)
Seat 3: ozstrike88 folded before Flop (didn't bet)
Seat 4: reiyser folded before Flop (didn't bet)
Seat 5: KuningasRane (button) collected ($2.50)
Seat 6: J0SHB0SH (small blind) folded before Flop



PokerStars Hand #254640164128:  Hold'em No Limit ($0.50/$1.00 USD) - 2025/01/31 18:44:06 WET [2025/01/31 13:44:06 ET]
Table 'Adria' 6-max Seat #6 is the button
Seat 1: Ysiven ($219.61 in chips) 
Seat 2: S3MPR3IGUAL ($109.70 in chips) 
Seat 3: ozstrike88 ($145.56 in chips) 
Seat 4: reiyser ($133.46 in chips) 
Seat 5: KuningasRane ($162.72 in chips) 
Seat 6: J0SHB0SH ($204.29 in chips) 
Ysiven: posts small blind $0.50
S3MPR3IGUAL: posts big blind $1
*** HOLE CARDS ***
ozstrike88: folds 
reiyser: folds 
KuningasRane: folds 
J0SHB0SH: raises $1.50 to $2.50
ozstrike88 leaves the table
Ysiven: folds 
S3MPR3IGUAL: calls $1.50
*** FLOP *** [Ad 2d 8s]
S3MPR3IGUAL: checks 
J0SHB0SH: checks 
*** TURN *** [Ad 2d 8s] [7h]
Rdalonso joins the table at seat #3 
S3MPR3IGUAL: checks 
J0SHB0SH: bets $3.92
S3MPR3IGUAL: calls $3.92
*** RIVER *** [Ad 2d 8s 7h] [Kd]
S3MPR3IGUAL: checks 
J0SHB0SH: bets $19.01
S3MPR3IGUAL: folds 
Uncalled bet ($19.01) returned to J0SHB0SH
J0SHB0SH collected $12.67 from pot
J0SHB0SH: doesn't show hand 
S3MPR3IGUAL leaves the table
*** SUMMARY ***
Total pot $13.34 | Rake $0.67 
Board [Ad 2d 8s 7h Kd]
Seat 1: Ysiven (small blind) folded before Flop
Seat 2: S3MPR3IGUAL (big blind) folded on the River
Seat 3: ozstrike88 folded before Flop (didn't bet)
Seat 4: reiyser folded before Flop (didn't bet)
Seat 5: KuningasRane folded before Flop (didn't bet)
Seat 6: J0SHB0SH (button) collected ($12.67)



PokerStars Hand #254640178794:  Hold'em No Limit ($0.50/$1.00 USD) - 2025/01/31 18:45:02 WET [2025/01/31 13:45:02 ET]
Table 'Adria' 6-max Seat #1 is the button
Seat 3: Rdalonso ($100 in chips) is sitting out
Seat 1: Ysiven ($219.11 in chips) 
Seat 4: reiyser ($133.46 in chips) 
Seat 5: KuningasRane ($162.72 in chips) 
Seat 6: J0SHB0SH ($210.54 in chips) 
reiyser: posts small blind $0.50
KuningasRane: posts big blind $1
*** HOLE CARDS ***
J0SHB0SH: raises $1.50 to $2.50
Ysiven: folds 
reiyser: folds 
KuningasRane: folds 
Uncalled bet ($1.50) returned to J0SHB0SH
J0SHB0SH collected $2.50 from pot
J0SHB0SH: doesn't show hand 
*** SUMMARY ***
Total pot $2.50 | Rake $0 
Seat 3: Rdalonso
Seat 1: Ysiven (button) folded before Flop (didn't bet)
Seat 4: reiyser (small blind) folded before Flop
Seat 5: KuningasRane (big blind) folded before Flop
Seat 6: J0SHB0SH collected ($2.50)



PokerStars Hand #254640182361:  Hold'em No Limit ($0.50/$1.00 USD) - 2025/01/31 18:45:15 WET [2025/01/31 13:45:15 ET]
Table 'Adria' 6-max Seat #4 is the button
Seat 3: Rdalonso ($100 in chips) is sitting out
Seat 1: Ysiven ($219.11 in chips) 
Seat 4: reiyser ($132.96 in chips) 
Seat 5: KuningasRane ($161.72 in chips) 
Seat 6: J0SHB0SH ($212.04 in chips) 
KuningasRane: posts small blind $0.50
J0SHB0SH: posts big blind $1
Rdalonso: sits out 
*** HOLE CARDS ***
Ysiven: folds 
reiyser: raises $1.23 to $2.23
KuningasRane: folds 
J0SHB0SH: folds 
Uncalled bet ($1.23) returned to reiyser
reiyser collected $2.50 from pot
reiyser: doesn't show hand 
*** SUMMARY ***
Total pot $2.50 | Rake $0 
Seat 3: Rdalonso
Seat 1: Ysiven folded before Flop (didn't bet)
Seat 4: reiyser (button) collected ($2.50)
Seat 5: KuningasRane (small blind) folded before Flop
Seat 6: J0SHB0SH (big blind) folded before Flop



PokerStars Hand #254640187745:  Hold'em No Limit ($0.50/$1.00 USD) - 2025/01/31 18:45:36 WET [2025/01/31 13:45:36 ET]
Table 'Adria' 6-max Seat #5 is the button
Seat 3: Rdalonso ($100 in chips) is sitting out
Seat 1: Ysiven ($219.11 in chips) 
Seat 4: reiyser ($134.46 in chips) 
Seat 5: KuningasRane ($161.22 in chips) 
Seat 6: J0SHB0SH ($211.04 in chips) 
J0SHB0SH: posts small blind $0.50
Ysiven: posts big blind $1
Rdalonso: sits out 
*** HOLE CARDS ***
reiyser: folds 
KuningasRane: folds 
J0SHB0SH: folds 
Uncalled bet ($0.50) returned to Ysiven
Ysiven collected $1 from pot
Ysiven: doesn't show hand 
*** SUMMARY ***
Total pot $1 | Rake $0 
Seat 3: Rdalonso
Seat 1: Ysiven (big blind) collected ($1)
Seat 4: reiyser folded before Flop (didn't bet)
Seat 5: KuningasRane (button) folded before Flop (didn't bet)
Seat 6: J0SHB0SH (small blind) folded before Flop



PokerStars Hand #254640189956:  Hold'em No Limit ($0.50/$1.00 USD) - 2025/01/31 18:45:44 WET [2025/01/31 13:45:44 ET]
Table 'Adria' 6-max Seat #6 is the button
Seat 1: Ysiven ($219.61 in chips) 
Seat 3: Rdalonso ($100 in chips) 
Seat 4: reiyser ($134.46 in chips) 
Seat 5: KuningasRane ($161.22 in chips) 
Seat 6: J0SHB0SH ($210.54 in chips) 
Ysiven: posts small blind $0.50
Rdalonso: posts big blind $1
*** HOLE CARDS ***
reiyser: folds 
KuningasRane: folds 
J0SHB0SH: raises $1.50 to $2.50
Ysiven: folds 
Rdalonso: folds 
Uncalled bet ($1.50) returned to J0SHB0SH
J0SHB0SH collected $2.50 from pot
J0SHB0SH: doesn't show hand 
*** SUMMARY ***
Total pot $2.50 | Rake $0 
Seat 1: Ysiven (small blind) folded before Flop
Seat 3: Rdalonso (big blind) folded before Flop
Seat 4: reiyser folded before Flop (didn't bet)
Seat 5: KuningasRane folded before Flop (didn't bet)
Seat 6: J0SHB0SH (button) collected ($2.50)



PokerStars Hand #254640193635:  Hold'em No Limit ($0.50/$1.00 USD) - 2025/01/31 18:45:58 WET [2025/01/31 13:45:58 ET]
Table 'Adria' 6-max Seat #1 is the button
Seat 1: Ysiven ($219.11 in chips) 
Seat 3: Rdalonso ($100 in chips) 
Seat 4: reiyser ($134.46 in chips) 
Seat 5: KuningasRane ($161.22 in chips) 
Seat 6: J0SHB0SH ($212.04 in chips) 
Rdalonso: posts small blind $0.50
reiyser: posts big blind $1
*** HOLE CARDS ***
KuningasRane: folds 
J0SHB0SH: raises $1.50 to $2.50
kvcsszblcs joins the table at seat #2 
Ysiven: folds 
Rdalonso: folds 
reiyser: folds 
Uncalled bet ($1.50) returned to J0SHB0SH
J0SHB0SH collected $2.50 from pot
J0SHB0SH: doesn't show hand 
*** SUMMARY ***
Total pot $2.50 | Rake $0 
Seat 1: Ysiven (button) folded before Flop (didn't bet)
Seat 3: Rdalonso (small blind) folded before Flop
Seat 4: reiyser (big blind) folded before Flop
Seat 5: KuningasRane folded before Flop (didn't bet)
Seat 6: J0SHB0SH collected ($2.50)



PokerStars Hand #254640197970:  Hold'em No Limit ($0.50/$1.00 USD) - 2025/01/31 18:46:14 WET [2025/01/31 13:46:14 ET]
Table 'Adria' 6-max Seat #3 is the button
Seat 2: kvcsszblcs ($100 in chips) is sitting out
Seat 1: Ysiven ($219.11 in chips) 
Seat 3: Rdalonso ($100 in chips) 
Seat 4: reiyser ($133.46 in chips) 
Seat 5: KuningasRane ($161.22 in chips) 
Seat 6: J0SHB0SH ($213.54 in chips) 
reiyser: posts small blind $0.50
KuningasRane: posts big blind $1
kvcsszblcs: sits out 
*** HOLE CARDS ***
J0SHB0SH: folds 
Ysiven: raises $1.30 to $2.30
Rdalonso: folds 
reiyser: folds 
KuningasRane: folds 
Uncalled bet ($1.30) returned to Ysiven
Ysiven collected $2.50 from pot
Ysiven: doesn't show hand 
*** SUMMARY ***
Total pot $2.50 | Rake $0 
Seat 2: kvcsszblcs
Seat 1: Ysiven collected ($2.50)
Seat 3: Rdalonso (button) folded before Flop (didn't bet)
Seat 4: reiyser (small blind) folded before Flop
Seat 5: KuningasRane (big blind) folded before Flop
Seat 6: J0SHB0SH folded before Flop (didn't bet)



PokerStars Hand #254640201319:  Hold'em No Limit ($0.50/$1.00 USD) - 2025/01/31 18:46:27 WET [2025/01/31 13:46:27 ET]
Table 'Adria' 6-max Seat #4 is the button
Seat 2: kvcsszblcs ($100 in chips) is sitting out
Seat 1: Ysiven ($220.61 in chips) 
Seat 3: Rdalonso ($100 in chips) 
Seat 4: reiyser ($132.96 in chips) 
Seat 5: KuningasRane ($160.22 in chips) 
Seat 6: J0SHB0SH ($213.54 in chips) 
KuningasRane: posts small blind $0.50
J0SHB0SH: posts big blind $1
kvcsszblcs: sits out 
*** HOLE CARDS ***
Ysiven: folds 
Rdalonso: folds 
reiyser: folds 
KuningasRane: folds 
Uncalled bet ($0.50) returned to J0SHB0SH
J0SHB0SH collected $1 from pot
J0SHB0SH: doesn't show hand 
*** SUMMARY ***
Total pot $1 | Rake $0 
Seat 2: kvcsszblcs
Seat 1: Ysiven folded before Flop (didn't bet)
Seat 3: Rdalonso folded before Flop (didn't bet)
Seat 4: reiyser (button) folded before Flop (didn't bet)
Seat 5: KuningasRane (small blind) folded before Flop
Seat 6: J0SHB0SH (big blind) collected ($1)



PokerStars Hand #254640204877:  Hold'em No Limit ($0.50/$1.00 USD) - 2025/01/31 18:46:40 WET [2025/01/31 13:46:40 ET]
Table 'Adria' 6-max Seat #5 is the button
Seat 2: kvcsszblcs ($100 in chips) is sitting out
Seat 1: Ysiven ($220.61 in chips) 
Seat 3: Rdalonso ($100 in chips) 
Seat 4: reiyser ($132.96 in chips) 
Seat 5: KuningasRane ($159.72 in chips) 
Seat 6: J0SHB0SH ($214.04 in chips) 
J0SHB0SH: posts small blind $0.50
Ysiven: posts big blind $1
kvcsszblcs: sits out 
*** HOLE CARDS ***
Rdalonso: folds 
reiyser: raises $1.23 to $2.23
KuningasRane: folds 
J0SHB0SH: folds 
Ysiven: folds 
Uncalled bet ($1.23) returned to reiyser
reiyser collected $2.50 from pot
reiyser: doesn't show hand 
*** SUMMARY ***
Total pot $2.50 | Rake $0 
Seat 2: kvcsszblcs
Seat 1: Ysiven (big blind) folded before Flop
Seat 3: Rdalonso folded before Flop (didn't bet)
Seat 4: reiyser collected ($2.50)
Seat 5: KuningasRane (button) folded before Flop (didn't bet)
Seat 6: J0SHB0SH (small blind) folded before Flop



PokerStars Hand #254640207727:  Hold'em No Limit ($0.50/$1.00 USD) - 2025/01/31 18:46:51 WET [2025/01/31 13:46:51 ET]
Table 'Adria' 6-max Seat #6 is the button
Seat 1: Ysiven ($219.61 in chips) 
Seat 2: kvcsszblcs ($100 in chips) 
Seat 3: Rdalonso ($100 in chips) 
Seat 4: reiyser ($134.46 in chips) 
Seat 5: KuningasRane ($159.72 in chips) 
Seat 6: J0SHB0SH ($213.54 in chips) 
Ysiven: posts small blind $0.50
kvcsszblcs: posts big blind $1
*** HOLE CARDS ***
Rdalonso: raises $1.50 to $2.50
reiyser: folds 
KuningasRane: folds 
J0SHB0SH: folds 
Ysiven: folds 
kvcsszblcs: folds 
Uncalled bet ($1.50) returned to Rdalonso
Rdalonso collected $2.50 from pot
Rdalonso: doesn't show hand 
*** SUMMARY ***
Total pot $2.50 | Rake $0 
Seat 1: Ysiven (small blind) folded before Flop
Seat 2: kvcsszblcs (big blind) folded before Flop
Seat 3: Rdalonso collected ($2.50)
Seat 4: reiyser folded before Flop (didn't bet)
Seat 5: KuningasRane folded before Flop (didn't bet)
Seat 6: J0SHB0SH (button) folded before Flop (didn't bet)



PokerStars Hand #254640212798:  Hold'em No Limit ($0.50/$1.00 USD) - 2025/01/31 18:47:10 WET [2025/01/31 13:47:10 ET]
Table 'Adria' 6-max Seat #1 is the button
Seat 1: Ysiven ($219.11 in chips) 
Seat 2: kvcsszblcs ($100 in chips) 
Seat 3: Rdalonso ($101.50 in chips) 
Seat 4: reiyser ($134.46 in chips) 
Seat 5: KuningasRane ($159.72 in chips) 
Seat 6: J0SHB0SH ($213.54 in chips) 
kvcsszblcs: posts small blind $0.50
Rdalonso: posts big blind $1
*** HOLE CARDS ***
reiyser: folds 
KuningasRane: raises $1.50 to $2.50
J0SHB0SH: folds 
reiyser leaves the table
Ysiven: raises $5 to $7.50
kvcsszblcs: folds 
Rdalonso: folds 
KuningasRane: raises $18.50 to $26
Ysiven: calls $18.50
*** FLOP *** [2c Qs Ac]
KuningasRane: checks 
Ysiven: checks 
*** TURN *** [2c Qs Ac] [Js]
KuningasRane: bets $18.40
Ysiven: folds 
Uncalled bet ($18.40) returned to KuningasRane
KuningasRane collected $51 from pot
KuningasRane: doesn't show hand 
*** SUMMARY ***
Total pot $53.50 | Rake $2.50 
Board [2c Qs Ac Js]
Seat 1: Ysiven (button) folded on the Turn
Seat 2: kvcsszblcs (small blind) folded before Flop
Seat 3: Rdalonso (big blind) folded before Flop
Seat 4: reiyser folded before Flop (didn't bet)
Seat 5: KuningasRane collected ($51)
Seat 6: J0SHB0SH folded before Flop (didn't bet)



PokerStars Hand #254640238749:  Hold'em No Limit ($0.50/$1.00 USD) - 2025/01/31 18:48:48 WET [2025/01/31 13:48:48 ET]
Table 'Adria' 6-max Seat #2 is the button
Seat 1: Ysiven ($193.11 in chips) 
Seat 2: kvcsszblcs ($100 in chips) 
Seat 3: Rdalonso ($100.50 in chips) 
Seat 5: KuningasRane ($184.72 in chips) 
Seat 6: J0SHB0SH ($213.54 in chips) 
Rdalonso: posts small blind $0.50
KuningasRane: posts big blind $1
*** HOLE CARDS ***
J0SHB0SH: raises $1.50 to $2.50
Ysiven: folds 
kvcsszblcs: raises $5.50 to $8
Rdalonso: folds 
KuningasRane: folds 
J0SHB0SH: folds 
Uncalled bet ($5.50) returned to kvcsszblcs
kvcsszblcs collected $6.50 from pot
kvcsszblcs: doesn't show hand 
*** SUMMARY ***
Total pot $6.50 | Rake $0 
Seat 1: Ysiven folded before Flop (didn't bet)
Seat 2: kvcsszblcs (button) collected ($6.50)
Seat 3: Rdalonso (small blind) folded before Flop
Seat 5: KuningasRane (big blind) folded before Flop
Seat 6: J0SHB0SH folded before Flop



PokerStars Hand #254640247752:  Hold'em No Limit ($0.50/$1.00 USD) - 2025/01/31 18:49:22 WET [2025/01/31 13:49:22 ET]
Table 'Adria' 6-max Seat #3 is the button
Seat 1: Ysiven ($193.11 in chips) 
Seat 2: kvcsszblcs ($104 in chips) 
Seat 3: Rdalonso ($100 in chips) 
Seat 5: KuningasRane ($183.72 in chips) 
Seat 6: J0SHB0SH ($211.04 in chips) 
KuningasRane: posts small blind $0.50
J0SHB0SH: posts big blind $1
*** HOLE CARDS ***
Ysiven: folds 
kvcsszblcs: folds 
Rdalonso: raises $1.50 to $2.50
KuningasRane: folds 
J0SHB0SH: folds 
Uncalled bet ($1.50) returned to Rdalonso
Rdalonso collected $2.50 from pot
Rdalonso: doesn't show hand 
Kristo 914 joins the table at seat #4 
*** SUMMARY ***
Total pot $2.50 | Rake $0 
Seat 1: Ysiven folded before Flop (didn't bet)
Seat 2: kvcsszblcs folded before Flop (didn't bet)
Seat 3: Rdalonso (button) collected ($2.50)
Seat 5: KuningasRane (small blind) folded before Flop
Seat 6: J0SHB0SH (big blind) folded before Flop



PokerStars Hand #254640250959:  Hold'em No Limit ($0.50/$1.00 USD) - 2025/01/31 18:49:34 WET [2025/01/31 13:49:34 ET]
Table 'Adria' 6-max Seat #5 is the button
Seat 4: Kristo 914 ($163.60 in chips) is sitting out
Seat 1: Ysiven ($193.11 in chips) 
Seat 2: kvcsszblcs ($104 in chips) 
Seat 3: Rdalonso ($101.50 in chips) 
Seat 5: KuningasRane ($183.22 in chips) 
Seat 6: J0SHB0SH ($210.04 in chips) 
J0SHB0SH: posts small blind $0.50
Ysiven: posts big blind $1
Kristo 914: sits out 
*** HOLE CARDS ***
kvcsszblcs: folds 
Kristo 914 leaves the table
Rdalonso: folds 
KuningasRane: folds 
J0SHB0SH: raises $2 to $3
Ysiven: folds 
Uncalled bet ($2) returned to J0SHB0SH
J0SHB0SH collected $2 from pot
J0SHB0SH: doesn't show hand 
*** SUMMARY ***
Total pot $2 | Rake $0 
Seat 4: Kristo 914
Seat 1: Ysiven (big blind) folded before Flop
Seat 2: kvcsszblcs folded before Flop (didn't bet)
Seat 3: Rdalonso folded before Flop (didn't bet)
Seat 5: KuningasRane (button) folded before Flop (didn't bet)
Seat 6: J0SHB0SH (small blind) collected ($2)



PokerStars Hand #254640255892:  Hold'em No Limit ($0.50/$1.00 USD) - 2025/01/31 18:49:53 WET [2025/01/31 13:49:53 ET]
Table 'Adria' 6-max Seat #6 is the button
Seat 1: Ysiven ($192.11 in chips) 
Seat 2: kvcsszblcs ($104 in chips) 
Seat 3: Rdalonso ($101.50 in chips) 
Seat 5: KuningasRane ($183.22 in chips) 
Seat 6: J0SHB0SH ($211.04 in chips) 
Ysiven: posts small blind $0.50
kvcsszblcs: posts big blind $1
*** HOLE CARDS ***
Rdalonso: folds 
KuningasRane: folds 
J0SHB0SH: raises $1.50 to $2.50
Ysiven: raises $8 to $10.50
kvcsszblcs: folds 
J0SHB0SH: raises $15.50 to $26
Ysiven: calls $15.50
*** FLOP *** [8h 2s Ts]
Ysiven: checks 
J0SHB0SH: bets $16.67
Ysiven: calls $16.67
*** TURN *** [8h 2s Ts] [Jd]
Ysiven: checks 
J0SHB0SH: bets $27.67
Ysiven: folds 
Uncalled bet ($27.67) returned to J0SHB0SH
weenomat joins the table at seat #4 
weenomat is disconnected 
J0SHB0SH collected $83.84 from pot
J0SHB0SH: doesn't show hand 
*** SUMMARY ***
Total pot $86.34 | Rake $2.50 
Board [8h 2s Ts Jd]
Seat 1: Ysiven (small blind) folded on the Turn
Seat 2: kvcsszblcs (big blind) folded before Flop
Seat 3: Rdalonso folded before Flop (didn't bet)
Seat 5: KuningasRane folded before Flop (didn't bet)
Seat 6: J0SHB0SH (button) collected ($83.84)



PokerStars Hand #254640287758:  Hold'em No Limit ($0.50/$1.00 USD) - 2025/01/31 18:51:53 WET [2025/01/31 13:51:53 ET]
Table 'Adria' 6-max Seat #1 is the button
Seat 3: Rdalonso ($101.50 in chips) is sitting out
Seat 1: Ysiven ($149.44 in chips) 
Seat 2: kvcsszblcs ($103 in chips) 
Seat 4: weenomat ($10 in chips) 
Seat 5: KuningasRane ($183.22 in chips) 
Seat 6: J0SHB0SH ($252.21 in chips) 
kvcsszblcs: posts small blind $0.50
Rdalonso: is sitting out 
weenomat: posts big blind $1
*** HOLE CARDS ***
KuningasRane: folds 
J0SHB0SH: folds 
Ysiven: folds 
Rdalonso leaves the table
kvcsszblcs: raises $11.50 to $12.50
weenomat: calls $9 and is all-in
Uncalled bet ($2.50) returned to kvcsszblcs
IREQO joins the table at seat #3 
*** FLOP *** [7h 2s Ts]
*** TURN *** [7h 2s Ts] [6d]
*** RIVER *** [7h 2s Ts 6d] [Th]
*** SHOW DOWN ***
kvcsszblcs: shows [Qd Kd] (a pair of Tens)
weenomat: shows [5h 3h] (a pair of Tens - lower kicker)
kvcsszblcs collected $19 from pot
*** SUMMARY ***
Total pot $20 | Rake $1 
Board [7h 2s Ts 6d Th]
Seat 3: Rdalonso
Seat 1: Ysiven (button) folded before Flop (didn't bet)
Seat 2: kvcsszblcs (small blind) showed [Qd Kd] and won ($19) with a pair of Tens
Seat 4: weenomat (big blind) showed [5h 3h] and lost with a pair of Tens
Seat 5: KuningasRane folded before Flop (didn't bet)
Seat 6: J0SHB0SH folded before Flop (didn't bet)



PokerStars Hand #254640296796:  Hold'em No Limit ($0.50/$1.00 USD) - 2025/01/31 18:52:27 WET [2025/01/31 13:52:27 ET]
Table 'Adria' 6-max Seat #2 is the button
Seat 3: IREQO ($100 in chips) is sitting out
Seat 4: weenomat ($0 in chips) is sitting out
Seat 1: Ysiven ($149.44 in chips) 
Seat 2: kvcsszblcs ($112 in chips) 
Seat 5: KuningasRane ($183.22 in chips) 
Seat 6: J0SHB0SH ($252.21 in chips) 
KuningasRane: posts small blind $0.50
J0SHB0SH: posts big blind $1
*** HOLE CARDS ***
Ysiven: folds 
kvcsszblcs: raises $1.25 to $2.25
KuningasRane: calls $1.75
J0SHB0SH: folds 
*** FLOP *** [Kd 2d 8c]
KuningasRane: checks 
kvcsszblcs: bets $1.31
KuningasRane: calls $1.31
*** TURN *** [Kd 2d 8c] [9s]
KuningasRane: checks 
kvcsszblcs: checks 
*** RIVER *** [Kd 2d 8c 9s] [Ah]
KuningasRane: checks 
kvcsszblcs: checks 
*** SHOW DOWN ***
KuningasRane: shows [9d 7d] (a pair of Nines)
kvcsszblcs: shows [Jc 9h] (a pair of Nines - Ace+King+Jack kicker)
kvcsszblcs collected $7.71 from pot
*** SUMMARY ***
Total pot $8.12 | Rake $0.41 
Board [Kd 2d 8c 9s Ah]
Seat 3: IREQO
Seat 4: weenomat
Seat 1: Ysiven folded before Flop (didn't bet)
Seat 2: kvcsszblcs (button) showed [Jc 9h] and won ($7.71) with a pair of Nines
Seat 5: KuningasRane (small blind) showed [9d 7d] and lost with a pair of Nines
Seat 6: J0SHB0SH (big blind) folded before Flop



