PokerStars Hand #254221026192:  Hold'em No Limit ($0.50/$1.00 USD) - 2025/01/05 0:46:08 WET [2025/01/05 19:46:08 ET]
Table 'Winifred' 6-max Seat #2 is the button
Seat 1: Eredar5 ($100 in chips) 
Seat 2: SorinS28 ($107.52 in chips) 
Seat 3: MaRKiToScoK ($100.50 in chips) 
Seat 5: XyonKim ($72.03 in chips) 
Seat 6: CaHek-Ty3 ($100 in chips) 
MaRKiToScoK: posts small blind $0.50
XyonKim: posts big blind $1
*** HOLE CARDS ***
CaHek-Ty3: raises $1.50 to $2.50
Eredar5: folds 
SorinS28: folds 
MaRKiToScoK: calls $2
XyonKim: folds 
*** FLOP *** [Kc 6h 8c]
MaRKiToScoK: checks 
CaHek-Ty3: bets $1.88
MaRKiToScoK: folds 
Uncalled bet ($1.88) returned to CaHek-Ty3
CaHek-Ty3 collected $5.70 from pot
*** SUMMARY ***
Total pot $6 | Rake $0.30 
Board [Kc 6h 8c]
Seat 1: Eredar5 folded before Flop (didn't bet)
Seat 2: SorinS28 (button) folded before Flop (didn't bet)
Seat 3: MaRKiToScoK (small blind) folded on the Flop
Seat 5: XyonKim (big blind) folded before Flop
Seat 6: CaHek-Ty3 collected ($5.70)



PokerStars Hand #254221031982:  Hold'em No Limit ($0.50/$1.00 USD) - 2025/01/05 0:46:31 WET [2025/01/05 19:46:31 ET]
Table 'Winifred' 6-max Seat #3 is the button
Seat 1: Eredar5 ($100 in chips) 
Seat 2: SorinS28 ($107.52 in chips) 
Seat 3: MaRKiToScoK ($100 in chips) 
Seat 5: XyonKim ($71.03 in chips) 
Seat 6: CaHek-Ty3 ($103.20 in chips) 
XyonKim: posts small blind $0.50
CaHek-Ty3: posts big blind $1
*** HOLE CARDS ***
Eredar5: folds 
SorinS28: folds 
MaRKiToScoK: folds 
XyonKim: raises $2 to $3
CaHek-Ty3: folds 
Uncalled bet ($2) returned to XyonKim
XyonKim collected $2 from pot
*** SUMMARY ***
Total pot $2 | Rake $0 
Seat 1: Eredar5 folded before Flop (didn't bet)
Seat 2: SorinS28 folded before Flop (didn't bet)
Seat 3: MaRKiToScoK (button) folded before Flop (didn't bet)
Seat 5: XyonKim (small blind) collected ($2)
Seat 6: CaHek-Ty3 (big blind) folded before Flop



PokerStars Hand #254221036191:  Hold'em No Limit ($0.50/$1.00 USD) - 2025/01/05 0:46:49 WET [2025/01/05 19:46:49 ET]
Table 'Winifred' 6-max Seat #5 is the button
Seat 1: Eredar5 ($100 in chips) is sitting out
Seat 2: SorinS28 ($107.52 in chips) 
Seat 3: MaRKiToScoK ($100 in chips) 
Seat 5: XyonKim ($72.03 in chips) 
Seat 6: CaHek-Ty3 ($102.20 in chips) 
CaHek-Ty3: posts small blind $0.50
Eredar5: is sitting out 
SorinS28: posts big blind $1
*** HOLE CARDS ***
MaRKiToScoK: folds 
XyonKim: folds 
CaHek-Ty3: folds 
Uncalled bet ($0.50) returned to SorinS28
SorinS28 collected $1 from pot
SorinS28: doesn't show hand 
*** SUMMARY ***
Total pot $1 | Rake $0 
Seat 1: Eredar5
Seat 2: SorinS28 (big blind) collected ($1)
Seat 3: MaRKiToScoK folded before Flop (didn't bet)
Seat 5: XyonKim (button) folded before Flop (didn't bet)
Seat 6: CaHek-Ty3 (small blind) folded before Flop



PokerStars Hand #254221037710:  Hold'em No Limit ($0.50/$1.00 USD) - 2025/01/05 0:46:55 WET [2025/01/05 19:46:55 ET]
Table 'Winifred' 6-max Seat #6 is the button
Seat 1: Eredar5 ($100 in chips) is sitting out
Seat 2: SorinS28 ($108.02 in chips) 
Seat 3: MaRKiToScoK ($100 in chips) 
Seat 5: XyonKim ($72.03 in chips) 
Seat 6: CaHek-Ty3 ($101.70 in chips) 
SorinS28: posts small blind $0.50
MaRKiToScoK: posts big blind $1
*** HOLE CARDS ***
XyonKim: folds 
CaHek-Ty3: folds 
Eredar5 leaves the table
SorinS28: raises $2 to $3
MaRKiToScoK: folds 
Uncalled bet ($2) returned to SorinS28
SorinS28 collected $2 from pot
SorinS28: doesn't show hand 
*** SUMMARY ***
Total pot $2 | Rake $0 
Seat 1: Eredar5
Seat 2: SorinS28 (small blind) collected ($2)
Seat 3: MaRKiToScoK (big blind) folded before Flop
Seat 5: XyonKim folded before Flop (didn't bet)
Seat 6: CaHek-Ty3 (button) folded before Flop (didn't bet)



PokerStars Hand #254221042971:  Hold'em No Limit ($0.50/$1.00 USD) - 2025/01/05 0:47:17 WET [2025/01/05 19:47:17 ET]
Table 'Winifred' 6-max Seat #2 is the button
Seat 2: SorinS28 ($109.02 in chips) 
Seat 3: MaRKiToScoK ($100 in chips) 
Seat 5: XyonKim ($72.03 in chips) 
Seat 6: CaHek-Ty3 ($101.70 in chips) 
MaRKiToScoK: posts small blind $0.50
XyonKim: posts big blind $1
*** HOLE CARDS ***
CaHek-Ty3: folds 
SorinS28: folds 
MaRKiToScoK: folds 
Uncalled bet ($0.50) returned to XyonKim
XyonKim collected $1 from pot
*** SUMMARY ***
Total pot $1 | Rake $0 
Seat 2: SorinS28 (button) folded before Flop (didn't bet)
Seat 3: MaRKiToScoK (small blind) folded before Flop
Seat 5: XyonKim (big blind) collected ($1)
Seat 6: CaHek-Ty3 folded before Flop (didn't bet)



PokerStars Hand #254221045865:  Hold'em No Limit ($0.50/$1.00 USD) - 2025/01/05 0:47:28 WET [2025/01/05 19:47:28 ET]
Table 'Winifred' 6-max Seat #3 is the button
Seat 2: SorinS28 ($109.02 in chips) 
Seat 3: MaRKiToScoK ($100 in chips) 
Seat 5: XyonKim ($72.53 in chips) 
Seat 6: CaHek-Ty3 ($101.70 in chips) 
XyonKim: posts small blind $0.50
CaHek-Ty3: posts big blind $1
*** HOLE CARDS ***
SorinS28: folds 
MaRKiToScoK: folds 
XyonKim: folds 
Uncalled bet ($0.50) returned to CaHek-Ty3
CaHek-Ty3 collected $1 from pot
*** SUMMARY ***
Total pot $1 | Rake $0 
Seat 2: SorinS28 folded before Flop (didn't bet)
Seat 3: MaRKiToScoK (button) folded before Flop (didn't bet)
Seat 5: XyonKim (small blind) folded before Flop
Seat 6: CaHek-Ty3 (big blind) collected ($1)



PokerStars Hand #254221049163:  Hold'em No Limit ($0.50/$1.00 USD) - 2025/01/05 0:47:42 WET [2025/01/05 19:47:42 ET]
Table 'Winifred' 6-max Seat #5 is the button
Seat 2: SorinS28 ($109.02 in chips) 
Seat 3: MaRKiToScoK ($100 in chips) 
Seat 5: XyonKim ($72.03 in chips) 
Seat 6: CaHek-Ty3 ($102.20 in chips) 
CaHek-Ty3: posts small blind $0.50
SorinS28: posts big blind $1
*** HOLE CARDS ***
Espada Fish joins the table at seat #1 
MaRKiToScoK: folds 
XyonKim: folds 
CaHek-Ty3: folds 
Uncalled bet ($0.50) returned to SorinS28
SorinS28 collected $1 from pot
SorinS28: doesn't show hand 
*** SUMMARY ***
Total pot $1 | Rake $0 
Seat 2: SorinS28 (big blind) collected ($1)
Seat 3: MaRKiToScoK folded before Flop (didn't bet)
Seat 5: XyonKim (button) folded before Flop (didn't bet)
Seat 6: CaHek-Ty3 (small blind) folded before Flop



PokerStars Hand #254221051716:  Hold'em No Limit ($0.50/$1.00 USD) - 2025/01/05 0:47:52 WET [2025/01/05 19:47:52 ET]
Table 'Winifred' 6-max Seat #6 is the button
Seat 1: Espada Fish ($100 in chips) is sitting out
Seat 2: SorinS28 ($109.52 in chips) 
Seat 3: MaRKiToScoK ($100 in chips) 
Seat 5: XyonKim ($72.03 in chips) 
Seat 6: CaHek-Ty3 ($101.70 in chips) 
SorinS28: posts small blind $0.50
MaRKiToScoK: posts big blind $1
*** HOLE CARDS ***
XyonKim: folds 
GuigaMan joins the table at seat #4 
CaHek-Ty3: raises $1.50 to $2.50
SorinS28: folds 
MaRKiToScoK: raises $9.50 to $12
CaHek-Ty3: folds 
Uncalled bet ($9.50) returned to MaRKiToScoK
MaRKiToScoK collected $5.50 from pot
*** SUMMARY ***
Total pot $5.50 | Rake $0 
Seat 1: Espada Fish
Seat 2: SorinS28 (small blind) folded before Flop
Seat 3: MaRKiToScoK (big blind) collected ($5.50)
Seat 5: XyonKim folded before Flop (didn't bet)
Seat 6: CaHek-Ty3 (button) folded before Flop



PokerStars Hand #254221057334:  Hold'em No Limit ($0.50/$1.00 USD) - 2025/01/05 0:48:16 WET [2025/01/05 19:48:16 ET]
Table 'Winifred' 6-max Seat #2 is the button
Seat 1: Espada Fish ($100 in chips) is sitting out
Seat 2: SorinS28 ($109.02 in chips) 
Seat 3: MaRKiToScoK ($103 in chips) 
Seat 4: GuigaMan ($100 in chips) 
Seat 5: XyonKim ($72.03 in chips) 
Seat 6: CaHek-Ty3 ($100 in chips) 
MaRKiToScoK: posts small blind $0.50
GuigaMan: posts big blind $1
Espada Fish: sits out 
*** HOLE CARDS ***
XyonKim: raises $2 to $3
CaHek-Ty3: folds 
SorinS28: calls $3
MaRKiToScoK: folds 
GuigaMan: calls $2
*** FLOP *** [3h 8c Qc]
GuigaMan: checks 
XyonKim: bets $4
SorinS28: folds 
GuigaMan: folds 
Uncalled bet ($4) returned to XyonKim
XyonKim collected $9.02 from pot
*** SUMMARY ***
Total pot $9.50 | Rake $0.48 
Board [3h 8c Qc]
Seat 1: Espada Fish
Seat 2: SorinS28 (button) folded on the Flop
Seat 3: MaRKiToScoK (small blind) folded before Flop
Seat 4: GuigaMan (big blind) folded on the Flop
Seat 5: XyonKim collected ($9.02)
Seat 6: CaHek-Ty3 folded before Flop (didn't bet)



PokerStars Hand #254221070312:  Hold'em No Limit ($0.50/$1.00 USD) - 2025/01/05 0:49:09 WET [2025/01/05 19:49:09 ET]
Table 'Winifred' 6-max Seat #3 is the button
Seat 1: Espada Fish ($100 in chips) is sitting out
Seat 2: SorinS28 ($106.02 in chips) 
Seat 3: MaRKiToScoK ($102.50 in chips) 
Seat 4: GuigaMan ($100 in chips) 
Seat 5: XyonKim ($78.05 in chips) 
Seat 6: CaHek-Ty3 ($100 in chips) 
GuigaMan: posts small blind $0.50
XyonKim: posts big blind $1
Espada Fish: sits out 
*** HOLE CARDS ***
CaHek-Ty3: folds 
SorinS28: raises $1.30 to $2.30
MaRKiToScoK: calls $2.30
GuigaMan: folds 
XyonKim: calls $1.30
*** FLOP *** [4h Ac 4d]
XyonKim: checks 
SorinS28: checks 
MaRKiToScoK: checks 
*** TURN *** [4h Ac 4d] [Jh]
XyonKim: checks 
SorinS28: checks 
MaRKiToScoK: checks 
*** RIVER *** [4h Ac 4d Jh] [8d]
XyonKim: checks 
SorinS28: bets $2.46
MaRKiToScoK: calls $2.46
XyonKim: folds 
*** SHOW DOWN ***
SorinS28: shows [Qs Qh] (two pair, Queens and Fours)
MaRKiToScoK: shows [As 6s] (two pair, Aces and Fours)
MaRKiToScoK collected $11.70 from pot
*** SUMMARY ***
Total pot $12.32 | Rake $0.62 
Board [4h Ac 4d Jh 8d]
Seat 1: Espada Fish
Seat 2: SorinS28 showed [Qs Qh] and lost with two pair, Queens and Fours
Seat 3: MaRKiToScoK (button) showed [As 6s] and won ($11.70) with two pair, Aces and Fours
Seat 4: GuigaMan (small blind) folded before Flop
Seat 5: XyonKim (big blind) folded on the River
Seat 6: CaHek-Ty3 folded before Flop (didn't bet)



PokerStars Hand #254221092350:  Hold'em No Limit ($0.50/$1.00 USD) - 2025/01/05 0:50:39 WET [2025/01/05 19:50:39 ET]
Table 'Winifred' 6-max Seat #4 is the button
Seat 1: Espada Fish ($100 in chips) is sitting out
Seat 2: SorinS28 ($101.26 in chips) 
Seat 3: MaRKiToScoK ($109.44 in chips) 
Seat 4: GuigaMan ($100 in chips) 
Seat 5: XyonKim ($75.75 in chips) 
Seat 6: CaHek-Ty3 ($100 in chips) 
XyonKim: posts small blind $0.50
CaHek-Ty3: posts big blind $1
Espada Fish: sits out 
*** HOLE CARDS ***
SorinS28: folds 
MaRKiToScoK: folds 
GuigaMan: folds 
XyonKim: calls $0.50
CaHek-Ty3: raises $4 to $5
XyonKim: folds 
Uncalled bet ($4) returned to CaHek-Ty3
CaHek-Ty3 collected $2 from pot
*** SUMMARY ***
Total pot $2 | Rake $0 
Seat 1: Espada Fish
Seat 2: SorinS28 folded before Flop (didn't bet)
Seat 3: MaRKiToScoK folded before Flop (didn't bet)
Seat 4: GuigaMan (button) folded before Flop (didn't bet)
Seat 5: XyonKim (small blind) folded before Flop
Seat 6: CaHek-Ty3 (big blind) collected ($2)



PokerStars Hand #254221096537:  Hold'em No Limit ($0.50/$1.00 USD) - 2025/01/05 0:50:57 WET [2025/01/05 19:50:57 ET]
Table 'Winifred' 6-max Seat #5 is the button
Seat 1: Espada Fish ($100 in chips) 
Seat 2: SorinS28 ($101.26 in chips) 
Seat 3: MaRKiToScoK ($109.44 in chips) 
Seat 4: GuigaMan ($100 in chips) 
Seat 5: XyonKim ($74.75 in chips) 
Seat 6: CaHek-Ty3 ($101 in chips) 
CaHek-Ty3: posts small blind $0.50
Espada Fish: posts big blind $1
*** HOLE CARDS ***
SorinS28: raises $1.02 to $2.02
MaRKiToScoK: folds 
GuigaMan: folds 
XyonKim: calls $2.02
CaHek-Ty3: folds 
Espada Fish: calls $1.02
*** FLOP *** [Kh 2d Tc]
Espada Fish: checks 
SorinS28: bets $1.74
XyonKim: calls $1.74
Espada Fish: calls $1.74
*** TURN *** [Kh 2d Tc] [Jh]
Espada Fish: checks 
SorinS28: bets $8.39
XyonKim: folds 
Espada Fish: folds 
Uncalled bet ($8.39) returned to SorinS28
SorinS28 collected $11.19 from pot
SorinS28: doesn't show hand 
*** SUMMARY ***
Total pot $11.78 | Rake $0.59 
Board [Kh 2d Tc Jh]
Seat 1: Espada Fish (big blind) folded on the Turn
Seat 2: SorinS28 collected ($11.19)
Seat 3: MaRKiToScoK folded before Flop (didn't bet)
Seat 4: GuigaMan folded before Flop (didn't bet)
Seat 5: XyonKim (button) folded on the Turn
Seat 6: CaHek-Ty3 (small blind) folded before Flop



PokerStars Hand #254221119270:  Hold'em No Limit ($0.50/$1.00 USD) - 2025/01/05 0:52:31 WET [2025/01/05 19:52:31 ET]
Table 'Winifred' 6-max Seat #6 is the button
Seat 1: Espada Fish ($100 in chips) 
Seat 2: SorinS28 ($108.69 in chips) 
Seat 3: MaRKiToScoK ($109.44 in chips) 
Seat 4: GuigaMan ($100 in chips) 
Seat 5: XyonKim ($70.99 in chips) 
Seat 6: CaHek-Ty3 ($100.50 in chips) 
Espada Fish: posts small blind $0.50
SorinS28: posts big blind $1
*** HOLE CARDS ***
MaRKiToScoK: raises $1.50 to $2.50
GuigaMan: folds 
XyonKim: calls $2.50
CaHek-Ty3: folds 
Espada Fish: folds 
SorinS28: folds 
*** FLOP *** [Kc 5c 6s]
MaRKiToScoK: checks 
XyonKim: bets $3
MaRKiToScoK: calls $3
*** TURN *** [Kc 5c 6s] [Ad]
MaRKiToScoK: checks 
XyonKim: bets $6
MaRKiToScoK: calls $6
*** RIVER *** [Kc 5c 6s Ad] [2d]
MaRKiToScoK: checks 
XyonKim: checks 
*** SHOW DOWN ***
MaRKiToScoK: shows [Qh Qd] (a pair of Queens)
XyonKim: shows [As Tc] (a pair of Aces)
XyonKim collected $23.28 from pot
*** SUMMARY ***
Total pot $24.50 | Rake $1.22 
Board [Kc 5c 6s Ad 2d]
Seat 1: Espada Fish (small blind) folded before Flop
Seat 2: SorinS28 (big blind) folded before Flop
Seat 3: MaRKiToScoK showed [Qh Qd] and lost with a pair of Queens
Seat 4: GuigaMan folded before Flop (didn't bet)
Seat 5: XyonKim showed [As Tc] and won ($23.28) with a pair of Aces
Seat 6: CaHek-Ty3 (button) folded before Flop (didn't bet)



PokerStars Hand #254221134777:  Hold'em No Limit ($0.50/$1.00 USD) - 2025/01/05 0:53:36 WET [2025/01/05 19:53:36 ET]
Table 'Winifred' 6-max Seat #1 is the button
Seat 1: Espada Fish ($100 in chips) 
Seat 2: SorinS28 ($107.69 in chips) 
Seat 3: MaRKiToScoK ($100 in chips) 
Seat 4: GuigaMan ($100 in chips) 
Seat 5: XyonKim ($82.77 in chips) 
Seat 6: CaHek-Ty3 ($100.50 in chips) 
SorinS28: posts small blind $0.50
MaRKiToScoK: posts big blind $1
*** HOLE CARDS ***
GuigaMan: folds 
XyonKim: folds 
CaHek-Ty3: folds 
Espada Fish: folds 
SorinS28: raises $2 to $3
MaRKiToScoK: raises $6 to $9
SorinS28: folds 
Uncalled bet ($6) returned to MaRKiToScoK
MaRKiToScoK collected $6 from pot
*** SUMMARY ***
Total pot $6 | Rake $0 
Seat 1: Espada Fish (button) folded before Flop (didn't bet)
Seat 2: SorinS28 (small blind) folded before Flop
Seat 3: MaRKiToScoK (big blind) collected ($6)
Seat 4: GuigaMan folded before Flop (didn't bet)
Seat 5: XyonKim folded before Flop (didn't bet)
Seat 6: CaHek-Ty3 folded before Flop (didn't bet)



PokerStars Hand #254221143320:  Hold'em No Limit ($0.50/$1.00 USD) - 2025/01/05 0:54:12 WET [2025/01/05 19:54:12 ET]
Table 'Winifred' 6-max Seat #2 is the button
Seat 1: Espada Fish ($100 in chips) 
Seat 2: SorinS28 ($104.69 in chips) 
Seat 3: MaRKiToScoK ($103 in chips) 
Seat 4: GuigaMan ($100 in chips) 
Seat 5: XyonKim ($82.77 in chips) 
Seat 6: CaHek-Ty3 ($100.50 in chips) 
MaRKiToScoK: posts small blind $0.50
GuigaMan: posts big blind $1
*** HOLE CARDS ***
XyonKim: calls $1
CaHek-Ty3: folds 
Espada Fish: folds 
SorinS28: folds 
MaRKiToScoK: folds 
GuigaMan: checks 
*** FLOP *** [8s 2s Ac]
GuigaMan: checks 
XyonKim: checks 
*** TURN *** [8s 2s Ac] [6s]
GuigaMan: checks 
XyonKim: bets $2.38
GuigaMan: folds 
Uncalled bet ($2.38) returned to XyonKim
XyonKim collected $2.38 from pot
*** SUMMARY ***
Total pot $2.50 | Rake $0.12 
Board [8s 2s Ac 6s]
Seat 1: Espada Fish folded before Flop (didn't bet)
Seat 2: SorinS28 (button) folded before Flop (didn't bet)
Seat 3: MaRKiToScoK (small blind) folded before Flop
Seat 4: GuigaMan (big blind) folded on the Turn
Seat 5: XyonKim collected ($2.38)
Seat 6: CaHek-Ty3 folded before Flop (didn't bet)



PokerStars Hand #254221152089:  Hold'em No Limit ($0.50/$1.00 USD) - 2025/01/05 0:54:50 WET [2025/01/05 19:54:50 ET]
Table 'Winifred' 6-max Seat #3 is the button
Seat 1: Espada Fish ($100 in chips) 
Seat 2: SorinS28 ($104.69 in chips) 
Seat 3: MaRKiToScoK ($102.50 in chips) 
Seat 4: GuigaMan ($100 in chips) 
Seat 5: XyonKim ($84.15 in chips) 
Seat 6: CaHek-Ty3 ($100.50 in chips) 
GuigaMan: posts small blind $0.50
XyonKim: posts big blind $1
*** HOLE CARDS ***
CaHek-Ty3: folds 
Espada Fish: raises $1.20 to $2.20
SorinS28: folds 
MaRKiToScoK: folds 
GuigaMan: folds 
XyonKim: folds 
Uncalled bet ($1.20) returned to Espada Fish
Espada Fish collected $2.50 from pot
Espada Fish: doesn't show hand 
*** SUMMARY ***
Total pot $2.50 | Rake $0 
Seat 1: Espada Fish collected ($2.50)
Seat 2: SorinS28 folded before Flop (didn't bet)
Seat 3: MaRKiToScoK (button) folded before Flop (didn't bet)
Seat 4: GuigaMan (small blind) folded before Flop
Seat 5: XyonKim (big blind) folded before Flop
Seat 6: CaHek-Ty3 folded before Flop (didn't bet)



PokerStars Hand #254221154997:  Hold'em No Limit ($0.50/$1.00 USD) - 2025/01/05 0:55:02 WET [2025/01/05 19:55:02 ET]
Table 'Winifred' 6-max Seat #4 is the button
Seat 1: Espada Fish ($101.50 in chips) is sitting out
Seat 6: CaHek-Ty3 ($100.50 in chips) is sitting out
Seat 2: SorinS28 ($104.69 in chips) 
Seat 3: MaRKiToScoK ($102.50 in chips) 
Seat 4: GuigaMan ($100 in chips) 
Seat 5: XyonKim ($83.15 in chips) 
XyonKim: posts small blind $0.50
CaHek-Ty3: is sitting out 
Espada Fish: is sitting out 
SorinS28: posts big blind $1
*** HOLE CARDS ***
MaRKiToScoK: raises $1.20 to $2.20
CaHek-Ty3 leaves the table
GuigaMan: folds 
XyonKim: folds 
SorinS28: folds 
Uncalled bet ($1.20) returned to MaRKiToScoK
Espada Fish leaves the table
MaRKiToScoK collected $2.50 from pot
*** SUMMARY ***
Total pot $2.50 | Rake $0 
Seat 1: Espada Fish
Seat 6: CaHek-Ty3
Seat 2: SorinS28 (big blind) folded before Flop
Seat 3: MaRKiToScoK collected ($2.50)
Seat 4: GuigaMan (button) folded before Flop (didn't bet)
Seat 5: XyonKim (small blind) folded before Flop



PokerStars Hand #254221157432:  Hold'em No Limit ($0.50/$1.00 USD) - 2025/01/05 0:55:13 WET [2025/01/05 19:55:13 ET]
Table 'Winifred' 6-max Seat #5 is the button
Seat 2: SorinS28 ($103.69 in chips) 
Seat 3: MaRKiToScoK ($104 in chips) 
Seat 4: GuigaMan ($100 in chips) 
Seat 5: XyonKim ($82.65 in chips) 
SorinS28: posts small blind $0.50
MaRKiToScoK: posts big blind $1
*** HOLE CARDS ***
GuigaMan: folds 
XyonKim: folds 
SorinS28: raises $2 to $3
MaRKiToScoK: folds 
Uncalled bet ($2) returned to SorinS28
SorinS28 collected $2 from pot
SorinS28: doesn't show hand 
*** SUMMARY ***
Total pot $2 | Rake $0 
Seat 2: SorinS28 (small blind) collected ($2)
Seat 3: MaRKiToScoK (big blind) folded before Flop
Seat 4: GuigaMan folded before Flop (didn't bet)
Seat 5: XyonKim (button) folded before Flop (didn't bet)



PokerStars Hand #254221159638:  Hold'em No Limit ($0.50/$1.00 USD) - 2025/01/05 0:55:26 WET [2025/01/05 19:55:26 ET]
Table 'Winifred' 6-max Seat #2 is the button
Seat 2: SorinS28 ($104.69 in chips) 
Seat 3: MaRKiToScoK ($103 in chips) 
Seat 4: GuigaMan ($100 in chips) 
Seat 5: XyonKim ($82.65 in chips) 
MaRKiToScoK: posts small blind $0.50
GuigaMan: posts big blind $1
*** HOLE CARDS ***
XyonKim: calls $1
SorinS28: folds 
MaRKiToScoK: calls $0.50
GuigaMan: checks 
*** FLOP *** [Qc 3d Jd]
MaRKiToScoK: checks 
GuigaMan: checks 
XyonKim: bets $2.85
MaRKiToScoK: folds 
GuigaMan: folds 
Uncalled bet ($2.85) returned to XyonKim
XyonKim collected $2.85 from pot
*** SUMMARY ***
Total pot $3 | Rake $0.15 
Board [Qc 3d Jd]
Seat 2: SorinS28 (button) folded before Flop (didn't bet)
Seat 3: MaRKiToScoK (small blind) folded on the Flop
Seat 4: GuigaMan (big blind) folded on the Flop
Seat 5: XyonKim collected ($2.85)



PokerStars Hand #254221434549:  Hold'em No Limit ($0.50/$1.00 USD) - 2025/01/05 1:17:06 WET [2025/01/05 20:17:06 ET]
Table 'Winifred' 6-max Seat #2 is the button
Seat 1: LuckyShikari ($108.76 in chips) 
Seat 2: GuigaMan ($112.68 in chips) 
Seat 5: slajjs ($24.68 in chips) 
slajjs: posts small blind $0.50
LuckyShikari: posts big blind $1
*** HOLE CARDS ***
GuigaMan: folds 
slajjs: raises $5 to $6
LuckyShikari: folds 
Uncalled bet ($5) returned to slajjs
slajjs collected $2 from pot
*** SUMMARY ***
Total pot $2 | Rake $0 
Seat 1: LuckyShikari (big blind) folded before Flop
Seat 2: GuigaMan (button) folded before Flop (didn't bet)
Seat 5: slajjs (small blind) collected ($2)



PokerStars Hand #254221438359:  Hold'em No Limit ($0.50/$1.00 USD) - 2025/01/05 1:17:23 WET [2025/01/05 20:17:23 ET]
Table 'Winifred' 6-max Seat #5 is the button
Seat 1: LuckyShikari ($107.76 in chips) 
Seat 2: GuigaMan ($112.68 in chips) 
Seat 5: slajjs ($25.68 in chips) 
LuckyShikari: posts small blind $0.50
GuigaMan: posts big blind $1
*** HOLE CARDS ***
slajjs: folds 
LuckyShikari: folds 
Uncalled bet ($0.50) returned to GuigaMan
GuigaMan collected $1 from pot
GuigaMan: doesn't show hand 
*** SUMMARY ***
Total pot $1 | Rake $0 
Seat 1: LuckyShikari (small blind) folded before Flop
Seat 2: GuigaMan (big blind) collected ($1)
Seat 5: slajjs (button) folded before Flop (didn't bet)



PokerStars Hand #254221440536:  Hold'em No Limit ($0.50/$1.00 USD) - 2025/01/05 1:17:33 WET [2025/01/05 20:17:33 ET]
Table 'Winifred' 6-max Seat #1 is the button
Seat 1: LuckyShikari ($107.26 in chips) 
Seat 2: GuigaMan ($113.18 in chips) 
Seat 5: slajjs ($25.68 in chips) 
GuigaMan: posts small blind $0.50
slajjs: posts big blind $1
*** HOLE CARDS ***
LuckyShikari: folds 
GuigaMan: folds 
Uncalled bet ($0.50) returned to slajjs
slajjs collected $1 from pot
*** SUMMARY ***
Total pot $1 | Rake $0 
Seat 1: LuckyShikari (button) folded before Flop (didn't bet)
Seat 2: GuigaMan (small blind) folded before Flop
Seat 5: slajjs (big blind) collected ($1)



PokerStars Hand #254221442117:  Hold'em No Limit ($0.50/$1.00 USD) - 2025/01/05 1:17:40 WET [2025/01/05 20:17:40 ET]
Table 'Winifred' 6-max Seat #2 is the button
Seat 1: LuckyShikari ($107.26 in chips) 
Seat 2: GuigaMan ($112.68 in chips) 
Seat 5: slajjs ($26.18 in chips) 
slajjs: posts small blind $0.50
LuckyShikari: posts big blind $1
*** HOLE CARDS ***
GuigaMan: raises $1.10 to $2.10
slajjs: raises $24.08 to $26.18 and is all-in
LuckyShikari: folds 
GuigaMan: folds 
Uncalled bet ($24.08) returned to slajjs
slajjs collected $5.20 from pot
*** SUMMARY ***
Total pot $5.20 | Rake $0 
Seat 1: LuckyShikari (big blind) folded before Flop
Seat 2: GuigaMan (button) folded before Flop
Seat 5: slajjs (small blind) collected ($5.20)



PokerStars Hand #254221444563:  Hold'em No Limit ($0.50/$1.00 USD) - 2025/01/05 1:17:51 WET [2025/01/05 20:17:51 ET]
Table 'Winifred' 6-max Seat #5 is the button
Seat 1: LuckyShikari ($106.26 in chips) 
Seat 2: GuigaMan ($110.58 in chips) 
Seat 5: slajjs ($29.28 in chips) 
LuckyShikari: posts small blind $0.50
GuigaMan: posts big blind $1
*** HOLE CARDS ***
slajjs: raises $6 to $7
LuckyShikari: folds 
GuigaMan: folds 
Uncalled bet ($6) returned to slajjs
slajjs collected $2.50 from pot
*** SUMMARY ***
Total pot $2.50 | Rake $0 
Seat 1: LuckyShikari (small blind) folded before Flop
Seat 2: GuigaMan (big blind) folded before Flop
Seat 5: slajjs (button) collected ($2.50)



PokerStars Hand #254221446938:  Hold'em No Limit ($0.50/$1.00 USD) - 2025/01/05 1:18:02 WET [2025/01/05 20:18:02 ET]
Table 'Winifred' 6-max Seat #1 is the button
Seat 1: LuckyShikari ($105.76 in chips) 
Seat 2: GuigaMan ($109.58 in chips) 
Seat 5: slajjs ($30.78 in chips) 
GuigaMan: posts small blind $0.50
slajjs: posts big blind $1
*** HOLE CARDS ***
LuckyShikari: raises $2.50 to $3.50
GuigaMan: calls $3
slajjs: calls $2.50
*** FLOP *** [Js As 4c]
GuigaMan: checks 
slajjs: checks 
LuckyShikari: checks 
*** TURN *** [Js As 4c] [Kd]
GuigaMan: bets $5.39
slajjs: folds 
LuckyShikari: raises $15.61 to $21
GuigaMan: calls $15.61
*** RIVER *** [Js As 4c Kd] [8c]
GuigaMan: checks 
LuckyShikari: bets $81.26 and is all-in
GuigaMan: calls $81.26
*** SHOW DOWN ***
LuckyShikari: shows [Qc Th] (a straight, Ten to Ace)
GuigaMan: shows [Jd Ah] (two pair, Aces and Jacks)
LuckyShikari collected $214.02 from pot
*** SUMMARY ***
Total pot $215.02 | Rake $1 
Board [Js As 4c Kd 8c]
Seat 1: LuckyShikari (button) showed [Qc Th] and won ($214.02) with a straight, Ten to Ace
Seat 2: GuigaMan (small blind) showed [Jd Ah] and lost with two pair, Aces and Jacks
Seat 5: slajjs (big blind) folded on the Turn



PokerStars Hand #254221456880:  Hold'em No Limit ($0.50/$1.00 USD) - 2025/01/05 1:18:48 WET [2025/01/05 20:18:48 ET]
Table 'Winifred' 6-max Seat #2 is the button
Seat 1: LuckyShikari ($214.02 in chips) 
Seat 2: GuigaMan ($100 in chips) 
Seat 5: slajjs ($27.28 in chips) 
slajjs: posts small blind $0.50
LuckyShikari: posts big blind $1
*** HOLE CARDS ***
GuigaMan: folds 
slajjs: raises $5 to $6
LuckyShikari: folds 
Uncalled bet ($5) returned to slajjs
slajjs collected $2 from pot
*** SUMMARY ***
Total pot $2 | Rake $0 
Seat 1: LuckyShikari (big blind) folded before Flop
Seat 2: GuigaMan (button) folded before Flop (didn't bet)
Seat 5: slajjs (small blind) collected ($2)



PokerStars Hand #254221459341:  Hold'em No Limit ($0.50/$1.00 USD) - 2025/01/05 1:18:59 WET [2025/01/05 20:18:59 ET]
Table 'Winifred' 6-max Seat #5 is the button
Seat 1: LuckyShikari ($213.02 in chips) 
Seat 2: GuigaMan ($100 in chips) 
Seat 5: slajjs ($28.28 in chips) 
LuckyShikari: posts small blind $0.50
GuigaMan: posts big blind $1
*** HOLE CARDS ***
slajjs: folds 
LuckyShikari: raises $2 to $3
GuigaMan: raises $6 to $9
LuckyShikari: folds 
Uncalled bet ($6) returned to GuigaMan
GuigaMan collected $6 from pot
GuigaMan: doesn't show hand 
*** SUMMARY ***
Total pot $6 | Rake $0 
Seat 1: LuckyShikari (small blind) folded before Flop
Seat 2: GuigaMan (big blind) collected ($6)
Seat 5: slajjs (button) folded before Flop (didn't bet)



PokerStars Hand #254221463191:  Hold'em No Limit ($0.50/$1.00 USD) - 2025/01/05 1:19:17 WET [2025/01/05 20:19:17 ET]
Table 'Winifred' 6-max Seat #1 is the button
Seat 1: LuckyShikari ($210.02 in chips) 
Seat 2: GuigaMan ($103 in chips) 
Seat 5: slajjs ($28.28 in chips) 
GuigaMan: posts small blind $0.50
slajjs: posts big blind $1
*** HOLE CARDS ***
LuckyShikari: folds 
GuigaMan: raises $1.50 to $2.50
slajjs: raises $25.78 to $28.28 and is all-in
GuigaMan: calls $25.78
*** FLOP *** [3c Tc 6s]
*** TURN *** [3c Tc 6s] [Th]
*** RIVER *** [3c Tc 6s Th] [Js]
*** SHOW DOWN ***
GuigaMan: shows [Ah Jd] (two pair, Jacks and Tens)
slajjs: shows [6d 7d] (two pair, Tens and Sixes)
GuigaMan collected $55.56 from pot
*** SUMMARY ***
Total pot $56.56 | Rake $1 
Board [3c Tc 6s Th Js]
Seat 1: LuckyShikari (button) folded before Flop (didn't bet)
Seat 2: GuigaMan (small blind) showed [Ah Jd] and won ($55.56) with two pair, Jacks and Tens
Seat 5: slajjs (big blind) showed [6d 7d] and lost with two pair, Tens and Sixes



PokerStars Hand #254221468750:  Hold'em No Limit ($0.50/$1.00 USD) - 2025/01/05 1:19:43 WET [2025/01/05 20:19:43 ET]
Table 'Winifred' 6-max Seat #2 is the button
Seat 5: slajjs ($0 in chips) is sitting out
Seat 1: LuckyShikari ($210.02 in chips) 
Seat 2: GuigaMan ($130.28 in chips) 
GuigaMan: posts small blind $0.50
LuckyShikari: posts big blind $1
*** HOLE CARDS ***
GuigaMan: folds 
Uncalled bet ($0.50) returned to LuckyShikari
LuckyShikari collected $1 from pot
LuckyShikari: doesn't show hand 
*** SUMMARY ***
Total pot $1 | Rake $0 
Seat 5: slajjs
Seat 1: LuckyShikari (big blind) collected ($1)
Seat 2: GuigaMan (button) (small blind) folded before Flop



PokerStars Hand #254221166147:  Hold'em No Limit ($0.50/$1.00 USD) - 2025/01/05 0:56:04 WET [2025/01/05 19:56:04 ET]
Table 'Winifred' 6-max Seat #3 is the button
Seat 2: SorinS28 ($104.69 in chips) 
Seat 3: MaRKiToScoK ($102 in chips) 
Seat 4: GuigaMan ($100 in chips) 
Seat 5: XyonKim ($84.50 in chips) 
GuigaMan: posts small blind $0.50
XyonKim: posts big blind $1
*** HOLE CARDS ***
SorinS28: raises $1.30 to $2.30
MaRKiToScoK: folds 
GuigaMan: folds 
XyonKim: folds 
Uncalled bet ($1.30) returned to SorinS28
SorinS28 collected $2.50 from pot
SorinS28: doesn't show hand 
*** SUMMARY ***
Total pot $2.50 | Rake $0 
Seat 2: SorinS28 collected ($2.50)
Seat 3: MaRKiToScoK (button) folded before Flop (didn't bet)
Seat 4: GuigaMan (small blind) folded before Flop
Seat 5: XyonKim (big blind) folded before Flop



PokerStars Hand #254221169781:  Hold'em No Limit ($0.50/$1.00 USD) - 2025/01/05 0:56:26 WET [2025/01/05 19:56:26 ET]
Table 'Winifred' 6-max Seat #4 is the button
Seat 2: SorinS28 ($106.19 in chips) is sitting out
Seat 3: MaRKiToScoK ($102 in chips) 
Seat 4: GuigaMan ($100 in chips) 
Seat 5: XyonKim ($83.50 in chips) 
XyonKim: posts small blind $0.50
SorinS28: is sitting out 
MaRKiToScoK: posts big blind $1
*** HOLE CARDS ***
ave_fenix800 joins the table at seat #1 
GuigaMan: raises $1.10 to $2.10
SorinS28 leaves the table
XyonKim: calls $1.60
MaRKiToScoK: calls $1.10
*** FLOP *** [7c 4s 2s]
XyonKim: checks 
MaRKiToScoK: checks 
GuigaMan: checks 
*** TURN *** [7c 4s 2s] [5c]
XyonKim: checks 
MaRKiToScoK: checks 
GuigaMan: checks 
*** RIVER *** [7c 4s 2s 5c] [Ah]
XyonKim: bets $3
MaRKiToScoK: folds 
GuigaMan: folds 
Uncalled bet ($3) returned to XyonKim
XyonKim collected $5.98 from pot
*** SUMMARY ***
Total pot $6.30 | Rake $0.32 
Board [7c 4s 2s 5c Ah]
Seat 2: SorinS28
Seat 3: MaRKiToScoK (big blind) folded on the River
Seat 4: GuigaMan (button) folded on the River
Seat 5: XyonKim (small blind) collected ($5.98)



PokerStars Hand #254221177380:  Hold'em No Limit ($0.50/$1.00 USD) - 2025/01/05 0:57:11 WET [2025/01/05 19:57:11 ET]
Table 'Winifred' 6-max Seat #5 is the button
Seat 1: ave_fenix800 ($100 in chips) is sitting out
Seat 3: MaRKiToScoK ($100 in chips) 
Seat 4: GuigaMan ($100 in chips) 
Seat 5: XyonKim ($87.38 in chips) 
MaRKiToScoK: posts small blind $0.50
GuigaMan: posts big blind $1
*** HOLE CARDS ***
XyonKim: folds 
MaRKiToScoK: folds 
Uncalled bet ($0.50) returned to GuigaMan
GuigaMan collected $1 from pot
GuigaMan: doesn't show hand 
*** SUMMARY ***
Total pot $1 | Rake $0 
Seat 1: ave_fenix800
Seat 3: MaRKiToScoK (small blind) folded before Flop
Seat 4: GuigaMan (big blind) collected ($1)
Seat 5: XyonKim (button) folded before Flop (didn't bet)



PokerStars Hand #254221179569:  Hold'em No Limit ($0.50/$1.00 USD) - 2025/01/05 0:57:23 WET [2025/01/05 19:57:23 ET]
Table 'Winifred' 6-max Seat #3 is the button
Seat 1: ave_fenix800 ($100 in chips) is sitting out
Seat 3: MaRKiToScoK ($100 in chips) 
Seat 4: GuigaMan ($100.50 in chips) 
Seat 5: XyonKim ($87.38 in chips) 
GuigaMan: posts small blind $0.50
XyonKim: posts big blind $1
ave_fenix800: sits out 
*** HOLE CARDS ***
MaRKiToScoK: raises $1.50 to $2.50
GuigaMan: folds 
XyonKim: calls $1.50
*** FLOP *** [4c Ts 3h]
XyonKim: checks 
MaRKiToScoK: bets $1.57
XyonKim: calls $1.57
*** TURN *** [4c Ts 3h] [6h]
XyonKim: checks 
MaRKiToScoK: checks 
*** RIVER *** [4c Ts 3h 6h] [9h]
XyonKim: checks 
NISIY joins the table at seat #6 
MaRKiToScoK: checks 
*** SHOW DOWN ***
XyonKim: shows [Ac 2c] (high card Ace)
MaRKiToScoK: shows [Ks 6s] (a pair of Sixes)
MaRKiToScoK collected $8.21 from pot
*** SUMMARY ***
Total pot $8.64 | Rake $0.43 
Board [4c Ts 3h 6h 9h]
Seat 1: ave_fenix800
Seat 3: MaRKiToScoK (button) showed [Ks 6s] and won ($8.21) with a pair of Sixes
Seat 4: GuigaMan (small blind) folded before Flop
Seat 5: XyonKim (big blind) showed [Ac 2c] and lost with high card Ace



PokerStars Hand #254221187306:  Hold'em No Limit ($0.50/$1.00 USD) - 2025/01/05 0:58:08 WET [2025/01/05 19:58:08 ET]
Table 'Winifred' 6-max Seat #4 is the button
Seat 1: ave_fenix800 ($100 in chips) is sitting out
Seat 3: MaRKiToScoK ($104.14 in chips) 
Seat 4: GuigaMan ($100 in chips) 
Seat 5: XyonKim ($83.31 in chips) 
Seat 6: NISIY ($100 in chips) 
XyonKim: posts small blind $0.50
NISIY: posts big blind $1
ave_fenix800: sits out 
*** HOLE CARDS ***
MaRKiToScoK: raises $1.20 to $2.20
GuigaMan: raises $4.80 to $7
XyonKim: folds 
NISIY: folds 
MaRKiToScoK: folds 
Uncalled bet ($4.80) returned to GuigaMan
GuigaMan collected $5.90 from pot
GuigaMan: doesn't show hand 
*** SUMMARY ***
Total pot $5.90 | Rake $0 
Seat 1: ave_fenix800
Seat 3: MaRKiToScoK folded before Flop
Seat 4: GuigaMan (button) collected ($5.90)
Seat 5: XyonKim (small blind) folded before Flop
Seat 6: NISIY (big blind) folded before Flop



PokerStars Hand #254221190023:  Hold'em No Limit ($0.50/$1.00 USD) - 2025/01/05 0:58:24 WET [2025/01/05 19:58:24 ET]
Table 'Winifred' 6-max Seat #5 is the button
Seat 1: ave_fenix800 ($100 in chips) 
Seat 3: MaRKiToScoK ($101.94 in chips) 
Seat 4: GuigaMan ($103.70 in chips) 
Seat 5: XyonKim ($82.81 in chips) 
Seat 6: NISIY ($100 in chips) 
NISIY: posts small blind $0.50
ave_fenix800: posts big blind $1
*** HOLE CARDS ***
MaRKiToScoK: raises $1.10 to $2.10
GuigaMan: folds 
XyonKim: raises $4.10 to $6.20
NISIY: folds 
ave_fenix800: folds 
MaRKiToScoK: folds 
Uncalled bet ($4.10) returned to XyonKim
XyonKim collected $5.70 from pot
*** SUMMARY ***
Total pot $5.70 | Rake $0 
Seat 1: ave_fenix800 (big blind) folded before Flop
Seat 3: MaRKiToScoK folded before Flop
Seat 4: GuigaMan folded before Flop (didn't bet)
Seat 5: XyonKim (button) collected ($5.70)
Seat 6: NISIY (small blind) folded before Flop



PokerStars Hand #254221194368:  Hold'em No Limit ($0.50/$1.00 USD) - 2025/01/05 0:58:49 WET [2025/01/05 19:58:49 ET]
Table 'Winifred' 6-max Seat #6 is the button
Seat 1: ave_fenix800 ($100 in chips) 
Seat 3: MaRKiToScoK ($100 in chips) 
Seat 4: GuigaMan ($103.70 in chips) 
Seat 5: XyonKim ($86.41 in chips) 
Seat 6: NISIY ($100 in chips) 
ave_fenix800: posts small blind $0.50
MaRKiToScoK: posts big blind $1
*** HOLE CARDS ***
GuigaMan: folds 
XyonKim: folds 
XyonKim leaves the table
NISIY: folds 
ave_fenix800: raises $2 to $3
MaRKiToScoK: calls $2
*** FLOP *** [7c 3c Ah]
ave_fenix800: bets $1.88
MaRKiToScoK: calls $1.88
*** TURN *** [7c 3c Ah] [5d]
ave_fenix800: checks 
MaRKiToScoK: bets $13.90
ave_fenix800: calls $13.90
*** RIVER *** [7c 3c Ah 5d] [6d]
ave_fenix800: checks 
MaRKiToScoK: checks 
*** SHOW DOWN ***
ave_fenix800: shows [As 9c] (a pair of Aces)
MaRKiToScoK: shows [7s 5h] (two pair, Sevens and Fives)
MaRKiToScoK collected $35.68 from pot
*** SUMMARY ***
Total pot $37.56 | Rake $1.88 
Board [7c 3c Ah 5d 6d]
Seat 1: ave_fenix800 (small blind) showed [As 9c] and lost with a pair of Aces
Seat 3: MaRKiToScoK (big blind) showed [7s 5h] and won ($35.68) with two pair, Sevens and Fives
Seat 4: GuigaMan folded before Flop (didn't bet)
Seat 5: XyonKim folded before Flop (didn't bet)
Seat 6: NISIY (button) folded before Flop (didn't bet)



PokerStars Hand #254221204415:  Hold'em No Limit ($0.50/$1.00 USD) - 2025/01/05 0:59:47 WET [2025/01/05 19:59:47 ET]
Table 'Winifred' 6-max Seat #1 is the button
Seat 1: ave_fenix800 ($100 in chips) 
Seat 3: MaRKiToScoK ($116.90 in chips) 
Seat 4: GuigaMan ($103.70 in chips) 
Seat 6: NISIY ($100 in chips) 
MaRKiToScoK: posts small blind $0.50
GuigaMan: posts big blind $1
*** HOLE CARDS ***
NISIY: folds 
ave_fenix800: folds 
MaRKiToScoK: folds 
Uncalled bet ($0.50) returned to GuigaMan
GuigaMan collected $1 from pot
GuigaMan: doesn't show hand 
*** SUMMARY ***
Total pot $1 | Rake $0 
Seat 1: ave_fenix800 (button) folded before Flop (didn't bet)
Seat 3: MaRKiToScoK (small blind) folded before Flop
Seat 4: GuigaMan (big blind) collected ($1)
Seat 6: NISIY folded before Flop (didn't bet)



PokerStars Hand #254221206290:  Hold'em No Limit ($0.50/$1.00 USD) - 2025/01/05 0:59:58 WET [2025/01/05 19:59:58 ET]
Table 'Winifred' 6-max Seat #3 is the button
Seat 6: NISIY ($100 in chips) is sitting out
Seat 1: ave_fenix800 ($100 in chips) 
Seat 3: MaRKiToScoK ($116.40 in chips) 
Seat 4: GuigaMan ($104.20 in chips) 
GuigaMan: posts small blind $0.50
NISIY: is sitting out 
ave_fenix800: posts big blind $1
*** HOLE CARDS ***
MaRKiToScoK: folds 
NISIY leaves the table
GuigaMan: raises $2 to $3
MaRKiToScoK leaves the table
ave_fenix800: folds 
Uncalled bet ($2) returned to GuigaMan
GuigaMan collected $2 from pot
GuigaMan: doesn't show hand 
*** SUMMARY ***
Total pot $2 | Rake $0 
Seat 6: NISIY
Seat 1: ave_fenix800 (big blind) folded before Flop
Seat 3: MaRKiToScoK (button) folded before Flop (didn't bet)
Seat 4: GuigaMan (small blind) collected ($2)



PokerStars Hand #254221319710:  Hold'em No Limit ($0.50/$1.00 USD) - 2025/01/05 1:08:31 WET [2025/01/05 20:08:31 ET]
Table 'Winifred' 6-max Seat #5 is the button
Seat 1: Manifestorr ($100 in chips) 
Seat 2: Rysiff ($100 in chips) 
Seat 3: XneferX ($100 in chips) 
Seat 5: slajjs ($41.32 in chips) 
Seat 6: Espada Fish ($101.50 in chips) 
Espada Fish: posts small blind $0.50
Manifestorr: posts big blind $1
*** HOLE CARDS ***
Rysiff: folds 
XneferX: raises $1.20 to $2.20
slajjs: folds 
Espada Fish is disconnected 
Espada Fish is connected 
Espada Fish: folds 
Manifestorr: folds 
Uncalled bet ($1.20) returned to XneferX
XneferX collected $2.50 from pot
XneferX: doesn't show hand 
*** SUMMARY ***
Total pot $2.50 | Rake $0 
Seat 1: Manifestorr (big blind) folded before Flop
Seat 2: Rysiff folded before Flop (didn't bet)
Seat 3: XneferX collected ($2.50)
Seat 5: slajjs (button) folded before Flop (didn't bet)
Seat 6: Espada Fish (small blind) folded before Flop



PokerStars Hand #254221327156:  Hold'em No Limit ($0.50/$1.00 USD) - 2025/01/05 1:09:04 WET [2025/01/05 20:09:04 ET]
Table 'Winifred' 6-max Seat #6 is the button
Seat 1: Manifestorr ($100 in chips) 
Seat 2: Rysiff ($100 in chips) 
Seat 3: XneferX ($101.50 in chips) 
Seat 5: slajjs ($41.32 in chips) 
Seat 6: Espada Fish ($101 in chips) 
Manifestorr: posts small blind $0.50
Rysiff: posts big blind $1
*** HOLE CARDS ***
XneferX: folds 
slajjs: folds 
Espada Fish: folds 
Manifestorr: raises $2 to $3
Rysiff: calls $2
*** FLOP *** [Kh 9c Tc]
Manifestorr: checks 
Rysiff: checks 
*** TURN *** [Kh 9c Tc] [Ad]
Manifestorr: checks 
Rysiff: bets $4.56
Manifestorr: folds 
Uncalled bet ($4.56) returned to Rysiff
Rysiff collected $5.70 from pot
Rysiff: doesn't show hand 
*** SUMMARY ***
Total pot $6 | Rake $0.30 
Board [Kh 9c Tc Ad]
Seat 1: Manifestorr (small blind) folded on the Turn
Seat 2: Rysiff (big blind) collected ($5.70)
Seat 3: XneferX folded before Flop (didn't bet)
Seat 5: slajjs folded before Flop (didn't bet)
Seat 6: Espada Fish (button) folded before Flop (didn't bet)



PokerStars Hand #254221339599:  Hold'em No Limit ($0.50/$1.00 USD) - 2025/01/05 1:09:59 WET [2025/01/05 20:09:59 ET]
Table 'Winifred' 6-max Seat #1 is the button
Seat 1: Manifestorr ($100 in chips) 
Seat 2: Rysiff ($102.70 in chips) 
Seat 3: XneferX ($101.50 in chips) 
Seat 5: slajjs ($41.32 in chips) 
Seat 6: Espada Fish ($101 in chips) 
Rysiff: posts small blind $0.50
XneferX: posts big blind $1
*** HOLE CARDS ***
slajjs: raises $2 to $3
Espada Fish: folds 
Manifestorr: folds 
Rysiff: folds 
XneferX: folds 
Uncalled bet ($2) returned to slajjs
slajjs collected $2.50 from pot
*** SUMMARY ***
Total pot $2.50 | Rake $0 
Seat 1: Manifestorr (button) folded before Flop (didn't bet)
Seat 2: Rysiff (small blind) folded before Flop
Seat 3: XneferX (big blind) folded before Flop
Seat 5: slajjs collected ($2.50)
Seat 6: Espada Fish folded before Flop (didn't bet)



PokerStars Hand #254221343035:  Hold'em No Limit ($0.50/$1.00 USD) - 2025/01/05 1:10:14 WET [2025/01/05 20:10:14 ET]
Table 'Winifred' 6-max Seat #2 is the button
Seat 1: Manifestorr ($100 in chips) 
Seat 2: Rysiff ($102.20 in chips) 
Seat 3: XneferX ($100.50 in chips) 
Seat 5: slajjs ($42.82 in chips) 
Seat 6: Espada Fish ($101 in chips) 
XneferX: posts small blind $0.50
slajjs: posts big blind $1
*** HOLE CARDS ***
Espada Fish: folds 
Manifestorr: folds 
Rysiff: raises $1.50 to $2.50
XneferX: folds 
slajjs: calls $1.50
*** FLOP *** [Jh Tc Td]
slajjs: checks 
Rysiff: bets $1.72
slajjs: calls $1.72
*** TURN *** [Jh Tc Td] [4c]
slajjs: checks 
Rysiff: bets $6.79
slajjs: folds 
Uncalled bet ($6.79) returned to Rysiff
Rysiff collected $8.49 from pot
Rysiff: doesn't show hand 
*** SUMMARY ***
Total pot $8.94 | Rake $0.45 
Board [Jh Tc Td 4c]
Seat 1: Manifestorr folded before Flop (didn't bet)
Seat 2: Rysiff (button) collected ($8.49)
Seat 3: XneferX (small blind) folded before Flop
Seat 5: slajjs (big blind) folded on the Turn
Seat 6: Espada Fish folded before Flop (didn't bet)



PokerStars Hand #254221352317:  Hold'em No Limit ($0.50/$1.00 USD) - 2025/01/05 1:10:55 WET [2025/01/05 20:10:55 ET]
Table 'Winifred' 6-max Seat #3 is the button
Seat 1: Manifestorr ($100 in chips) 
Seat 2: Rysiff ($106.47 in chips) 
Seat 3: XneferX ($100 in chips) 
Seat 5: slajjs ($38.60 in chips) 
Seat 6: Espada Fish ($101 in chips) 
slajjs: posts small blind $0.50
Espada Fish: posts big blind $1
*** HOLE CARDS ***
Manifestorr: folds 
Rysiff: raises $1.50 to $2.50
XneferX: folds 
slajjs: folds 
Espada Fish: folds 
Uncalled bet ($1.50) returned to Rysiff
Rysiff collected $2.50 from pot
Rysiff: doesn't show hand 
*** SUMMARY ***
Total pot $2.50 | Rake $0 
Seat 1: Manifestorr folded before Flop (didn't bet)
Seat 2: Rysiff collected ($2.50)
Seat 3: XneferX (button) folded before Flop (didn't bet)
Seat 5: slajjs (small blind) folded before Flop
Seat 6: Espada Fish (big blind) folded before Flop



PokerStars Hand #254221354919:  Hold'em No Limit ($0.50/$1.00 USD) - 2025/01/05 1:11:07 WET [2025/01/05 20:11:07 ET]
Table 'Winifred' 6-max Seat #5 is the button
Seat 1: Manifestorr ($100 in chips) is sitting out
Seat 2: Rysiff ($107.97 in chips) is sitting out
Seat 3: XneferX ($100 in chips) 
Seat 5: slajjs ($38.10 in chips) 
Seat 6: Espada Fish ($100 in chips) 
Espada Fish: posts small blind $0.50
Manifestorr: is sitting out 
Rysiff: is sitting out 
XneferX: posts big blind $1
*** HOLE CARDS ***
slajjs: folds 
Rysiff leaves the table
Manifestorr leaves the table
Espada Fish: raises $2 to $3
XneferX: calls $2
*** FLOP *** [6h 9d 7c]
Espada Fish: checks 
XneferX: bets $2.91
Espada Fish: raises $8.52 to $11.43
LuckyShikari joins the table at seat #1 
GuigaMan joins the table at seat #2 
XneferX: calls $8.52
*** TURN *** [6h 9d 7c] [2d]
Espada Fish: checks 
XneferX: checks 
*** RIVER *** [6h 9d 7c 2d] [Kd]
Espada Fish: checks 
XneferX: checks 
*** SHOW DOWN ***
Espada Fish: shows [8h Qh] (high card King)
XneferX: shows [6d 7h] (two pair, Sevens and Sixes)
XneferX collected $27.86 from pot
*** SUMMARY ***
Total pot $28.86 | Rake $1 
Board [6h 9d 7c 2d Kd]
Seat 1: Manifestorr
Seat 2: Rysiff
Seat 3: XneferX (big blind) showed [6d 7h] and won ($27.86) with two pair, Sevens and Sixes
Seat 5: slajjs (button) folded before Flop (didn't bet)
Seat 6: Espada Fish (small blind) showed [8h Qh] and lost with high card King



PokerStars Hand #254221378993:  Hold'em No Limit ($0.50/$1.00 USD) - 2025/01/05 1:12:55 WET [2025/01/05 20:12:55 ET]
Table 'Winifred' 6-max Seat #6 is the button
Seat 1: LuckyShikari ($100 in chips) is sitting out
Seat 2: GuigaMan ($105.20 in chips) is sitting out
Seat 3: XneferX ($113.43 in chips) 
Seat 5: slajjs ($38.10 in chips) 
Seat 6: Espada Fish ($100 in chips) 
XneferX: posts small blind $0.50
slajjs: posts big blind $1
*** HOLE CARDS ***
Espada Fish: folds 
XneferX: folds 
Uncalled bet ($0.50) returned to slajjs
slajjs collected $1 from pot
*** SUMMARY ***
Total pot $1 | Rake $0 
Seat 1: LuckyShikari
Seat 2: GuigaMan
Seat 3: XneferX (small blind) folded before Flop
Seat 5: slajjs (big blind) collected ($1)
Seat 6: Espada Fish (button) folded before Flop (didn't bet)



PokerStars Hand #254221380473:  Hold'em No Limit ($0.50/$1.00 USD) - 2025/01/05 1:13:02 WET [2025/01/05 20:13:02 ET]
Table 'Winifred' 6-max Seat #3 is the button
Seat 1: LuckyShikari ($100 in chips) is sitting out
Seat 2: GuigaMan ($105.20 in chips) is sitting out
Seat 3: XneferX ($112.93 in chips) 
Seat 5: slajjs ($38.60 in chips) 
Seat 6: Espada Fish ($100 in chips) 
slajjs: posts small blind $0.50
Espada Fish: posts big blind $1
LuckyShikari: sits out 
GuigaMan: sits out 
*** HOLE CARDS ***
XneferX: folds 
slajjs: folds 
Uncalled bet ($0.50) returned to Espada Fish
Espada Fish collected $1 from pot
Espada Fish: doesn't show hand 
*** SUMMARY ***
Total pot $1 | Rake $0 
Seat 1: LuckyShikari
Seat 2: GuigaMan
Seat 3: XneferX (button) folded before Flop (didn't bet)
Seat 5: slajjs (small blind) folded before Flop
Seat 6: Espada Fish (big blind) collected ($1)



PokerStars Hand #254221382204:  Hold'em No Limit ($0.50/$1.00 USD) - 2025/01/05 1:13:10 WET [2025/01/05 20:13:10 ET]
Table 'Winifred' 6-max Seat #5 is the button
Seat 2: GuigaMan ($105.20 in chips) is sitting out
Seat 1: LuckyShikari ($100 in chips) 
Seat 3: XneferX ($112.93 in chips) 
Seat 5: slajjs ($38.10 in chips) 
Seat 6: Espada Fish ($100.50 in chips) 
Espada Fish: posts small blind $0.50
LuckyShikari: posts big blind $1
GuigaMan: sits out 
*** HOLE CARDS ***
XneferX: folds 
slajjs: folds 
Espada Fish: folds 
Uncalled bet ($0.50) returned to LuckyShikari
LuckyShikari collected $1 from pot
LuckyShikari: doesn't show hand 
*** SUMMARY ***
Total pot $1 | Rake $0 
Seat 2: GuigaMan
Seat 1: LuckyShikari (big blind) collected ($1)
Seat 3: XneferX folded before Flop (didn't bet)
Seat 5: slajjs (button) folded before Flop (didn't bet)
Seat 6: Espada Fish (small blind) folded before Flop



PokerStars Hand #254221384663:  Hold'em No Limit ($0.50/$1.00 USD) - 2025/01/05 1:13:20 WET [2025/01/05 20:13:20 ET]
Table 'Winifred' 6-max Seat #6 is the button
Seat 1: LuckyShikari ($100.50 in chips) 
Seat 2: GuigaMan ($105.20 in chips) 
Seat 3: XneferX ($112.93 in chips) 
Seat 5: slajjs ($38.10 in chips) 
Seat 6: Espada Fish ($100 in chips) 
LuckyShikari: posts small blind $0.50
GuigaMan: posts big blind $1
*** HOLE CARDS ***
XneferX: raises $1.20 to $2.20
slajjs: raises $6.80 to $9
Espada Fish: folds 
LuckyShikari: folds 
GuigaMan: folds 
XneferX: folds 
Uncalled bet ($6.80) returned to slajjs
slajjs collected $5.90 from pot
*** SUMMARY ***
Total pot $5.90 | Rake $0 
Seat 1: LuckyShikari (small blind) folded before Flop
Seat 2: GuigaMan (big blind) folded before Flop
Seat 3: XneferX folded before Flop
Seat 5: slajjs collected ($5.90)
Seat 6: Espada Fish (button) folded before Flop (didn't bet)



PokerStars Hand #254221387668:  Hold'em No Limit ($0.50/$1.00 USD) - 2025/01/05 1:13:35 WET [2025/01/05 20:13:35 ET]
Table 'Winifred' 6-max Seat #1 is the button
Seat 3: XneferX ($110.73 in chips) is sitting out
Seat 1: LuckyShikari ($100 in chips) 
Seat 2: GuigaMan ($104.20 in chips) 
Seat 5: slajjs ($41.80 in chips) 
Seat 6: Espada Fish ($100 in chips) 
GuigaMan: posts small blind $0.50
XneferX: is sitting out 
slajjs: posts big blind $1
*** HOLE CARDS ***
XneferX leaves the table
Espada Fish: raises $1.20 to $2.20
LuckyShikari: raises $5.90 to $8.10
GuigaMan: folds 
slajjs: folds 
Espada Fish: folds 
Uncalled bet ($5.90) returned to LuckyShikari
LuckyShikari collected $5.90 from pot
LuckyShikari: doesn't show hand 
*** SUMMARY ***
Total pot $5.90 | Rake $0 
Seat 3: XneferX
Seat 1: LuckyShikari (button) collected ($5.90)
Seat 2: GuigaMan (small blind) folded before Flop
Seat 5: slajjs (big blind) folded before Flop
Seat 6: Espada Fish folded before Flop



PokerStars Hand #254221392355:  Hold'em No Limit ($0.50/$1.00 USD) - 2025/01/05 1:13:56 WET [2025/01/05 20:13:56 ET]
Table 'Winifred' 6-max Seat #2 is the button
Seat 6: Espada Fish ($100 in chips) is sitting out
Seat 1: LuckyShikari ($103.70 in chips) 
Seat 2: GuigaMan ($103.70 in chips) 
Seat 5: slajjs ($40.80 in chips) 
slajjs: posts small blind $0.50
Espada Fish: is sitting out 
LuckyShikari: posts big blind $1
*** HOLE CARDS ***
GuigaMan: folds 
Espada Fish leaves the table
slajjs: calls $0.50
LuckyShikari: checks 
*** FLOP *** [Ac Qs Ts]
slajjs: bets $1
LuckyShikari: calls $1
*** TURN *** [Ac Qs Ts] [Kd]
slajjs: bets $1.90
LuckyShikari: calls $1.90
*** RIVER *** [Ac Qs Ts Kd] [2c]
slajjs: checks 
LuckyShikari: checks 
*** SHOW DOWN ***
slajjs: shows [8h 6s] (high card Ace)
LuckyShikari: shows [7s Qd] (a pair of Queens)
LuckyShikari collected $7.41 from pot
*** SUMMARY ***
Total pot $7.80 | Rake $0.39 
Board [Ac Qs Ts Kd 2c]
Seat 6: Espada Fish
Seat 1: LuckyShikari (big blind) showed [7s Qd] and won ($7.41) with a pair of Queens
Seat 2: GuigaMan (button) folded before Flop (didn't bet)
Seat 5: slajjs (small blind) showed [8h 6s] and lost with high card Ace



PokerStars Hand #254221399535:  Hold'em No Limit ($0.50/$1.00 USD) - 2025/01/05 1:14:29 WET [2025/01/05 20:14:29 ET]
Table 'Winifred' 6-max Seat #5 is the button
Seat 1: LuckyShikari ($107.21 in chips) 
Seat 2: GuigaMan ($103.70 in chips) 
Seat 5: slajjs ($36.90 in chips) 
LuckyShikari: posts small blind $0.50
GuigaMan: posts big blind $1
*** HOLE CARDS ***
slajjs: folds 
LuckyShikari: folds 
Uncalled bet ($0.50) returned to GuigaMan
GuigaMan collected $1 from pot
GuigaMan: doesn't show hand 
*** SUMMARY ***
Total pot $1 | Rake $0 
Seat 1: LuckyShikari (small blind) folded before Flop
Seat 2: GuigaMan (big blind) collected ($1)
Seat 5: slajjs (button) folded before Flop (didn't bet)



PokerStars Hand #254221401756:  Hold'em No Limit ($0.50/$1.00 USD) - 2025/01/05 1:14:40 WET [2025/01/05 20:14:40 ET]
Table 'Winifred' 6-max Seat #1 is the button
Seat 1: LuckyShikari ($106.71 in chips) 
Seat 2: GuigaMan ($104.20 in chips) 
Seat 5: slajjs ($36.90 in chips) 
GuigaMan: posts small blind $0.50
slajjs: posts big blind $1
*** HOLE CARDS ***
LuckyShikari: folds 
GuigaMan: raises $1.50 to $2.50
slajjs: calls $1.50
*** FLOP *** [8s 4c Ah]
GuigaMan: checks 
slajjs: checks 
*** TURN *** [8s 4c Ah] [Tc]
GuigaMan: bets $3.56
slajjs: folds 
Uncalled bet ($3.56) returned to GuigaMan
GuigaMan collected $4.75 from pot
GuigaMan: doesn't show hand 
*** SUMMARY ***
Total pot $5 | Rake $0.25 
Board [8s 4c Ah Tc]
Seat 1: LuckyShikari (button) folded before Flop (didn't bet)
Seat 2: GuigaMan (small blind) collected ($4.75)
Seat 5: slajjs (big blind) folded on the Turn



PokerStars Hand #254221405522:  Hold'em No Limit ($0.50/$1.00 USD) - 2025/01/05 1:14:56 WET [2025/01/05 20:14:56 ET]
Table 'Winifred' 6-max Seat #2 is the button
Seat 1: LuckyShikari ($106.71 in chips) 
Seat 2: GuigaMan ($106.45 in chips) 
Seat 5: slajjs ($34.40 in chips) 
slajjs: posts small blind $0.50
LuckyShikari: posts big blind $1
*** HOLE CARDS ***
GuigaMan: raises $1.10 to $2.10
slajjs: raises $5.20 to $7.30
LuckyShikari: folds 
GuigaMan: folds 
Uncalled bet ($5.20) returned to slajjs
slajjs collected $5.20 from pot
*** SUMMARY ***
Total pot $5.20 | Rake $0 
Seat 1: LuckyShikari (big blind) folded before Flop
Seat 2: GuigaMan (button) folded before Flop
Seat 5: slajjs (small blind) collected ($5.20)



PokerStars Hand #254221408063:  Hold'em No Limit ($0.50/$1.00 USD) - 2025/01/05 1:15:08 WET [2025/01/05 20:15:08 ET]
Table 'Winifred' 6-max Seat #5 is the button
Seat 1: LuckyShikari ($105.71 in chips) 
Seat 2: GuigaMan ($104.35 in chips) 
Seat 5: slajjs ($37.50 in chips) 
LuckyShikari: posts small blind $0.50
GuigaMan: posts big blind $1
*** HOLE CARDS ***
slajjs: calls $1
LuckyShikari: folds 
GuigaMan: checks 
*** FLOP *** [6c 9c 2s]
GuigaMan: checks 
slajjs: checks 
*** TURN *** [6c 9c 2s] [Jc]
GuigaMan: checks 
slajjs: bets $1.19
GuigaMan: folds 
Uncalled bet ($1.19) returned to slajjs
slajjs collected $2.38 from pot
*** SUMMARY ***
Total pot $2.50 | Rake $0.12 
Board [6c 9c 2s Jc]
Seat 1: LuckyShikari (small blind) folded before Flop
Seat 2: GuigaMan (big blind) folded on the Turn
Seat 5: slajjs (button) collected ($2.38)



PokerStars Hand #254221412677:  Hold'em No Limit ($0.50/$1.00 USD) - 2025/01/05 1:15:28 WET [2025/01/05 20:15:28 ET]
Table 'Winifred' 6-max Seat #1 is the button
Seat 1: LuckyShikari ($105.21 in chips) 
Seat 2: GuigaMan ($103.35 in chips) 
Seat 5: slajjs ($38.88 in chips) 
GuigaMan: posts small blind $0.50
slajjs: posts big blind $1
*** HOLE CARDS ***
LuckyShikari: folds 
GuigaMan: raises $2 to $3
slajjs: calls $2
*** FLOP *** [4d 3d Ac]
GuigaMan: checks 
slajjs: bets $5.70
GuigaMan: raises $94.65 to $100.35 and is all-in
slajjs: folds 
Uncalled bet ($94.65) returned to GuigaMan
GuigaMan collected $16.53 from pot
GuigaMan: doesn't show hand 
*** SUMMARY ***
Total pot $17.40 | Rake $0.87 
Board [4d 3d Ac]
Seat 1: LuckyShikari (button) folded before Flop (didn't bet)
Seat 2: GuigaMan (small blind) collected ($16.53)
Seat 5: slajjs (big blind) folded on the Flop



PokerStars Hand #254221419693:  Hold'em No Limit ($0.50/$1.00 USD) - 2025/01/05 1:16:00 WET [2025/01/05 20:16:00 ET]
Table 'Winifred' 6-max Seat #2 is the button
Seat 1: LuckyShikari ($105.21 in chips) 
Seat 2: GuigaMan ($111.18 in chips) 
Seat 5: slajjs ($30.18 in chips) 
slajjs: posts small blind $0.50
LuckyShikari: posts big blind $1
*** HOLE CARDS ***
GuigaMan: folds 
slajjs: calls $0.50
LuckyShikari: raises $3.50 to $4.50
slajjs: calls $3.50
*** FLOP *** [Qs 7s Ac]
slajjs: checks 
LuckyShikari: checks 
*** TURN *** [Qs 7s Ac] [8d]
slajjs: checks 
LuckyShikari: checks 
*** RIVER *** [Qs 7s Ac 8d] [Qc]
slajjs: checks 
LuckyShikari: checks 
*** SHOW DOWN ***
slajjs: shows [4s 6s] (a pair of Queens)
LuckyShikari: shows [Kd 8h] (two pair, Queens and Eights)
LuckyShikari collected $8.55 from pot
*** SUMMARY ***
Total pot $9 | Rake $0.45 
Board [Qs 7s Ac 8d Qc]
Seat 1: LuckyShikari (big blind) showed [Kd 8h] and won ($8.55) with two pair, Queens and Eights
Seat 2: GuigaMan (button) folded before Flop (didn't bet)
Seat 5: slajjs (small blind) showed [4s 6s] and lost with a pair of Queens



PokerStars Hand #254221429983:  Hold'em No Limit ($0.50/$1.00 USD) - 2025/01/05 1:16:46 WET [2025/01/05 20:16:46 ET]
Table 'Winifred' 6-max Seat #5 is the button
Seat 1: LuckyShikari ($109.26 in chips) 
Seat 2: GuigaMan ($111.18 in chips) 
Seat 5: slajjs ($25.68 in chips) 
LuckyShikari: posts small blind $0.50
GuigaMan: posts big blind $1
*** HOLE CARDS ***
slajjs: folds 
LuckyShikari: folds 
Uncalled bet ($0.50) returned to GuigaMan
GuigaMan collected $1 from pot
GuigaMan: doesn't show hand 
*** SUMMARY ***
Total pot $1 | Rake $0 
Seat 1: LuckyShikari (small blind) folded before Flop
Seat 2: GuigaMan (big blind) collected ($1)
Seat 5: slajjs (button) folded before Flop (didn't bet)



PokerStars Hand #254221432062:  Hold'em No Limit ($0.50/$1.00 USD) - 2025/01/05 1:16:55 WET [2025/01/05 20:16:55 ET]
Table 'Winifred' 6-max Seat #1 is the button
Seat 1: LuckyShikari ($108.76 in chips) 
Seat 2: GuigaMan ($111.68 in chips) 
Seat 5: slajjs ($25.68 in chips) 
GuigaMan: posts small blind $0.50
slajjs: posts big blind $1
*** HOLE CARDS ***
LuckyShikari: folds 
GuigaMan: raises $1.10 to $2.10
slajjs: folds 
Uncalled bet ($1.10) returned to GuigaMan
GuigaMan collected $2 from pot
GuigaMan: doesn't show hand 
*** SUMMARY ***
Total pot $2 | Rake $0 
Seat 1: LuckyShikari (button) folded before Flop (didn't bet)
Seat 2: GuigaMan (small blind) collected ($2)
Seat 5: slajjs (big blind) folded before Flop



