PokerStars Hand #254734656409:  Hold'em No Limit ($0.50/$1.00 USD) - 2025/02/06 15:55:22 WET [2025/02/06 10:55:22 ET]
Table 'Ascanios II' 6-max Seat #2 is the button
Seat 2: coeeeelho ($100 in chips) 
Seat 3: Espada Fish ($100 in chips) 
coeeeelho: posts small blind $0.50
Espada Fish: posts big blind $1
*** HOLE CARDS ***
coeeeelho: raises $1.50 to $2.50
Espada Fish: raises $9.50 to $12
coeeeelho: calls $9.50
*** FLOP *** [8s 7c Jc]
Espada Fish: bets $11.50
coeeeelho: calls $11.50
*** TURN *** [8s 7c Jc] [5s]
Espada Fish: checks 
coeeeelho: bets $15
Bessie0009 joins the table at seat #1 
Bessie0009 is disconnected 
Espada Fish: raises $61.50 to $76.50 and is all-in
coeeeelho: folds 
Uncalled bet ($61.50) returned to Espada Fish
Espada Fish collected $76 from pot
Espada Fish: doesn't show hand 
*** SUMMARY ***
Total pot $77 | Rake $1 
Board [8s 7c Jc 5s]
Seat 2: coeeeelho (button) (small blind) folded on the Turn
Seat 3: Espada Fish (big blind) collected ($76)



PokerStars Hand #254734667607:  Hold'em No Limit ($0.50/$1.00 USD) - 2025/02/06 15:56:34 WET [2025/02/06 10:56:34 ET]
Table 'Ascanios II' 6-max Seat #3 is the button
Seat 1: Bessie0009 ($19.32 in chips) is sitting out
Seat 2: coeeeelho ($100 in chips) 
Seat 3: Espada Fish ($137.50 in chips) 
Espada Fish: posts small blind $0.50
coeeeelho: posts big blind $1
*** HOLE CARDS ***
Espada Fish: raises $1.50 to $2.50
coeeeelho: folds 
Uncalled bet ($1.50) returned to Espada Fish
Espada Fish collected $2 from pot
Espada Fish: doesn't show hand 
*** SUMMARY ***
Total pot $2 | Rake $0 
Seat 1: Bessie0009
Seat 2: coeeeelho (big blind) folded before Flop
Seat 3: Espada Fish (button) (small blind) collected ($2)



PokerStars Hand #254734668878:  Hold'em No Limit ($0.50/$1.00 USD) - 2025/02/06 15:56:42 WET [2025/02/06 10:56:42 ET]
Table 'Ascanios II' 6-max Seat #2 is the button
Seat 1: Bessie0009 ($19.32 in chips) is sitting out
Seat 2: coeeeelho ($100 in chips) 
Seat 3: Espada Fish ($138.50 in chips) 
coeeeelho: posts small blind $0.50
Espada Fish: posts big blind $1
*** HOLE CARDS ***
coeeeelho: raises $1.50 to $2.50
Espada Fish: calls $1.50
*** FLOP *** [Ts Th 6s]
Espada Fish: checks 
coeeeelho: bets $1
Espada Fish: calls $1
*** TURN *** [Ts Th 6s] [As]
Espada Fish: checks 
coeeeelho: checks 
*** RIVER *** [Ts Th 6s As] [Kh]
RAidakCo joins the table at seat #4 
Espada Fish: bets $2.19
coeeeelho: calls $2.19
*** SHOW DOWN ***
Espada Fish: shows [7s Js] (a flush, Ace high)
coeeeelho: mucks hand 
Espada Fish collected $10.81 from pot
*** SUMMARY ***
Total pot $11.38 | Rake $0.57 
Board [Ts Th 6s As Kh]
Seat 1: Bessie0009
Seat 2: coeeeelho (button) (small blind) mucked
Seat 3: Espada Fish (big blind) showed [7s Js] and won ($10.81) with a flush, Ace high



PokerStars Hand #254734680040:  Hold'em No Limit ($0.50/$1.00 USD) - 2025/02/06 15:57:53 WET [2025/02/06 10:57:53 ET]
Table 'Ascanios II' 6-max Seat #2 is the button
Seat 1: Bessie0009 ($19.32 in chips) is sitting out
Seat 2: coeeeelho ($100 in chips) 
Seat 3: Espada Fish ($143.62 in chips) 
Seat 4: RAidakCo ($100 in chips) 
Espada Fish: posts small blind $0.50
RAidakCo: posts big blind $1
*** HOLE CARDS ***
coeeeelho: folds 
Espada Fish: folds 
Uncalled bet ($0.50) returned to RAidakCo
RAidakCo collected $1 from pot
RAidakCo: doesn't show hand 
*** SUMMARY ***
Total pot $1 | Rake $0 
Seat 1: Bessie0009
Seat 2: coeeeelho (button) folded before Flop (didn't bet)
Seat 3: Espada Fish (small blind) folded before Flop
Seat 4: RAidakCo (big blind) collected ($1)



PokerStars Hand #254734681380:  Hold'em No Limit ($0.50/$1.00 USD) - 2025/02/06 15:58:01 WET [2025/02/06 10:58:01 ET]
Table 'Ascanios II' 6-max Seat #3 is the button
Seat 1: Bessie0009 ($19.32 in chips) 
Seat 2: coeeeelho ($100 in chips) 
Seat 3: Espada Fish ($143.12 in chips) 
Seat 4: RAidakCo ($100.50 in chips) 
RAidakCo: posts small blind $0.50
Bessie0009: posts big blind $1
*** HOLE CARDS ***
coeeeelho: folds 
CichiChanMarian joins the table at seat #6 
AlexEliseev7 joins the table at seat #5 
Espada Fish: raises $1.50 to $2.50
RAidakCo: folds 
Bessie0009: calls $1.50
*** FLOP *** [Ah 6c 7s]
Bessie0009: checks 
Espada Fish: bets $1.72
Bessie0009: folds 
Uncalled bet ($1.72) returned to Espada Fish
Espada Fish collected $5.22 from pot
Espada Fish: doesn't show hand 
*** SUMMARY ***
Total pot $5.50 | Rake $0.28 
Board [Ah 6c 7s]
Seat 1: Bessie0009 (big blind) folded on the Flop
Seat 2: coeeeelho folded before Flop (didn't bet)
Seat 3: Espada Fish (button) collected ($5.22)
Seat 4: RAidakCo (small blind) folded before Flop



PokerStars Hand #254734686573:  Hold'em No Limit ($0.50/$1.00 USD) - 2025/02/06 15:58:34 WET [2025/02/06 10:58:34 ET]
Table 'Ascanios II' 6-max Seat #4 is the button
Seat 5: AlexEliseev7 ($100 in chips) is sitting out
Seat 6: CichiChanMarian ($100 in chips) is sitting out
Seat 1: Bessie0009 ($16.82 in chips) 
Seat 2: coeeeelho ($100 in chips) 
Seat 3: Espada Fish ($145.84 in chips) 
Seat 4: RAidakCo ($100 in chips) 
Bessie0009: posts small blind $0.50
coeeeelho: posts big blind $1
*** HOLE CARDS ***
Espada Fish: folds 
RAidakCo: raises $1.50 to $2.50
Bessie0009: folds 
coeeeelho: folds 
Uncalled bet ($1.50) returned to RAidakCo
RAidakCo collected $2.50 from pot
RAidakCo: doesn't show hand 
*** SUMMARY ***
Total pot $2.50 | Rake $0 
Seat 5: AlexEliseev7
Seat 6: CichiChanMarian
Seat 1: Bessie0009 (small blind) folded before Flop
Seat 2: coeeeelho (big blind) folded before Flop
Seat 3: Espada Fish folded before Flop (didn't bet)
Seat 4: RAidakCo (button) collected ($2.50)



PokerStars Hand #254734689000:  Hold'em No Limit ($0.50/$1.00 USD) - 2025/02/06 15:58:49 WET [2025/02/06 10:58:49 ET]
Table 'Ascanios II' 6-max Seat #1 is the button
Seat 5: AlexEliseev7 ($100 in chips) is sitting out
Seat 6: CichiChanMarian ($100 in chips) is sitting out
Seat 1: Bessie0009 ($16.32 in chips) 
Seat 2: coeeeelho ($100 in chips) 
Seat 3: Espada Fish ($145.84 in chips) 
Seat 4: RAidakCo ($101.50 in chips) 
coeeeelho: posts small blind $0.50
Espada Fish: posts big blind $1
AlexEliseev7: sits out 
CichiChanMarian: sits out 
*** HOLE CARDS ***
RAidakCo: folds 
Bessie0009: raises $2.50 to $3.50
coeeeelho: folds 
Espada Fish: folds 
Uncalled bet ($2.50) returned to Bessie0009
Bessie0009 collected $2.50 from pot
*** SUMMARY ***
Total pot $2.50 | Rake $0 
Seat 5: AlexEliseev7
Seat 6: CichiChanMarian
Seat 1: Bessie0009 (button) collected ($2.50)
Seat 2: coeeeelho (small blind) folded before Flop
Seat 3: Espada Fish (big blind) folded before Flop
Seat 4: RAidakCo folded before Flop (didn't bet)



PokerStars Hand #254734691817:  Hold'em No Limit ($0.50/$1.00 USD) - 2025/02/06 15:59:07 WET [2025/02/06 10:59:07 ET]
Table 'Ascanios II' 6-max Seat #2 is the button
Seat 5: AlexEliseev7 ($100 in chips) is sitting out
Seat 6: CichiChanMarian ($100 in chips) is sitting out
Seat 1: Bessie0009 ($17.82 in chips) 
Seat 2: coeeeelho ($100 in chips) 
Seat 3: Espada Fish ($144.84 in chips) 
Seat 4: RAidakCo ($101.50 in chips) 
Espada Fish: posts small blind $0.50
RAidakCo: posts big blind $1
AlexEliseev7: sits out 
CichiChanMarian: sits out 
*** HOLE CARDS ***
Bessie0009: folds 
coeeeelho: raises $1.50 to $2.50
Espada Fish: folds 
RAidakCo: raises $10.50 to $13
coeeeelho: folds 
Uncalled bet ($10.50) returned to RAidakCo
RAidakCo collected $5.50 from pot
RAidakCo: doesn't show hand 
*** SUMMARY ***
Total pot $5.50 | Rake $0 
Seat 5: AlexEliseev7
Seat 6: CichiChanMarian
Seat 1: Bessie0009 folded before Flop (didn't bet)
Seat 2: coeeeelho (button) folded before Flop
Seat 3: Espada Fish (small blind) folded before Flop
Seat 4: RAidakCo (big blind) collected ($5.50)



PokerStars Hand #254734695844:  Hold'em No Limit ($0.50/$1.00 USD) - 2025/02/06 15:59:32 WET [2025/02/06 10:59:32 ET]
Table 'Ascanios II' 6-max Seat #3 is the button
Seat 6: CichiChanMarian ($100 in chips) is sitting out
Seat 1: Bessie0009 ($17.82 in chips) 
Seat 2: coeeeelho ($100 in chips) 
Seat 3: Espada Fish ($144.34 in chips) 
Seat 4: RAidakCo ($104.50 in chips) 
Seat 5: AlexEliseev7 ($100 in chips) 
RAidakCo: posts small blind $0.50
AlexEliseev7: posts big blind $1
CichiChanMarian: sits out 
*** HOLE CARDS ***
Bessie0009: folds 
coeeeelho: folds 
Espada Fish: raises $1.50 to $2.50
RAidakCo: folds 
AlexEliseev7: folds 
Uncalled bet ($1.50) returned to Espada Fish
Espada Fish collected $2.50 from pot
Espada Fish: doesn't show hand 
*** SUMMARY ***
Total pot $2.50 | Rake $0 
Seat 6: CichiChanMarian
Seat 1: Bessie0009 folded before Flop (didn't bet)
Seat 2: coeeeelho folded before Flop (didn't bet)
Seat 3: Espada Fish (button) collected ($2.50)
Seat 4: RAidakCo (small blind) folded before Flop
Seat 5: AlexEliseev7 (big blind) folded before Flop



PokerStars Hand #254734700228:  Hold'em No Limit ($0.50/$1.00 USD) - 2025/02/06 15:59:59 WET [2025/02/06 10:59:59 ET]
Table 'Ascanios II' 6-max Seat #4 is the button
Seat 1: Bessie0009 ($17.82 in chips) 
Seat 2: coeeeelho ($100 in chips) 
Seat 3: Espada Fish ($145.84 in chips) 
Seat 4: RAidakCo ($104 in chips) 
Seat 5: AlexEliseev7 ($100 in chips) 
Seat 6: CichiChanMarian ($100 in chips) 
AlexEliseev7: posts small blind $0.50
CichiChanMarian: posts big blind $1
*** HOLE CARDS ***
Bessie0009: folds 
coeeeelho: raises $1.10 to $2.10
Espada Fish: folds 
RAidakCo: folds 
AlexEliseev7: folds 
CichiChanMarian: folds 
Uncalled bet ($1.10) returned to coeeeelho
coeeeelho collected $2.50 from pot
*** SUMMARY ***
Total pot $2.50 | Rake $0 
Seat 1: Bessie0009 folded before Flop (didn't bet)
Seat 2: coeeeelho collected ($2.50)
Seat 3: Espada Fish folded before Flop (didn't bet)
Seat 4: RAidakCo (button) folded before Flop (didn't bet)
Seat 5: AlexEliseev7 (small blind) folded before Flop
Seat 6: CichiChanMarian (big blind) folded before Flop



PokerStars Hand #254734705193:  Hold'em No Limit ($0.50/$1.00 USD) - 2025/02/06 16:00:30 WET [2025/02/06 11:00:30 ET]
Table 'Ascanios II' 6-max Seat #5 is the button
Seat 1: Bessie0009 ($17.82 in chips) 
Seat 2: coeeeelho ($101.50 in chips) 
Seat 3: Espada Fish ($145.84 in chips) 
Seat 4: RAidakCo ($104 in chips) 
Seat 5: AlexEliseev7 ($100 in chips) 
Seat 6: CichiChanMarian ($100 in chips) 
CichiChanMarian: posts small blind $0.50
Bessie0009: posts big blind $1
*** HOLE CARDS ***
coeeeelho: folds 
Espada Fish: folds 
RAidakCo: raises $1.20 to $2.20
AlexEliseev7: folds 
CichiChanMarian: raises $8.80 to $11
Bessie0009: folds 
RAidakCo: calls $8.80
*** FLOP *** [5c 3h Ad]
CichiChanMarian: checks 
RAidakCo: bets $7.21
CichiChanMarian: folds 
Uncalled bet ($7.21) returned to RAidakCo
RAidakCo collected $21.85 from pot
RAidakCo: doesn't show hand 
*** SUMMARY ***
Total pot $23 | Rake $1.15 
Board [5c 3h Ad]
Seat 1: Bessie0009 (big blind) folded before Flop
Seat 2: coeeeelho folded before Flop (didn't bet)
Seat 3: Espada Fish folded before Flop (didn't bet)
Seat 4: RAidakCo collected ($21.85)
Seat 5: AlexEliseev7 (button) folded before Flop (didn't bet)
Seat 6: CichiChanMarian (small blind) folded on the Flop



PokerStars Hand #254734718961:  Hold'em No Limit ($0.50/$1.00 USD) - 2025/02/06 16:01:42 WET [2025/02/06 11:01:42 ET]
Table 'Ascanios II' 6-max Seat #6 is the button
Seat 1: Bessie0009 ($16.82 in chips) 
Seat 2: coeeeelho ($101.50 in chips) 
Seat 3: Espada Fish ($145.84 in chips) 
Seat 4: RAidakCo ($114.85 in chips) 
Seat 5: AlexEliseev7 ($100 in chips) 
Seat 6: CichiChanMarian ($100 in chips) 
Bessie0009: posts small blind $0.50
coeeeelho: posts big blind $1
*** HOLE CARDS ***
Espada Fish: folds 
RAidakCo: folds 
AlexEliseev7: raises $1.50 to $2.50
CichiChanMarian: folds 
Bessie0009: folds 
coeeeelho: folds 
Uncalled bet ($1.50) returned to AlexEliseev7
AlexEliseev7 collected $2.50 from pot
AlexEliseev7: doesn't show hand 
*** SUMMARY ***
Total pot $2.50 | Rake $0 
Seat 1: Bessie0009 (small blind) folded before Flop
Seat 2: coeeeelho (big blind) folded before Flop
Seat 3: Espada Fish folded before Flop (didn't bet)
Seat 4: RAidakCo folded before Flop (didn't bet)
Seat 5: AlexEliseev7 collected ($2.50)
Seat 6: CichiChanMarian (button) folded before Flop (didn't bet)



PokerStars Hand #254734725655:  Hold'em No Limit ($0.50/$1.00 USD) - 2025/02/06 16:02:13 WET [2025/02/06 11:02:13 ET]
Table 'Ascanios II' 6-max Seat #1 is the button
Seat 1: Bessie0009 ($16.32 in chips) 
Seat 2: coeeeelho ($100.50 in chips) 
Seat 3: Espada Fish ($145.84 in chips) 
Seat 4: RAidakCo ($114.85 in chips) 
Seat 5: AlexEliseev7 ($101.50 in chips) 
Seat 6: CichiChanMarian ($100 in chips) 
coeeeelho: posts small blind $0.50
Espada Fish: posts big blind $1
*** HOLE CARDS ***
RAidakCo: folds 
AlexEliseev7: folds 
CichiChanMarian: folds 
Bessie0009: raises $2.50 to $3.50
coeeeelho: folds 
Espada Fish: folds 
Uncalled bet ($2.50) returned to Bessie0009
Bessie0009 collected $2.50 from pot
*** SUMMARY ***
Total pot $2.50 | Rake $0 
Seat 1: Bessie0009 (button) collected ($2.50)
Seat 2: coeeeelho (small blind) folded before Flop
Seat 3: Espada Fish (big blind) folded before Flop
Seat 4: RAidakCo folded before Flop (didn't bet)
Seat 5: AlexEliseev7 folded before Flop (didn't bet)
Seat 6: CichiChanMarian folded before Flop (didn't bet)



PokerStars Hand #254734731456:  Hold'em No Limit ($0.50/$1.00 USD) - 2025/02/06 16:02:42 WET [2025/02/06 11:02:42 ET]
Table 'Ascanios II' 6-max Seat #2 is the button
Seat 1: Bessie0009 ($17.82 in chips) 
Seat 2: coeeeelho ($100 in chips) 
Seat 3: Espada Fish ($144.84 in chips) 
Seat 4: RAidakCo ($114.85 in chips) 
Seat 5: AlexEliseev7 ($101.50 in chips) 
Seat 6: CichiChanMarian ($100 in chips) 
Espada Fish: posts small blind $0.50
RAidakCo: posts big blind $1
*** HOLE CARDS ***
AlexEliseev7: raises $1.50 to $2.50
CichiChanMarian: folds 
Bessie0009: folds 
coeeeelho: folds 
Espada Fish: folds 
RAidakCo: calls $1.50
*** FLOP *** [2c 7d 4s]
RAidakCo: checks 
AlexEliseev7: bets $4.07
RAidakCo: raises $7.93 to $12
AlexEliseev7: folds 
Uncalled bet ($7.93) returned to RAidakCo
RAidakCo collected $12.96 from pot
RAidakCo: doesn't show hand 
*** SUMMARY ***
Total pot $13.64 | Rake $0.68 
Board [2c 7d 4s]
Seat 1: Bessie0009 folded before Flop (didn't bet)
Seat 2: coeeeelho (button) folded before Flop (didn't bet)
Seat 3: Espada Fish (small blind) folded before Flop
Seat 4: RAidakCo (big blind) collected ($12.96)
Seat 5: AlexEliseev7 folded on the Flop
Seat 6: CichiChanMarian folded before Flop (didn't bet)



PokerStars Hand #254734740258:  Hold'em No Limit ($0.50/$1.00 USD) - 2025/02/06 16:03:24 WET [2025/02/06 11:03:24 ET]
Table 'Ascanios II' 6-max Seat #3 is the button
Seat 1: Bessie0009 ($17.82 in chips) 
Seat 2: coeeeelho ($100 in chips) 
Seat 3: Espada Fish ($144.34 in chips) 
Seat 4: RAidakCo ($121.24 in chips) 
Seat 5: AlexEliseev7 ($100 in chips) 
Seat 6: CichiChanMarian ($100 in chips) 
RAidakCo: posts small blind $0.50
AlexEliseev7: posts big blind $1
*** HOLE CARDS ***
CichiChanMarian: folds 
Bessie0009: raises $2.50 to $3.50
coeeeelho: folds 
Espada Fish: folds 
RAidakCo: folds 
AlexEliseev7: folds 
Uncalled bet ($2.50) returned to Bessie0009
Bessie0009 collected $2.50 from pot
*** SUMMARY ***
Total pot $2.50 | Rake $0 
Seat 1: Bessie0009 collected ($2.50)
Seat 2: coeeeelho folded before Flop (didn't bet)
Seat 3: Espada Fish (button) folded before Flop (didn't bet)
Seat 4: RAidakCo (small blind) folded before Flop
Seat 5: AlexEliseev7 (big blind) folded before Flop
Seat 6: CichiChanMarian folded before Flop (didn't bet)



PokerStars Hand #254734745462:  Hold'em No Limit ($0.50/$1.00 USD) - 2025/02/06 16:03:49 WET [2025/02/06 11:03:49 ET]
Table 'Ascanios II' 6-max Seat #4 is the button
Seat 1: Bessie0009 ($19.32 in chips) 
Seat 2: coeeeelho ($100 in chips) 
Seat 3: Espada Fish ($144.34 in chips) 
Seat 4: RAidakCo ($120.74 in chips) 
Seat 5: AlexEliseev7 ($100 in chips) 
Seat 6: CichiChanMarian ($100 in chips) 
AlexEliseev7: posts small blind $0.50
CichiChanMarian: posts big blind $1
*** HOLE CARDS ***
Bessie0009: folds 
coeeeelho: folds 
Espada Fish: raises $1.20 to $2.20
RAidakCo: folds 
AlexEliseev7: folds 
CichiChanMarian: folds 
Uncalled bet ($1.20) returned to Espada Fish
Espada Fish collected $2.50 from pot
Espada Fish: doesn't show hand 
*** SUMMARY ***
Total pot $2.50 | Rake $0 
Seat 1: Bessie0009 folded before Flop (didn't bet)
Seat 2: coeeeelho folded before Flop (didn't bet)
Seat 3: Espada Fish collected ($2.50)
Seat 4: RAidakCo (button) folded before Flop (didn't bet)
Seat 5: AlexEliseev7 (small blind) folded before Flop
Seat 6: CichiChanMarian (big blind) folded before Flop



PokerStars Hand #254734751154:  Hold'em No Limit ($0.50/$1.00 USD) - 2025/02/06 16:04:17 WET [2025/02/06 11:04:17 ET]
Table 'Ascanios II' 6-max Seat #5 is the button
Seat 1: Bessie0009 ($19.32 in chips) is sitting out
Seat 2: coeeeelho ($100 in chips) 
Seat 3: Espada Fish ($145.84 in chips) 
Seat 4: RAidakCo ($120.74 in chips) 
Seat 5: AlexEliseev7 ($100 in chips) 
Seat 6: CichiChanMarian ($100 in chips) 
CichiChanMarian: posts small blind $0.50
Bessie0009: is sitting out 
coeeeelho: posts big blind $1
*** HOLE CARDS ***
Espada Fish: folds 
RAidakCo: folds 
AlexEliseev7: folds 
CichiChanMarian: raises $2 to $3
coeeeelho: folds 
Uncalled bet ($2) returned to CichiChanMarian
CichiChanMarian collected $2 from pot
CichiChanMarian: doesn't show hand 
*** SUMMARY ***
Total pot $2 | Rake $0 
Seat 1: Bessie0009
Seat 2: coeeeelho (big blind) folded before Flop
Seat 3: Espada Fish folded before Flop (didn't bet)
Seat 4: RAidakCo folded before Flop (didn't bet)
Seat 5: AlexEliseev7 (button) folded before Flop (didn't bet)
Seat 6: CichiChanMarian (small blind) collected ($2)



PokerStars Hand #254734755806:  Hold'em No Limit ($0.50/$1.00 USD) - 2025/02/06 16:04:39 WET [2025/02/06 11:04:39 ET]
Table 'Ascanios II' 6-max Seat #6 is the button
Seat 1: Bessie0009 ($19.32 in chips) is sitting out
Seat 2: coeeeelho ($100 in chips) 
Seat 3: Espada Fish ($145.84 in chips) 
Seat 4: RAidakCo ($120.74 in chips) 
Seat 5: AlexEliseev7 ($100 in chips) 
Seat 6: CichiChanMarian ($101 in chips) 
coeeeelho: posts small blind $0.50
Espada Fish: posts big blind $1
*** HOLE CARDS ***
RAidakCo: raises $1.20 to $2.20
AlexEliseev7: folds 
CichiChanMarian: folds 
coeeeelho: folds 
Espada Fish: calls $1.20
*** FLOP *** [4h 2c Ks]
Espada Fish: checks 
RAidakCo: bets $1.54
Espada Fish: calls $1.54
*** TURN *** [4h 2c Ks] [8s]
Espada Fish: checks 
RAidakCo: bets $11.37
Espada Fish: calls $11.37
*** RIVER *** [4h 2c Ks 8s] [Qs]
Bessie0009 is disconnected 
Espada Fish: checks 
RAidakCo: checks 
*** SHOW DOWN ***
Espada Fish: shows [Qd Kc] (two pair, Kings and Queens)
RAidakCo: mucks hand 
Espada Fish collected $29.18 from pot
*** SUMMARY ***
Total pot $30.72 | Rake $1.54 
Board [4h 2c Ks 8s Qs]
Seat 1: Bessie0009
Seat 2: coeeeelho (small blind) folded before Flop
Seat 3: Espada Fish (big blind) showed [Qd Kc] and won ($29.18) with two pair, Kings and Queens
Seat 4: RAidakCo mucked
Seat 5: AlexEliseev7 folded before Flop (didn't bet)
Seat 6: CichiChanMarian (button) folded before Flop (didn't bet)



PokerStars Hand #254734772636:  Hold'em No Limit ($0.50/$1.00 USD) - 2025/02/06 16:05:59 WET [2025/02/06 11:05:59 ET]
Table 'Ascanios II' 6-max Seat #2 is the button
Seat 1: Bessie0009 ($19.32 in chips) is sitting out
Seat 2: coeeeelho ($100 in chips) 
Seat 3: Espada Fish ($159.91 in chips) 
Seat 4: RAidakCo ($105.63 in chips) 
Seat 5: AlexEliseev7 ($100 in chips) 
Seat 6: CichiChanMarian ($101 in chips) 
Espada Fish: posts small blind $0.50
RAidakCo: posts big blind $1
Bessie0009: sits out 
*** HOLE CARDS ***
AlexEliseev7: raises $1.50 to $2.50
CichiChanMarian: folds 
coeeeelho: raises $5 to $7.50
Espada Fish: folds 
RAidakCo: folds 
AlexEliseev7: raises $14 to $21.50
coeeeelho: folds 
Uncalled bet ($14) returned to AlexEliseev7
AlexEliseev7 collected $16.50 from pot
AlexEliseev7: doesn't show hand 
*** SUMMARY ***
Total pot $16.50 | Rake $0 
Seat 1: Bessie0009
Seat 2: coeeeelho (button) folded before Flop
Seat 3: Espada Fish (small blind) folded before Flop
Seat 4: RAidakCo (big blind) folded before Flop
Seat 5: AlexEliseev7 collected ($16.50)
Seat 6: CichiChanMarian folded before Flop (didn't bet)



PokerStars Hand #254734782113:  Hold'em No Limit ($0.50/$1.00 USD) - 2025/02/06 16:06:44 WET [2025/02/06 11:06:44 ET]
Table 'Ascanios II' 6-max Seat #3 is the button
Seat 1: Bessie0009 ($19.32 in chips) is sitting out
Seat 2: coeeeelho ($100 in chips) 
Seat 3: Espada Fish ($159.41 in chips) 
Seat 4: RAidakCo ($104.63 in chips) 
Seat 5: AlexEliseev7 ($109 in chips) 
Seat 6: CichiChanMarian ($101 in chips) 
RAidakCo: posts small blind $0.50
AlexEliseev7: posts big blind $1
Bessie0009: sits out 
*** HOLE CARDS ***
CichiChanMarian: folds 
coeeeelho: folds 
Espada Fish: folds 
RAidakCo: raises $2 to $3
AlexEliseev7: calls $2
*** FLOP *** [2h 5s 3c]
RAidakCo: checks 
AlexEliseev7: checks 
*** TURN *** [2h 5s 3c] [Kh]
RAidakCo: bets $8.55
AlexEliseev7: folds 
Uncalled bet ($8.55) returned to RAidakCo
RAidakCo collected $5.70 from pot
RAidakCo: doesn't show hand 
*** SUMMARY ***
Total pot $6 | Rake $0.30 
Board [2h 5s 3c Kh]
Seat 1: Bessie0009
Seat 2: coeeeelho folded before Flop (didn't bet)
Seat 3: Espada Fish (button) folded before Flop (didn't bet)
Seat 4: RAidakCo (small blind) collected ($5.70)
Seat 5: AlexEliseev7 (big blind) folded on the Turn
Seat 6: CichiChanMarian folded before Flop (didn't bet)



PokerStars Hand #254734788852:  Hold'em No Limit ($0.50/$1.00 USD) - 2025/02/06 16:07:17 WET [2025/02/06 11:07:17 ET]
Table 'Ascanios II' 6-max Seat #4 is the button
Seat 1: Bessie0009 ($19.32 in chips) is sitting out
Seat 2: coeeeelho ($100 in chips) 
Seat 3: Espada Fish ($159.41 in chips) 
Seat 4: RAidakCo ($107.33 in chips) 
Seat 5: AlexEliseev7 ($106 in chips) 
Seat 6: CichiChanMarian ($101 in chips) 
AlexEliseev7: posts small blind $0.50
CichiChanMarian: posts big blind $1
Bessie0009: sits out 
*** HOLE CARDS ***
coeeeelho: folds 
Espada Fish: raises $1.20 to $2.20
RAidakCo: folds 
AlexEliseev7: folds 
CichiChanMarian: folds 
Uncalled bet ($1.20) returned to Espada Fish
Espada Fish collected $2.50 from pot
Espada Fish: doesn't show hand 
*** SUMMARY ***
Total pot $2.50 | Rake $0 
Seat 1: Bessie0009
Seat 2: coeeeelho folded before Flop (didn't bet)
Seat 3: Espada Fish collected ($2.50)
Seat 4: RAidakCo (button) folded before Flop (didn't bet)
Seat 5: AlexEliseev7 (small blind) folded before Flop
Seat 6: CichiChanMarian (big blind) folded before Flop



PokerStars Hand #254734794259:  Hold'em No Limit ($0.50/$1.00 USD) - 2025/02/06 16:07:43 WET [2025/02/06 11:07:43 ET]
Table 'Ascanios II' 6-max Seat #5 is the button
Seat 1: Bessie0009 ($19.32 in chips) 
Seat 2: coeeeelho ($100 in chips) 
Seat 3: Espada Fish ($160.91 in chips) 
Seat 4: RAidakCo ($107.33 in chips) 
Seat 5: AlexEliseev7 ($105.50 in chips) 
Seat 6: CichiChanMarian ($100 in chips) 
CichiChanMarian: posts small blind $0.50
Bessie0009: posts big blind $1
*** HOLE CARDS ***
coeeeelho: raises $1.10 to $2.10
Espada Fish: folds 
RAidakCo: folds 
AlexEliseev7: folds 
CichiChanMarian: folds 
Bessie0009: raises $4.70 to $6.80
coeeeelho: calls $4.70
*** FLOP *** [Ts Jd Ah]
Bessie0009: bets $12.52 and is all-in
coeeeelho: folds 
Uncalled bet ($12.52) returned to Bessie0009
Bessie0009 collected $13.40 from pot
*** SUMMARY ***
Total pot $14.10 | Rake $0.70 
Board [Ts Jd Ah]
Seat 1: Bessie0009 (big blind) collected ($13.40)
Seat 2: coeeeelho folded on the Flop
Seat 3: Espada Fish folded before Flop (didn't bet)
Seat 4: RAidakCo folded before Flop (didn't bet)
Seat 5: AlexEliseev7 (button) folded before Flop (didn't bet)
Seat 6: CichiChanMarian (small blind) folded before Flop



PokerStars Hand #254734799992:  Hold'em No Limit ($0.50/$1.00 USD) - 2025/02/06 16:08:10 WET [2025/02/06 11:08:10 ET]
Table 'Ascanios II' 6-max Seat #6 is the button
Seat 1: Bessie0009 ($25.92 in chips) 
Seat 2: coeeeelho ($100 in chips) 
Seat 3: Espada Fish ($160.91 in chips) 
Seat 4: RAidakCo ($107.33 in chips) 
Seat 5: AlexEliseev7 ($105.50 in chips) 
Seat 6: CichiChanMarian ($100 in chips) 
Bessie0009: posts small blind $0.50
coeeeelho: posts big blind $1
*** HOLE CARDS ***
Espada Fish: folds 
RAidakCo: folds 
AlexEliseev7: folds 
CichiChanMarian: folds 
Bessie0009: calls $0.50
coeeeelho: checks 
*** FLOP *** [2s Qd Qc]
Bessie0009: checks 
coeeeelho: checks 
*** TURN *** [2s Qd Qc] [Jd]
Bessie0009: bets $1.90
coeeeelho: raises $1.90 to $3.80
Bessie0009: folds 
Uncalled bet ($1.90) returned to coeeeelho
coeeeelho collected $5.51 from pot
*** SUMMARY ***
Total pot $5.80 | Rake $0.29 
Board [2s Qd Qc Jd]
Seat 1: Bessie0009 (small blind) folded on the Turn
Seat 2: coeeeelho (big blind) collected ($5.51)
Seat 3: Espada Fish folded before Flop (didn't bet)
Seat 4: RAidakCo folded before Flop (didn't bet)
Seat 5: AlexEliseev7 folded before Flop (didn't bet)
Seat 6: CichiChanMarian (button) folded before Flop (didn't bet)



PokerStars Hand #254734805321:  Hold'em No Limit ($0.50/$1.00 USD) - 2025/02/06 16:08:36 WET [2025/02/06 11:08:36 ET]
Table 'Ascanios II' 6-max Seat #1 is the button
Seat 1: Bessie0009 ($23.02 in chips) 
Seat 2: coeeeelho ($102.61 in chips) 
Seat 3: Espada Fish ($160.91 in chips) 
Seat 4: RAidakCo ($107.33 in chips) 
Seat 5: AlexEliseev7 ($105.50 in chips) 
Seat 6: CichiChanMarian ($100 in chips) 
coeeeelho: posts small blind $0.50
Espada Fish: posts big blind $1
*** HOLE CARDS ***
RAidakCo: raises $1 to $2
AlexEliseev7: folds 
CichiChanMarian: folds 
Bessie0009: calls $2
coeeeelho: folds 
Espada Fish: calls $1
*** FLOP *** [3c 8c 4c]
Espada Fish: checks 
RAidakCo: checks 
Bessie0009: bets $6.18
Espada Fish: folds 
RAidakCo: folds 
Uncalled bet ($6.18) returned to Bessie0009
Bessie0009 collected $6.18 from pot
*** SUMMARY ***
Total pot $6.50 | Rake $0.32 
Board [3c 8c 4c]
Seat 1: Bessie0009 (button) collected ($6.18)
Seat 2: coeeeelho (small blind) folded before Flop
Seat 3: Espada Fish (big blind) folded on the Flop
Seat 4: RAidakCo folded on the Flop
Seat 5: AlexEliseev7 folded before Flop (didn't bet)
Seat 6: CichiChanMarian folded before Flop (didn't bet)



PokerStars Hand #254734813727:  Hold'em No Limit ($0.50/$1.00 USD) - 2025/02/06 16:09:16 WET [2025/02/06 11:09:16 ET]
Table 'Ascanios II' 6-max Seat #2 is the button
Seat 1: Bessie0009 ($27.20 in chips) 
Seat 2: coeeeelho ($102.11 in chips) 
Seat 3: Espada Fish ($158.91 in chips) 
Seat 4: RAidakCo ($105.33 in chips) 
Seat 5: AlexEliseev7 ($105.50 in chips) 
Seat 6: CichiChanMarian ($100 in chips) 
Espada Fish: posts small blind $0.50
RAidakCo: posts big blind $1
*** HOLE CARDS ***
AlexEliseev7: raises $1.50 to $2.50
CichiChanMarian: folds 
Bessie0009: folds 
coeeeelho: folds 
Espada Fish: folds 
RAidakCo: folds 
Uncalled bet ($1.50) returned to AlexEliseev7
AlexEliseev7 collected $2.50 from pot
AlexEliseev7: doesn't show hand 
*** SUMMARY ***
Total pot $2.50 | Rake $0 
Seat 1: Bessie0009 folded before Flop (didn't bet)
Seat 2: coeeeelho (button) folded before Flop (didn't bet)
Seat 3: Espada Fish (small blind) folded before Flop
Seat 4: RAidakCo (big blind) folded before Flop
Seat 5: AlexEliseev7 collected ($2.50)
Seat 6: CichiChanMarian folded before Flop (didn't bet)



PokerStars Hand #254734816622:  Hold'em No Limit ($0.50/$1.00 USD) - 2025/02/06 16:09:29 WET [2025/02/06 11:09:29 ET]
Table 'Ascanios II' 6-max Seat #3 is the button
Seat 1: Bessie0009 ($27.20 in chips) 
Seat 2: coeeeelho ($102.11 in chips) 
Seat 3: Espada Fish ($158.41 in chips) 
Seat 4: RAidakCo ($104.33 in chips) 
Seat 5: AlexEliseev7 ($107 in chips) 
Seat 6: CichiChanMarian ($100 in chips) 
RAidakCo: posts small blind $0.50
AlexEliseev7: posts big blind $1
*** HOLE CARDS ***
CichiChanMarian: folds 
Bessie0009: calls $1
coeeeelho: raises $3 to $4
Espada Fish: folds 
RAidakCo: folds 
AlexEliseev7: folds 
Bessie0009: calls $3
*** FLOP *** [Ah 4h Th]
Bessie0009: checks 
coeeeelho: bets $2
Bessie0009: folds 
Uncalled bet ($2) returned to coeeeelho
coeeeelho collected $9.02 from pot
*** SUMMARY ***
Total pot $9.50 | Rake $0.48 
Board [Ah 4h Th]
Seat 1: Bessie0009 folded on the Flop
Seat 2: coeeeelho collected ($9.02)
Seat 3: Espada Fish (button) folded before Flop (didn't bet)
Seat 4: RAidakCo (small blind) folded before Flop
Seat 5: AlexEliseev7 (big blind) folded before Flop
Seat 6: CichiChanMarian folded before Flop (didn't bet)



PokerStars Hand #254734829063:  Hold'em No Limit ($0.50/$1.00 USD) - 2025/02/06 16:10:27 WET [2025/02/06 11:10:27 ET]
Table 'Ascanios II' 6-max Seat #4 is the button
Seat 1: Bessie0009 ($23.20 in chips) 
Seat 2: coeeeelho ($107.13 in chips) 
Seat 3: Espada Fish ($158.41 in chips) 
Seat 4: RAidakCo ($103.83 in chips) 
Seat 5: AlexEliseev7 ($106 in chips) 
Seat 6: CichiChanMarian ($100 in chips) 
AlexEliseev7: posts small blind $0.50
CichiChanMarian: posts big blind $1
*** HOLE CARDS ***
Bessie0009: folds 
coeeeelho: folds 
Espada Fish: folds 
RAidakCo: folds 
AlexEliseev7: folds 
Uncalled bet ($0.50) returned to CichiChanMarian
CichiChanMarian collected $1 from pot
CichiChanMarian: doesn't show hand 
*** SUMMARY ***
Total pot $1 | Rake $0 
Seat 1: Bessie0009 folded before Flop (didn't bet)
Seat 2: coeeeelho folded before Flop (didn't bet)
Seat 3: Espada Fish folded before Flop (didn't bet)
Seat 4: RAidakCo (button) folded before Flop (didn't bet)
Seat 5: AlexEliseev7 (small blind) folded before Flop
Seat 6: CichiChanMarian (big blind) collected ($1)



PokerStars Hand #254734831678:  Hold'em No Limit ($0.50/$1.00 USD) - 2025/02/06 16:10:40 WET [2025/02/06 11:10:40 ET]
Table 'Ascanios II' 6-max Seat #5 is the button
Seat 1: Bessie0009 ($23.20 in chips) 
Seat 2: coeeeelho ($107.13 in chips) 
Seat 3: Espada Fish ($158.41 in chips) 
Seat 4: RAidakCo ($103.83 in chips) 
Seat 5: AlexEliseev7 ($105.50 in chips) 
Seat 6: CichiChanMarian ($100.50 in chips) 
CichiChanMarian: posts small blind $0.50
Bessie0009: posts big blind $1
*** HOLE CARDS ***
coeeeelho: raises $1.10 to $2.10
Espada Fish: folds 
RAidakCo: folds 
AlexEliseev7: folds 
CichiChanMarian: folds 
Bessie0009: calls $1.10
*** FLOP *** [Jd 3d 8s]
Bessie0009: checks 
coeeeelho: bets $1.47
Bessie0009: raises $7.40 to $8.87
coeeeelho: calls $7.40
*** TURN *** [Jd 3d 8s] [4s]
Bessie0009: bets $12.23 and is all-in
coeeeelho: calls $12.23
*** RIVER *** [Jd 3d 8s 4s] [Qc]
*** SHOW DOWN ***
Bessie0009: shows [Ac 3h] (a pair of Threes)
coeeeelho: shows [Jc Qh] (two pair, Queens and Jacks)
coeeeelho collected $44.56 from pot
Bessie0009 cashed out the hand for $4.97 | Cash Out Fee $0.10
*** SUMMARY ***
Total pot $46.90 | Rake $2.34 
Board [Jd 3d 8s 4s Qc]
Seat 1: Bessie0009 (big blind) showed [Ac 3h] and lost with a pair of Threes (cashed out).
Seat 2: coeeeelho showed [Jc Qh] and won ($44.56) with two pair, Queens and Jacks
Seat 3: Espada Fish folded before Flop (didn't bet)
Seat 4: RAidakCo folded before Flop (didn't bet)
Seat 5: AlexEliseev7 (button) folded before Flop (didn't bet)
Seat 6: CichiChanMarian (small blind) folded before Flop



PokerStars Hand #254734843533:  Hold'em No Limit ($0.50/$1.00 USD) - 2025/02/06 16:11:35 WET [2025/02/06 11:11:35 ET]
Table 'Ascanios II' 6-max Seat #6 is the button
Seat 1: Bessie0009 ($4.97 in chips) 
Seat 2: coeeeelho ($128.49 in chips) 
Seat 3: Espada Fish ($158.41 in chips) 
Seat 4: RAidakCo ($103.83 in chips) 
Seat 5: AlexEliseev7 ($105.50 in chips) 
Seat 6: CichiChanMarian ($100 in chips) 
Bessie0009: posts small blind $0.50
coeeeelho: posts big blind $1
*** HOLE CARDS ***
Espada Fish: folds 
RAidakCo: folds 
AlexEliseev7: folds 
CichiChanMarian: raises $1.50 to $2.50
Bessie0009: folds 
coeeeelho: calls $1.50
*** FLOP *** [7c Th 3s]
coeeeelho: checks 
CichiChanMarian: bets $1.72
coeeeelho: calls $1.72
*** TURN *** [7c Th 3s] [6h]
coeeeelho: checks 
CichiChanMarian: checks 
*** RIVER *** [7c Th 3s 6h] [Jc]
coeeeelho: checks 
CichiChanMarian: bets $6.37
coeeeelho: calls $6.37
*** SHOW DOWN ***
CichiChanMarian: shows [4s Js] (a pair of Jacks)
coeeeelho: mucks hand 
CichiChanMarian collected $20.60 from pot
*** SUMMARY ***
Total pot $21.68 | Rake $1.08 
Board [7c Th 3s 6h Jc]
Seat 1: Bessie0009 (small blind) folded before Flop
Seat 2: coeeeelho (big blind) mucked
Seat 3: Espada Fish folded before Flop (didn't bet)
Seat 4: RAidakCo folded before Flop (didn't bet)
Seat 5: AlexEliseev7 folded before Flop (didn't bet)
Seat 6: CichiChanMarian (button) showed [4s Js] and won ($20.60) with a pair of Jacks



PokerStars Hand #254734864220:  Hold'em No Limit ($0.50/$1.00 USD) - 2025/02/06 16:13:12 WET [2025/02/06 11:13:12 ET]
Table 'Ascanios II' 6-max Seat #1 is the button
Seat 1: Bessie0009 ($4.47 in chips) 
Seat 2: coeeeelho ($117.90 in chips) 
Seat 3: Espada Fish ($158.41 in chips) 
Seat 4: RAidakCo ($103.83 in chips) 
Seat 5: AlexEliseev7 ($105.50 in chips) 
Seat 6: CichiChanMarian ($110.01 in chips) 
coeeeelho: posts small blind $0.50
Espada Fish: posts big blind $1
*** HOLE CARDS ***
RAidakCo: raises $1 to $2
AlexEliseev7: folds 
CichiChanMarian: folds 
Bessie0009: folds 
coeeeelho: folds 
Espada Fish: calls $1
*** FLOP *** [Ks Td 2d]
Espada Fish: checks 
RAidakCo: bets $3.21
Espada Fish: calls $3.21
*** TURN *** [Ks Td 2d] [9c]
Espada Fish: checks 
RAidakCo: checks 
*** RIVER *** [Ks Td 2d 9c] [As]
Espada Fish: bets $3.42
RAidakCo: raises $8.61 to $12.03
Espada Fish: calls $8.61
*** SHOW DOWN ***
RAidakCo: shows [Ah Kc] (two pair, Aces and Kings)
Espada Fish: mucks hand 
RAidakCo collected $33.23 from pot
*** SUMMARY ***
Total pot $34.98 | Rake $1.75 
Board [Ks Td 2d 9c As]
Seat 1: Bessie0009 (button) folded before Flop (didn't bet)
Seat 2: coeeeelho (small blind) folded before Flop
Seat 3: Espada Fish (big blind) mucked
Seat 4: RAidakCo showed [Ah Kc] and won ($33.23) with two pair, Aces and Kings
Seat 5: AlexEliseev7 folded before Flop (didn't bet)
Seat 6: CichiChanMarian folded before Flop (didn't bet)



PokerStars Hand #254734884768:  Hold'em No Limit ($0.50/$1.00 USD) - 2025/02/06 16:14:47 WET [2025/02/06 11:14:47 ET]
Table 'Ascanios II' 6-max Seat #2 is the button
Seat 1: Bessie0009 ($12.33 in chips) 
Seat 2: coeeeelho ($117.40 in chips) 
Seat 3: Espada Fish ($141.17 in chips) 
Seat 4: RAidakCo ($119.82 in chips) 
Seat 5: AlexEliseev7 ($105.50 in chips) 
Seat 6: CichiChanMarian ($110.01 in chips) 
Espada Fish: posts small blind $0.50
RAidakCo: posts big blind $1
*** HOLE CARDS ***
AlexEliseev7: raises $1.50 to $2.50
CichiChanMarian: folds 
Bessie0009: raises $6.50 to $9
coeeeelho: folds 
Espada Fish: folds 
RAidakCo: folds 
AlexEliseev7: raises $6.50 to $15.50
Bessie0009: calls $3.33 and is all-in
Uncalled bet ($3.17) returned to AlexEliseev7
AlexEliseev7 has timed out
*** FLOP *** [6h Qd 6s]
*** TURN *** [6h Qd 6s] [2s]
*** RIVER *** [6h Qd 6s 2s] [Qs]
*** SHOW DOWN ***
AlexEliseev7: shows [Ad Ac] (two pair, Aces and Queens)
Bessie0009: shows [As 9c] (two pair, Queens and Sixes)
AlexEliseev7 collected $24.85 from pot
*** SUMMARY ***
Total pot $26.16 | Rake $1.31 
Board [6h Qd 6s 2s Qs]
Seat 1: Bessie0009 showed [As 9c] and lost with two pair, Queens and Sixes
Seat 2: coeeeelho (button) folded before Flop (didn't bet)
Seat 3: Espada Fish (small blind) folded before Flop
Seat 4: RAidakCo (big blind) folded before Flop
Seat 5: AlexEliseev7 showed [Ad Ac] and won ($24.85) with two pair, Aces and Queens
Seat 6: CichiChanMarian folded before Flop (didn't bet)



PokerStars Hand #254734897681:  Hold'em No Limit ($0.50/$1.00 USD) - 2025/02/06 16:15:46 WET [2025/02/06 11:15:46 ET]
Table 'Ascanios II' 6-max Seat #3 is the button
Seat 1: Bessie0009 ($0 in chips) is sitting out
Seat 2: coeeeelho ($117.40 in chips) 
Seat 3: Espada Fish ($140.67 in chips) 
Seat 4: RAidakCo ($118.82 in chips) 
Seat 5: AlexEliseev7 ($118.02 in chips) 
Seat 6: CichiChanMarian ($110.01 in chips) 
RAidakCo: posts small blind $0.50
AlexEliseev7: posts big blind $1
*** HOLE CARDS ***
CichiChanMarian: folds 
coeeeelho: folds 
Espada Fish: folds 
RAidakCo: folds 
Uncalled bet ($0.50) returned to AlexEliseev7
AlexEliseev7 collected $1 from pot
AlexEliseev7: doesn't show hand 
*** SUMMARY ***
Total pot $1 | Rake $0 
Seat 1: Bessie0009
Seat 2: coeeeelho folded before Flop (didn't bet)
Seat 3: Espada Fish (button) folded before Flop (didn't bet)
Seat 4: RAidakCo (small blind) folded before Flop
Seat 5: AlexEliseev7 (big blind) collected ($1)
Seat 6: CichiChanMarian folded before Flop (didn't bet)



PokerStars Hand #254734902301:  Hold'em No Limit ($0.50/$1.00 USD) - 2025/02/06 16:16:08 WET [2025/02/06 11:16:08 ET]
Table 'Ascanios II' 6-max Seat #4 is the button
Seat 6: CichiChanMarian ($110.01 in chips) is sitting out
Seat 1: Bessie0009 ($13.50 in chips) 
Seat 2: coeeeelho ($117.40 in chips) 
Seat 3: Espada Fish ($140.67 in chips) 
Seat 4: RAidakCo ($118.32 in chips) 
Seat 5: AlexEliseev7 ($118.52 in chips) 
AlexEliseev7: posts small blind $0.50
CichiChanMarian: is sitting out 
Bessie0009: posts big blind $1
*** HOLE CARDS ***
CichiChanMarian leaves the table
coeeeelho: folds 
Espada Fish: folds 
RAidakCo: folds 
AlexEliseev7: raises $117.52 to $118.52 and is all-in
Bessie0009: folds 
Uncalled bet ($117.52) returned to AlexEliseev7
AlexEliseev7 collected $2 from pot
AlexEliseev7: doesn't show hand 
*** SUMMARY ***
Total pot $2 | Rake $0 
Seat 6: CichiChanMarian
Seat 1: Bessie0009 (big blind) folded before Flop
Seat 2: coeeeelho folded before Flop (didn't bet)
Seat 3: Espada Fish folded before Flop (didn't bet)
Seat 4: RAidakCo (button) folded before Flop (didn't bet)
Seat 5: AlexEliseev7 (small blind) collected ($2)



PokerStars Hand #254734907038:  Hold'em No Limit ($0.50/$1.00 USD) - 2025/02/06 16:16:29 WET [2025/02/06 11:16:29 ET]
Table 'Ascanios II' 6-max Seat #5 is the button
Seat 1: Bessie0009 ($12.50 in chips) 
Seat 2: coeeeelho ($117.40 in chips) 
Seat 3: Espada Fish ($140.67 in chips) 
Seat 4: RAidakCo ($118.32 in chips) 
Seat 5: AlexEliseev7 ($119.52 in chips) 
Bessie0009: posts small blind $0.50
coeeeelho: posts big blind $1
*** HOLE CARDS ***
Espada Fish: raises $1.50 to $2.50
RAidakCo: folds 
IREQO joins the table at seat #6 
AlexEliseev7: raises $6.50 to $9
Bessie0009: folds 
coeeeelho: folds 
Espada Fish: calls $6.50
*** FLOP *** [3h Kh 7s]
Espada Fish: checks 
AlexEliseev7: bets $6.11
Espada Fish: raises $12.22 to $18.33
AlexEliseev7: folds 
Uncalled bet ($12.22) returned to Espada Fish
Espada Fish collected $30.13 from pot
Espada Fish: doesn't show hand 
*** SUMMARY ***
Total pot $31.72 | Rake $1.59 
Board [3h Kh 7s]
Seat 1: Bessie0009 (small blind) folded before Flop
Seat 2: coeeeelho (big blind) folded before Flop
Seat 3: Espada Fish collected ($30.13)
Seat 4: RAidakCo folded before Flop (didn't bet)
Seat 5: AlexEliseev7 (button) folded on the Flop



PokerStars Hand #254734922215:  Hold'em No Limit ($0.50/$1.00 USD) - 2025/02/06 16:17:39 WET [2025/02/06 11:17:39 ET]
Table 'Ascanios II' 6-max Seat #1 is the button
Seat 6: IREQO ($100 in chips) is sitting out
Seat 1: Bessie0009 ($12 in chips) 
Seat 2: coeeeelho ($116.40 in chips) 
Seat 3: Espada Fish ($155.69 in chips) 
Seat 4: RAidakCo ($118.32 in chips) 
Seat 5: AlexEliseev7 ($104.41 in chips) 
coeeeelho: posts small blind $0.50
Espada Fish: posts big blind $1
IREQO: sits out 
*** HOLE CARDS ***
RAidakCo: raises $1.20 to $2.20
AlexEliseev7: folds 
Bessie0009: folds 
coeeeelho: folds 
Espada Fish: folds 
Uncalled bet ($1.20) returned to RAidakCo
RAidakCo collected $2.50 from pot
RAidakCo: doesn't show hand 
*** SUMMARY ***
Total pot $2.50 | Rake $0 
Seat 6: IREQO
Seat 1: Bessie0009 (button) folded before Flop (didn't bet)
Seat 2: coeeeelho (small blind) folded before Flop
Seat 3: Espada Fish (big blind) folded before Flop
Seat 4: RAidakCo collected ($2.50)
Seat 5: AlexEliseev7 folded before Flop (didn't bet)



PokerStars Hand #254734924937:  Hold'em No Limit ($0.50/$1.00 USD) - 2025/02/06 16:17:52 WET [2025/02/06 11:17:52 ET]
Table 'Ascanios II' 6-max Seat #2 is the button
Seat 6: IREQO ($100 in chips) is sitting out
Seat 1: Bessie0009 ($12 in chips) 
Seat 2: coeeeelho ($115.90 in chips) 
Seat 3: Espada Fish ($154.69 in chips) 
Seat 4: RAidakCo ($119.82 in chips) 
Seat 5: AlexEliseev7 ($104.41 in chips) 
Espada Fish: posts small blind $0.50
RAidakCo: posts big blind $1
IREQO: sits out 
*** HOLE CARDS ***
AlexEliseev7: raises $1.50 to $2.50
Bessie0009: raises $9.50 to $12 and is all-in
coeeeelho: folds 
Espada Fish: folds 
RAidakCo: folds 
AlexEliseev7: calls $9.50
AlexEliseev7 has timed out
*** FLOP *** [Ad Kh Js]
*** TURN *** [Ad Kh Js] [6h]
*** RIVER *** [Ad Kh Js 6h] [6s]
*** SHOW DOWN ***
AlexEliseev7: shows [9h 9d] (two pair, Nines and Sixes)
Bessie0009: shows [Ac 7h] (two pair, Aces and Sixes)
Bessie0009 collected $24.22 from pot
*** SUMMARY ***
Total pot $25.50 | Rake $1.28 
Board [Ad Kh Js 6h 6s]
Seat 6: IREQO
Seat 1: Bessie0009 showed [Ac 7h] and won ($24.22) with two pair, Aces and Sixes
Seat 2: coeeeelho (button) folded before Flop (didn't bet)
Seat 3: Espada Fish (small blind) folded before Flop
Seat 4: RAidakCo (big blind) folded before Flop
Seat 5: AlexEliseev7 showed [9h 9d] and lost with two pair, Nines and Sixes



PokerStars Hand #254734934303:  Hold'em No Limit ($0.50/$1.00 USD) - 2025/02/06 16:18:34 WET [2025/02/06 11:18:34 ET]
Table 'Ascanios II' 6-max Seat #3 is the button
Seat 6: IREQO ($100 in chips) is sitting out
Seat 1: Bessie0009 ($24.22 in chips) 
Seat 2: coeeeelho ($115.90 in chips) 
Seat 3: Espada Fish ($154.19 in chips) 
Seat 4: RAidakCo ($118.82 in chips) 
Seat 5: AlexEliseev7 ($100 in chips) 
RAidakCo: posts small blind $0.50
AlexEliseev7: posts big blind $1
IREQO: sits out 
*** HOLE CARDS ***
Bessie0009: folds 
coeeeelho: folds 
Espada Fish: folds 
RAidakCo: folds 
Uncalled bet ($0.50) returned to AlexEliseev7
AlexEliseev7 collected $1 from pot
AlexEliseev7: doesn't show hand 
*** SUMMARY ***
Total pot $1 | Rake $0 
Seat 6: IREQO
Seat 1: Bessie0009 folded before Flop (didn't bet)
Seat 2: coeeeelho folded before Flop (didn't bet)
Seat 3: Espada Fish (button) folded before Flop (didn't bet)
Seat 4: RAidakCo (small blind) folded before Flop
Seat 5: AlexEliseev7 (big blind) collected ($1)



PokerStars Hand #254734940413:  Hold'em No Limit ($0.50/$1.00 USD) - 2025/02/06 16:19:02 WET [2025/02/06 11:19:02 ET]
Table 'Ascanios II' 6-max Seat #4 is the button
Seat 1: Bessie0009 ($24.22 in chips) 
Seat 2: coeeeelho ($115.90 in chips) 
Seat 3: Espada Fish ($154.19 in chips) 
Seat 4: RAidakCo ($118.32 in chips) 
Seat 5: AlexEliseev7 ($100.50 in chips) 
Seat 6: IREQO ($100 in chips) 
AlexEliseev7: posts small blind $0.50
IREQO: posts big blind $1
*** HOLE CARDS ***
Bessie0009: folds 
coeeeelho: folds 
Espada Fish: folds 
RAidakCo: raises $1.50 to $2.50
AlexEliseev7: folds 
IREQO: calls $1.50
*** FLOP *** [8d 7s 5c]
IREQO: checks 
RAidakCo: checks 
*** TURN *** [8d 7s 5c] [2d]
IREQO: bets $2.61
RAidakCo: raises $9.39 to $12
IREQO: folds 
Uncalled bet ($9.39) returned to RAidakCo
RAidakCo collected $10.18 from pot
RAidakCo: doesn't show hand 
*** SUMMARY ***
Total pot $10.72 | Rake $0.54 
Board [8d 7s 5c 2d]
Seat 1: Bessie0009 folded before Flop (didn't bet)
Seat 2: coeeeelho folded before Flop (didn't bet)
Seat 3: Espada Fish folded before Flop (didn't bet)
Seat 4: RAidakCo (button) collected ($10.18)
Seat 5: AlexEliseev7 (small blind) folded before Flop
Seat 6: IREQO (big blind) folded on the Turn



PokerStars Hand #254734960242:  Hold'em No Limit ($0.50/$1.00 USD) - 2025/02/06 16:20:33 WET [2025/02/06 11:20:33 ET]
Table 'Ascanios II' 6-max Seat #5 is the button
Seat 1: Bessie0009 ($24.22 in chips) is sitting out
Seat 2: coeeeelho ($115.90 in chips) 
Seat 3: Espada Fish ($154.19 in chips) 
Seat 4: RAidakCo ($123.39 in chips) 
Seat 5: AlexEliseev7 ($100 in chips) 
Seat 6: IREQO ($100 in chips) 
IREQO: posts small blind $0.50
Bessie0009 is disconnected 
Bessie0009 has timed out while disconnected
Bessie0009: is sitting out 
coeeeelho: posts big blind $1
*** HOLE CARDS ***
Espada Fish: raises $1.20 to $2.20
RAidakCo: folds 
AlexEliseev7: folds 
IREQO: folds 
coeeeelho: folds 
Uncalled bet ($1.20) returned to Espada Fish
Espada Fish collected $2.50 from pot
Espada Fish: doesn't show hand 
*** SUMMARY ***
Total pot $2.50 | Rake $0 
Seat 1: Bessie0009
Seat 2: coeeeelho (big blind) folded before Flop
Seat 3: Espada Fish collected ($2.50)
Seat 4: RAidakCo folded before Flop (didn't bet)
Seat 5: AlexEliseev7 (button) folded before Flop (didn't bet)
Seat 6: IREQO (small blind) folded before Flop



PokerStars Hand #254734965969:  Hold'em No Limit ($0.50/$1.00 USD) - 2025/02/06 16:20:59 WET [2025/02/06 11:20:59 ET]
Table 'Ascanios II' 6-max Seat #6 is the button
Seat 1: Bessie0009 ($24.22 in chips) is sitting out
Seat 2: coeeeelho ($114.90 in chips) 
Seat 3: Espada Fish ($155.69 in chips) 
Seat 4: RAidakCo ($123.39 in chips) 
Seat 5: AlexEliseev7 ($100 in chips) 
Seat 6: IREQO ($100 in chips) 
coeeeelho: posts small blind $0.50
Espada Fish: posts big blind $1
*** HOLE CARDS ***
RAidakCo: folds 
AlexEliseev7: folds 
IREQO: raises $1.50 to $2.50
coeeeelho: folds 
Espada Fish: folds 
Uncalled bet ($1.50) returned to IREQO
IREQO collected $2.50 from pot
IREQO: doesn't show hand 
*** SUMMARY ***
Total pot $2.50 | Rake $0 
Seat 1: Bessie0009
Seat 2: coeeeelho (small blind) folded before Flop
Seat 3: Espada Fish (big blind) folded before Flop
Seat 4: RAidakCo folded before Flop (didn't bet)
Seat 5: AlexEliseev7 folded before Flop (didn't bet)
Seat 6: IREQO (button) collected ($2.50)



PokerStars Hand #254734970172:  Hold'em No Limit ($0.50/$1.00 USD) - 2025/02/06 16:21:18 WET [2025/02/06 11:21:18 ET]
Table 'Ascanios II' 6-max Seat #2 is the button
Seat 1: Bessie0009 ($24.22 in chips) is sitting out
Seat 2: coeeeelho ($114.40 in chips) 
Seat 3: Espada Fish ($154.69 in chips) 
Seat 4: RAidakCo ($123.39 in chips) 
Seat 5: AlexEliseev7 ($100 in chips) 
Seat 6: IREQO ($101.50 in chips) 
Espada Fish: posts small blind $0.50
RAidakCo: posts big blind $1
Bessie0009 has timed out
Bessie0009: is sitting out 
*** HOLE CARDS ***
AlexEliseev7: folds 
IREQO: folds 
coeeeelho: folds 
Espada Fish: raises $2 to $3
RAidakCo: folds 
Uncalled bet ($2) returned to Espada Fish
Espada Fish collected $2 from pot
Espada Fish: doesn't show hand 
*** SUMMARY ***
Total pot $2 | Rake $0 
Seat 1: Bessie0009
Seat 2: coeeeelho (button) folded before Flop (didn't bet)
Seat 3: Espada Fish (small blind) collected ($2)
Seat 4: RAidakCo (big blind) folded before Flop
Seat 5: AlexEliseev7 folded before Flop (didn't bet)
Seat 6: IREQO folded before Flop (didn't bet)



PokerStars Hand #254734976084:  Hold'em No Limit ($0.50/$1.00 USD) - 2025/02/06 16:21:45 WET [2025/02/06 11:21:45 ET]
Table 'Ascanios II' 6-max Seat #3 is the button
Seat 1: Bessie0009 ($24.22 in chips) is sitting out
Seat 2: coeeeelho ($114.40 in chips) 
Seat 3: Espada Fish ($155.69 in chips) 
Seat 4: RAidakCo ($122.39 in chips) 
Seat 5: AlexEliseev7 ($100 in chips) 
Seat 6: IREQO ($101.50 in chips) 
RAidakCo: posts small blind $0.50
AlexEliseev7: posts big blind $1
*** HOLE CARDS ***
IREQO: folds 
coeeeelho: folds 
Espada Fish: folds 
RAidakCo: folds 
Uncalled bet ($0.50) returned to AlexEliseev7
AlexEliseev7 collected $1 from pot
AlexEliseev7: doesn't show hand 
*** SUMMARY ***
Total pot $1 | Rake $0 
Seat 1: Bessie0009
Seat 2: coeeeelho folded before Flop (didn't bet)
Seat 3: Espada Fish (button) folded before Flop (didn't bet)
Seat 4: RAidakCo (small blind) folded before Flop
Seat 5: AlexEliseev7 (big blind) collected ($1)
Seat 6: IREQO folded before Flop (didn't bet)



PokerStars Hand #254734980013:  Hold'em No Limit ($0.50/$1.00 USD) - 2025/02/06 16:22:02 WET [2025/02/06 11:22:02 ET]
Table 'Ascanios II' 6-max Seat #4 is the button
Seat 1: Bessie0009 ($24.22 in chips) is sitting out
Seat 2: coeeeelho ($114.40 in chips) 
Seat 3: Espada Fish ($155.69 in chips) 
Seat 4: RAidakCo ($121.89 in chips) 
Seat 5: AlexEliseev7 ($100.50 in chips) 
Seat 6: IREQO ($101.50 in chips) 
AlexEliseev7: posts small blind $0.50
IREQO: posts big blind $1
Bessie0009: sits out 
*** HOLE CARDS ***
coeeeelho: folds 
Espada Fish: folds 
RAidakCo: raises $1.50 to $2.50
AlexEliseev7: folds 
IREQO: raises $8.50 to $11
RAidakCo: raises $13 to $24
IREQO: folds 
Uncalled bet ($13) returned to RAidakCo
RAidakCo collected $22.50 from pot
RAidakCo: doesn't show hand 
*** SUMMARY ***
Total pot $22.50 | Rake $0 
Seat 1: Bessie0009
Seat 2: coeeeelho folded before Flop (didn't bet)
Seat 3: Espada Fish folded before Flop (didn't bet)
Seat 4: RAidakCo (button) collected ($22.50)
Seat 5: AlexEliseev7 (small blind) folded before Flop
Seat 6: IREQO (big blind) folded before Flop



PokerStars Hand #254734990453:  Hold'em No Limit ($0.50/$1.00 USD) - 2025/02/06 16:22:50 WET [2025/02/06 11:22:50 ET]
Table 'Ascanios II' 6-max Seat #5 is the button
Seat 1: Bessie0009 ($24.22 in chips) 
Seat 2: coeeeelho ($114.40 in chips) 
Seat 3: Espada Fish ($155.69 in chips) 
Seat 4: RAidakCo ($133.39 in chips) 
Seat 5: AlexEliseev7 ($100 in chips) 
Seat 6: IREQO ($100 in chips) 
IREQO: posts small blind $0.50
Bessie0009: posts big blind $1
*** HOLE CARDS ***
coeeeelho: folds 
Espada Fish: folds 
RAidakCo: folds 
AlexEliseev7: raises $1.50 to $2.50
IREQO: folds 
Bessie0009: calls $1.50
*** FLOP *** [As Th Td]
Bessie0009: checks 
AlexEliseev7: checks 
*** TURN *** [As Th Td] [4h]
Bessie0009: bets $5.22
AlexEliseev7: folds 
Uncalled bet ($5.22) returned to Bessie0009
Bessie0009 collected $5.22 from pot
*** SUMMARY ***
Total pot $5.50 | Rake $0.28 
Board [As Th Td 4h]
Seat 1: Bessie0009 (big blind) collected ($5.22)
Seat 2: coeeeelho folded before Flop (didn't bet)
Seat 3: Espada Fish folded before Flop (didn't bet)
Seat 4: RAidakCo folded before Flop (didn't bet)
Seat 5: AlexEliseev7 (button) folded on the Turn
Seat 6: IREQO (small blind) folded before Flop



PokerStars Hand #254734999624:  Hold'em No Limit ($0.50/$1.00 USD) - 2025/02/06 16:23:31 WET [2025/02/06 11:23:31 ET]
Table 'Ascanios II' 6-max Seat #6 is the button
Seat 1: Bessie0009 ($26.94 in chips) 
Seat 2: coeeeelho ($114.40 in chips) 
Seat 3: Espada Fish ($155.69 in chips) 
Seat 4: RAidakCo ($133.39 in chips) 
Seat 5: AlexEliseev7 ($100 in chips) 
Seat 6: IREQO ($100 in chips) 
Bessie0009: posts small blind $0.50
coeeeelho: posts big blind $1
*** HOLE CARDS ***
Espada Fish: folds 
RAidakCo: folds 
AlexEliseev7: folds 
IREQO: folds 
Bessie0009: folds 
Uncalled bet ($0.50) returned to coeeeelho
coeeeelho collected $1 from pot
*** SUMMARY ***
Total pot $1 | Rake $0 
Seat 1: Bessie0009 (small blind) folded before Flop
Seat 2: coeeeelho (big blind) collected ($1)
Seat 3: Espada Fish folded before Flop (didn't bet)
Seat 4: RAidakCo folded before Flop (didn't bet)
Seat 5: AlexEliseev7 folded before Flop (didn't bet)
Seat 6: IREQO (button) folded before Flop (didn't bet)



PokerStars Hand #254735002360:  Hold'em No Limit ($0.50/$1.00 USD) - 2025/02/06 16:23:44 WET [2025/02/06 11:23:44 ET]
Table 'Ascanios II' 6-max Seat #1 is the button
Seat 1: Bessie0009 ($26.44 in chips) 
Seat 2: coeeeelho ($114.90 in chips) 
Seat 3: Espada Fish ($155.69 in chips) 
Seat 4: RAidakCo ($133.39 in chips) 
Seat 5: AlexEliseev7 ($100 in chips) 
Seat 6: IREQO ($100 in chips) 
coeeeelho: posts small blind $0.50
Espada Fish: posts big blind $1
*** HOLE CARDS ***
RAidakCo: folds 
AlexEliseev7: folds 
IREQO: folds 
Bessie0009: raises $2.50 to $3.50
coeeeelho: folds 
Espada Fish: calls $2.50
*** FLOP *** [Jh 6h 9h]
Espada Fish: checks 
Bessie0009: bets $3.56
Espada Fish: folds 
Uncalled bet ($3.56) returned to Bessie0009
Bessie0009 collected $7.12 from pot
*** SUMMARY ***
Total pot $7.50 | Rake $0.38 
Board [Jh 6h 9h]
Seat 1: Bessie0009 (button) collected ($7.12)
Seat 2: coeeeelho (small blind) folded before Flop
Seat 3: Espada Fish (big blind) folded on the Flop
Seat 4: RAidakCo folded before Flop (didn't bet)
Seat 5: AlexEliseev7 folded before Flop (didn't bet)
Seat 6: IREQO folded before Flop (didn't bet)



PokerStars Hand #254735011297:  Hold'em No Limit ($0.50/$1.00 USD) - 2025/02/06 16:24:24 WET [2025/02/06 11:24:24 ET]
Table 'Ascanios II' 6-max Seat #2 is the button
Seat 1: Bessie0009 ($30.06 in chips) 
Seat 2: coeeeelho ($114.40 in chips) 
Seat 3: Espada Fish ($152.19 in chips) 
Seat 4: RAidakCo ($133.39 in chips) 
Seat 5: AlexEliseev7 ($100 in chips) 
Seat 6: IREQO ($100 in chips) 
Espada Fish: posts small blind $0.50
RAidakCo: posts big blind $1
*** HOLE CARDS ***
AlexEliseev7: folds 
IREQO: raises $1.50 to $2.50
Bessie0009: folds 
coeeeelho: folds 
Espada Fish: folds 
RAidakCo: folds 
Uncalled bet ($1.50) returned to IREQO
IREQO collected $2.50 from pot
IREQO: doesn't show hand 
*** SUMMARY ***
Total pot $2.50 | Rake $0 
Seat 1: Bessie0009 folded before Flop (didn't bet)
Seat 2: coeeeelho (button) folded before Flop (didn't bet)
Seat 3: Espada Fish (small blind) folded before Flop
Seat 4: RAidakCo (big blind) folded before Flop
Seat 5: AlexEliseev7 folded before Flop (didn't bet)
Seat 6: IREQO collected ($2.50)



PokerStars Hand #254735015590:  Hold'em No Limit ($0.50/$1.00 USD) - 2025/02/06 16:24:43 WET [2025/02/06 11:24:43 ET]
Table 'Ascanios II' 6-max Seat #3 is the button
Seat 1: Bessie0009 ($30.06 in chips) 
Seat 2: coeeeelho ($114.40 in chips) 
Seat 3: Espada Fish ($151.69 in chips) 
Seat 4: RAidakCo ($132.39 in chips) 
Seat 5: AlexEliseev7 ($100 in chips) 
Seat 6: IREQO ($101.50 in chips) 
RAidakCo: posts small blind $0.50
AlexEliseev7: posts big blind $1
*** HOLE CARDS ***
IREQO: folds 
Bessie0009: calls $1
coeeeelho: folds 
Espada Fish: folds 
RAidakCo: raises $3 to $4
AlexEliseev7: folds 
Bessie0009: calls $3
*** FLOP *** [Qs Kh 7h]
RAidakCo: checks 
Bessie0009: checks 
*** TURN *** [Qs Kh 7h] [7c]
RAidakCo: checks 
Bessie0009: bets $8.55
RAidakCo: calls $8.55
*** RIVER *** [Qs Kh 7h 7c] [5h]
RAidakCo: checks 
Bessie0009: bets $17.51 and is all-in
RAidakCo: calls $17.51
*** SHOW DOWN ***
Bessie0009: shows [9c Jc] (a pair of Sevens)
RAidakCo: shows [Qd Tc] (two pair, Queens and Sevens)
RAidakCo collected $58.62 from pot
*** SUMMARY ***
Total pot $61.12 | Rake $2.50 
Board [Qs Kh 7h 7c 5h]
Seat 1: Bessie0009 showed [9c Jc] and lost with a pair of Sevens
Seat 2: coeeeelho folded before Flop (didn't bet)
Seat 3: Espada Fish (button) folded before Flop (didn't bet)
Seat 4: RAidakCo (small blind) showed [Qd Tc] and won ($58.62) with two pair, Queens and Sevens
Seat 5: AlexEliseev7 (big blind) folded before Flop
Seat 6: IREQO folded before Flop (didn't bet)



PokerStars Hand #254735024993:  Hold'em No Limit ($0.50/$1.00 USD) - 2025/02/06 16:25:25 WET [2025/02/06 11:25:25 ET]
Table 'Ascanios II' 6-max Seat #4 is the button
Seat 1: Bessie0009 ($0 in chips) is sitting out
Seat 2: coeeeelho ($114.40 in chips) 
Seat 3: Espada Fish ($151.69 in chips) 
Seat 4: RAidakCo ($160.95 in chips) 
Seat 5: AlexEliseev7 ($100 in chips) 
Seat 6: IREQO ($101.50 in chips) 
AlexEliseev7: posts small blind $0.50
IREQO: posts big blind $1
*** HOLE CARDS ***
coeeeelho: folds 
Espada Fish: folds 
RAidakCo: raises $1.50 to $2.50
Bessie0009 leaves the table
AlexEliseev7: folds 
IREQO: folds 
Uncalled bet ($1.50) returned to RAidakCo
RAidakCo collected $2.50 from pot
RAidakCo: doesn't show hand 
*** SUMMARY ***
Total pot $2.50 | Rake $0 
Seat 1: Bessie0009
Seat 2: coeeeelho folded before Flop (didn't bet)
Seat 3: Espada Fish folded before Flop (didn't bet)
Seat 4: RAidakCo (button) collected ($2.50)
Seat 5: AlexEliseev7 (small blind) folded before Flop
Seat 6: IREQO (big blind) folded before Flop



PokerStars Hand #254735028017:  Hold'em No Limit ($0.50/$1.00 USD) - 2025/02/06 16:25:39 WET [2025/02/06 11:25:39 ET]
Table 'Ascanios II' 6-max Seat #5 is the button
Seat 2: coeeeelho ($114.40 in chips) 
Seat 3: Espada Fish ($151.69 in chips) 
Seat 4: RAidakCo ($162.45 in chips) 
Seat 5: AlexEliseev7 ($100 in chips) 
Seat 6: IREQO ($100.50 in chips) 
IREQO: posts small blind $0.50
coeeeelho: posts big blind $1
*** HOLE CARDS ***
Espada Fish: folds 
RAidakCo: folds 
AlexEliseev7: folds 
IREQO: folds 
Uncalled bet ($0.50) returned to coeeeelho
Espada Fish leaves the table
coeeeelho collected $1 from pot
*** SUMMARY ***
Total pot $1 | Rake $0 
Seat 2: coeeeelho (big blind) collected ($1)
Seat 3: Espada Fish folded before Flop (didn't bet)
Seat 4: RAidakCo folded before Flop (didn't bet)
Seat 5: AlexEliseev7 (button) folded before Flop (didn't bet)
Seat 6: IREQO (small blind) folded before Flop



PokerStars Hand #254735031044:  Hold'em No Limit ($0.50/$1.00 USD) - 2025/02/06 16:25:52 WET [2025/02/06 11:25:52 ET]
Table 'Ascanios II' 6-max Seat #6 is the button
Seat 2: coeeeelho ($114.90 in chips) 
Seat 4: RAidakCo ($162.45 in chips) 
Seat 5: AlexEliseev7 ($100 in chips) 
Seat 6: IREQO ($100 in chips) 
coeeeelho: posts small blind $0.50
RAidakCo: posts big blind $1
*** HOLE CARDS ***
AlexEliseev7: folds 
IREQO: raises $1.50 to $2.50
coeeeelho: folds 
RAidakCo: folds 
Uncalled bet ($1.50) returned to IREQO
IREQO collected $2.50 from pot
IREQO: doesn't show hand 
*** SUMMARY ***
Total pot $2.50 | Rake $0 
Seat 2: coeeeelho (small blind) folded before Flop
Seat 4: RAidakCo (big blind) folded before Flop
Seat 5: AlexEliseev7 folded before Flop (didn't bet)
Seat 6: IREQO (button) collected ($2.50)



PokerStars Hand #254735034731:  Hold'em No Limit ($0.50/$1.00 USD) - 2025/02/06 16:26:09 WET [2025/02/06 11:26:09 ET]
Table 'Ascanios II' 6-max Seat #4 is the button
Seat 5: AlexEliseev7 ($100 in chips) is sitting out
Seat 6: IREQO ($101.50 in chips) is sitting out
Seat 2: coeeeelho ($114.40 in chips) 
Seat 4: RAidakCo ($161.45 in chips) 
RAidakCo: posts small blind $0.50
AlexEliseev7: is sitting out 
IREQO: is sitting out 
coeeeelho: posts big blind $1
*** HOLE CARDS ***
RAidakCo: raises $1.50 to $2.50
coeeeelho: calls $1.50
*** FLOP *** [Qh 2c 8s]
coeeeelho: checks 
RAidakCo: checks 
*** TURN *** [Qh 2c 8s] [4d]
coeeeelho: checks 
AlexEliseev7 leaves the table
RAidakCo: bets $2.38
coeeeelho: folds 
Uncalled bet ($2.38) returned to RAidakCo
RAidakCo collected $4.75 from pot
RAidakCo: doesn't show hand 
*** SUMMARY ***
Total pot $5 | Rake $0.25 
Board [Qh 2c 8s 4d]
Seat 5: AlexEliseev7
Seat 6: IREQO
Seat 2: coeeeelho (big blind) folded on the Turn
Seat 4: RAidakCo (button) (small blind) collected ($4.75)



PokerStars Hand #254735125730:  Hold'em No Limit ($0.50/$1.00 USD) - 2025/02/06 16:32:57 WET [2025/02/06 11:32:57 ET]
Table 'Ascanios II' 6-max Seat #1 is the button
Seat 1: Granit34 ($100 in chips) 
Seat 3: PayTaxOrDie ($82 in chips) 
Granit34: posts small blind $0.50
PayTaxOrDie: posts big blind $1
*** HOLE CARDS ***
Granit34: calls $0.50
PayTaxOrDie: checks 
*** FLOP *** [Ks Kd 6s]
PayTaxOrDie: checks 
Granit34: bets $1.90
PayTaxOrDie: folds 
Uncalled bet ($1.90) returned to Granit34
Granit34 collected $1.88 from pot
*** SUMMARY ***
Total pot $2 | Rake $0.12 
Board [Ks Kd 6s]
Seat 1: Granit34 (button) (small blind) collected ($1.88)
Seat 3: PayTaxOrDie (big blind) folded on the Flop



PokerStars Hand #254735129933:  Hold'em No Limit ($0.50/$1.00 USD) - 2025/02/06 16:33:16 WET [2025/02/06 11:33:16 ET]
Table 'Ascanios II' 6-max Seat #3 is the button
Seat 1: Granit34 ($100.88 in chips) 
Seat 3: PayTaxOrDie ($100 in chips) 
PayTaxOrDie: posts small blind $0.50
Granit34: posts big blind $1
*** HOLE CARDS ***
PayTaxOrDie: raises $1.50 to $2.50
Granit34: calls $1.50
*** FLOP *** [4d Ac 5s]
Granit34: checks 
PayTaxOrDie: bets $1.19
Granit34: calls $1.19
*** TURN *** [4d Ac 5s] [Kc]
Granit34: checks 
PayTaxOrDie: checks 
*** RIVER *** [4d Ac 5s Kc] [Kh]
Granit34: bets $2
PayTaxOrDie: calls $2
*** SHOW DOWN ***
Granit34: shows [Js 2s] (a pair of Kings)
PayTaxOrDie: shows [8s Ah] (two pair, Aces and Kings)
PayTaxOrDie collected $10.81 from pot
*** SUMMARY ***
Total pot $11.38 | Rake $0.57 
Board [4d Ac 5s Kc Kh]
Seat 1: Granit34 (big blind) showed [Js 2s] and lost with a pair of Kings
Seat 3: PayTaxOrDie (button) (small blind) showed [8s Ah] and won ($10.81) with two pair, Aces and Kings



PokerStars Hand #254735141109:  Hold'em No Limit ($0.50/$1.00 USD) - 2025/02/06 16:34:06 WET [2025/02/06 11:34:06 ET]
Table 'Ascanios II' 6-max Seat #1 is the button
Seat 1: Granit34 ($95.19 in chips) 
Seat 3: PayTaxOrDie ($105.12 in chips) 
Granit34: posts small blind $0.50
PayTaxOrDie: posts big blind $1
*** HOLE CARDS ***
Granit34: folds 
Uncalled bet ($0.50) returned to PayTaxOrDie
PayTaxOrDie collected $1 from pot
PayTaxOrDie: doesn't show hand 
*** SUMMARY ***
Total pot $1 | Rake $0 
Seat 1: Granit34 (button) (small blind) folded before Flop
Seat 3: PayTaxOrDie (big blind) collected ($1)



PokerStars Hand #254735142720:  Hold'em No Limit ($0.50/$1.00 USD) - 2025/02/06 16:34:13 WET [2025/02/06 11:34:13 ET]
Table 'Ascanios II' 6-max Seat #3 is the button
Seat 1: Granit34 ($94.69 in chips) 
Seat 3: PayTaxOrDie ($105.62 in chips) 
PayTaxOrDie: posts small blind $0.50
Granit34: posts big blind $1
*** HOLE CARDS ***
PayTaxOrDie: folds 
Uncalled bet ($0.50) returned to Granit34
Granit34 collected $1 from pot
*** SUMMARY ***
Total pot $1 | Rake $0 
Seat 1: Granit34 (big blind) collected ($1)
Seat 3: PayTaxOrDie (button) (small blind) folded before Flop



PokerStars Hand #254735144601:  Hold'em No Limit ($0.50/$1.00 USD) - 2025/02/06 16:34:22 WET [2025/02/06 11:34:22 ET]
Table 'Ascanios II' 6-max Seat #1 is the button
Seat 1: Granit34 ($95.19 in chips) 
Seat 3: PayTaxOrDie ($105.12 in chips) 
Granit34: posts small blind $0.50
PayTaxOrDie: posts big blind $1
*** HOLE CARDS ***
Granit34: raises $2 to $3
PayTaxOrDie: calls $2
*** FLOP *** [5s Qd 9h]
PayTaxOrDie: checks 
Granit34: checks 
*** TURN *** [5s Qd 9h] [4d]
PayTaxOrDie: checks 
EAroca joins the table at seat #2 
Granit34: checks 
*** RIVER *** [5s Qd 9h 4d] [6d]
PayTaxOrDie: checks 
Granit34: checks 
*** SHOW DOWN ***
PayTaxOrDie: shows [2h Ah] (high card Ace)
Granit34: shows [As Ts] (high card Ace - Queen+Ten kicker)
Granit34 collected $5.62 from pot
*** SUMMARY ***
Total pot $6 | Rake $0.38 
Board [5s Qd 9h 4d 6d]
Seat 1: Granit34 (button) (small blind) showed [As Ts] and won ($5.62) with high card Ace
Seat 3: PayTaxOrDie (big blind) showed [2h Ah] and lost with high card Ace



PokerStars Hand #254735151709:  Hold'em No Limit ($0.50/$1.00 USD) - 2025/02/06 16:34:53 WET [2025/02/06 11:34:53 ET]
Table 'Ascanios II' 6-max Seat #3 is the button
Seat 1: Granit34 ($97.81 in chips) 
Seat 2: EAroca ($100 in chips) 
Seat 3: PayTaxOrDie ($102.12 in chips) 
Granit34: posts small blind $0.50
EAroca: posts big blind $1
*** HOLE CARDS ***
PayTaxOrDie: folds 
Granit34: calls $0.50
EAroca: raises $2.50 to $3.50
Granit34: folds 
Uncalled bet ($2.50) returned to EAroca
EAroca collected $2 from pot
EAroca: doesn't show hand 
*** SUMMARY ***
Total pot $2 | Rake $0 
Seat 1: Granit34 (small blind) folded before Flop
Seat 2: EAroca (big blind) collected ($2)
Seat 3: PayTaxOrDie (button) folded before Flop (didn't bet)



PokerStars Hand #254735154133:  Hold'em No Limit ($0.50/$1.00 USD) - 2025/02/06 16:35:04 WET [2025/02/06 11:35:04 ET]
Table 'Ascanios II' 6-max Seat #1 is the button
Seat 1: Granit34 ($96.81 in chips) 
Seat 2: EAroca ($101 in chips) 
Seat 3: PayTaxOrDie ($102.12 in chips) 
EAroca: posts small blind $0.50
PayTaxOrDie: posts big blind $1
*** HOLE CARDS ***
Granit34: raises $2 to $3
EAroca: folds 
PayTaxOrDie: calls $2
*** FLOP *** [4d 5h 8d]
PayTaxOrDie: checks 
Granit34: checks 
*** TURN *** [4d 5h 8d] [Jh]
PayTaxOrDie: bets $2.04
Granit34: folds 
Uncalled bet ($2.04) returned to PayTaxOrDie
PayTaxOrDie collected $6.18 from pot
PayTaxOrDie: doesn't show hand 
Granit34 leaves the table
*** SUMMARY ***
Total pot $6.50 | Rake $0.32 
Board [4d 5h 8d Jh]
Seat 1: Granit34 (button) folded on the Turn
Seat 2: EAroca (small blind) folded before Flop
Seat 3: PayTaxOrDie (big blind) collected ($6.18)



PokerStars Hand #254735160365:  Hold'em No Limit ($0.50/$1.00 USD) - 2025/02/06 16:35:32 WET [2025/02/06 11:35:32 ET]
Table 'Ascanios II' 6-max Seat #3 is the button
Seat 2: EAroca ($100.50 in chips) 
Seat 3: PayTaxOrDie ($105.30 in chips) 
PayTaxOrDie: posts small blind $0.50
EAroca: posts big blind $1
*** HOLE CARDS ***
PayTaxOrDie: raises $1.50 to $2.50
EAroca: folds 
Uncalled bet ($1.50) returned to PayTaxOrDie
PayTaxOrDie collected $2 from pot
PayTaxOrDie: doesn't show hand 
*** SUMMARY ***
Total pot $2 | Rake $0 
Seat 2: EAroca (big blind) folded before Flop
Seat 3: PayTaxOrDie (button) (small blind) collected ($2)



PokerStars Hand #254735162687:  Hold'em No Limit ($0.50/$1.00 USD) - 2025/02/06 16:35:42 WET [2025/02/06 11:35:42 ET]
Table 'Ascanios II' 6-max Seat #2 is the button
Seat 2: EAroca ($100 in chips) 
Seat 3: PayTaxOrDie ($106.30 in chips) 
EAroca: posts small blind $0.50
PayTaxOrDie: posts big blind $1
*** HOLE CARDS ***
EAroca: raises $1.30 to $2.30
PayTaxOrDie: folds 
Uncalled bet ($1.30) returned to EAroca
EAroca collected $2 from pot
EAroca: doesn't show hand 
*** SUMMARY ***
Total pot $2 | Rake $0 
Seat 2: EAroca (button) (small blind) collected ($2)
Seat 3: PayTaxOrDie (big blind) folded before Flop



