PokerStars Hand #254483159113:  Hold'em No Limit ($0.50/$1.00 USD) - 2025/01/21 13:12:47 WET [2025/01/21 8:12:47 ET]
Table 'Gyptis IV' 6-max Seat #3 is the button
Seat 1: Brookstj500 ($40 in chips) 
Seat 3: DL1B ($100 in chips) 
Seat 4: nickreason17 ($100 in chips) 
nickreason17: posts small blind $0.50
Gfoer joins the table at seat #2 
Brookstj500: posts big blind $1
*** HOLE CARDS ***
DL1B: folds 
nickreason17: folds 
Uncalled bet ($0.50) returned to Brookstj500
Brookstj500 collected $1 from pot
Brookstj500: doesn't show hand 
*** SUMMARY ***
Total pot $1 | Rake $0 
Seat 1: Brookstj500 (big blind) collected ($1)
Seat 3: DL1B (button) folded before Flop (didn't bet)
Seat 4: nickreason17 (small blind) folded before Flop



PokerStars Hand #254483160276:  Hold'em No Limit ($0.50/$1.00 USD) - 2025/01/21 13:12:55 WET [2025/01/21 8:12:55 ET]
Table 'Gyptis IV' 6-max Seat #4 is the button
Seat 1: Brookstj500 ($40.50 in chips) 
Seat 2: Gfoer ($100 in chips) 
Seat 3: DL1B ($100 in chips) 
Seat 4: nickreason17 ($100 in chips) 
Brookstj500: posts small blind $0.50
Gfoer: posts big blind $1
*** HOLE CARDS ***
DL1B: raises $1.50 to $2.50
nickreason17: folds 
Brookstj500: folds 
Gfoer: calls $1.50
*** FLOP *** [Qd 3h 4d]
Rdalonso joins the table at seat #5 
Cle0patr4 joins the table at seat #6 
Gfoer: checks 
DL1B: bets $1.72
Gfoer: folds 
Uncalled bet ($1.72) returned to DL1B
DL1B collected $5.22 from pot
DL1B: doesn't show hand 
*** SUMMARY ***
Total pot $5.50 | Rake $0.28 
Board [Qd 3h 4d]
Seat 1: Brookstj500 (small blind) folded before Flop
Seat 2: Gfoer (big blind) folded on the Flop
Seat 3: DL1B collected ($5.22)
Seat 4: nickreason17 (button) folded before Flop (didn't bet)



PokerStars Hand #254483167029:  Hold'em No Limit ($0.50/$1.00 USD) - 2025/01/21 13:13:39 WET [2025/01/21 8:13:39 ET]
Table 'Gyptis IV' 6-max Seat #1 is the button
Seat 5: Rdalonso ($100 in chips) is sitting out
Seat 6: Cle0patr4 ($100 in chips) is sitting out
Seat 1: Brookstj500 ($40 in chips) 
Seat 2: Gfoer ($100 in chips) 
Seat 3: DL1B ($102.72 in chips) 
Seat 4: nickreason17 ($100 in chips) 
Gfoer: posts small blind $0.50
DL1B: posts big blind $1
Rdalonso: sits out 
Cle0patr4: sits out 
*** HOLE CARDS ***
nickreason17: raises $1.25 to $2.25
Brookstj500: folds 
Gfoer: folds 
DL1B: folds 
Uncalled bet ($1.25) returned to nickreason17
nickreason17 collected $2.50 from pot
nickreason17: doesn't show hand 
*** SUMMARY ***
Total pot $2.50 | Rake $0 
Seat 5: Rdalonso
Seat 6: Cle0patr4
Seat 1: Brookstj500 (button) folded before Flop (didn't bet)
Seat 2: Gfoer (small blind) folded before Flop
Seat 3: DL1B (big blind) folded before Flop
Seat 4: nickreason17 collected ($2.50)



PokerStars Hand #254483169593:  Hold'em No Limit ($0.50/$1.00 USD) - 2025/01/21 13:13:56 WET [2025/01/21 8:13:56 ET]
Table 'Gyptis IV' 6-max Seat #2 is the button
Seat 5: Rdalonso ($100 in chips) is sitting out
Seat 6: Cle0patr4 ($100 in chips) is sitting out
Seat 1: Brookstj500 ($40 in chips) 
Seat 2: Gfoer ($100 in chips) 
Seat 3: DL1B ($101.72 in chips) 
Seat 4: nickreason17 ($101.50 in chips) 
DL1B: posts small blind $0.50
nickreason17: posts big blind $1
Rdalonso: sits out 
Cle0patr4: sits out 
*** HOLE CARDS ***
Brookstj500: folds 
Gfoer: folds 
DL1B: folds 
Uncalled bet ($0.50) returned to nickreason17
nickreason17 collected $1 from pot
nickreason17: doesn't show hand 
*** SUMMARY ***
Total pot $1 | Rake $0 
Seat 5: Rdalonso
Seat 6: Cle0patr4
Seat 1: Brookstj500 folded before Flop (didn't bet)
Seat 2: Gfoer (button) folded before Flop (didn't bet)
Seat 3: DL1B (small blind) folded before Flop
Seat 4: nickreason17 (big blind) collected ($1)



PokerStars Hand #254483171187:  Hold'em No Limit ($0.50/$1.00 USD) - 2025/01/21 13:14:07 WET [2025/01/21 8:14:07 ET]
Table 'Gyptis IV' 6-max Seat #3 is the button
Seat 6: Cle0patr4 ($100 in chips) is sitting out
Seat 1: Brookstj500 ($40 in chips) 
Seat 2: Gfoer ($100 in chips) 
Seat 3: DL1B ($101.22 in chips) 
Seat 4: nickreason17 ($102 in chips) 
Seat 5: Rdalonso ($100 in chips) 
nickreason17: posts small blind $0.50
Rdalonso: posts big blind $1
Cle0patr4: sits out 
*** HOLE CARDS ***
Brookstj500: folds 
Gfoer: folds 
DL1B: raises $1.50 to $2.50
nickreason17: folds 
Rdalonso: folds 
Uncalled bet ($1.50) returned to DL1B
DL1B collected $2.50 from pot
DL1B: doesn't show hand 
*** SUMMARY ***
Total pot $2.50 | Rake $0 
Seat 6: Cle0patr4
Seat 1: Brookstj500 folded before Flop (didn't bet)
Seat 2: Gfoer folded before Flop (didn't bet)
Seat 3: DL1B (button) collected ($2.50)
Seat 4: nickreason17 (small blind) folded before Flop
Seat 5: Rdalonso (big blind) folded before Flop



PokerStars Hand #254483173741:  Hold'em No Limit ($0.50/$1.00 USD) - 2025/01/21 13:14:23 WET [2025/01/21 8:14:23 ET]
Table 'Gyptis IV' 6-max Seat #4 is the button
Seat 1: Brookstj500 ($40 in chips) 
Seat 2: Gfoer ($100 in chips) 
Seat 3: DL1B ($102.72 in chips) 
Seat 4: nickreason17 ($101.50 in chips) 
Seat 5: Rdalonso ($100 in chips) 
Seat 6: Cle0patr4 ($100 in chips) 
Rdalonso: posts small blind $0.50
Cle0patr4: posts big blind $1
*** HOLE CARDS ***
Brookstj500: calls $1
Gfoer: folds 
DL1B: folds 
nickreason17: raises $2.50 to $3.50
Rdalonso: folds 
Cle0patr4: raises $10 to $13.50
Brookstj500: folds 
nickreason17: folds 
Uncalled bet ($10) returned to Cle0patr4
Cle0patr4 collected $8.50 from pot
Cle0patr4: doesn't show hand 
*** SUMMARY ***
Total pot $8.50 | Rake $0 
Seat 1: Brookstj500 folded before Flop
Seat 2: Gfoer folded before Flop (didn't bet)
Seat 3: DL1B folded before Flop (didn't bet)
Seat 4: nickreason17 (button) folded before Flop
Seat 5: Rdalonso (small blind) folded before Flop
Seat 6: Cle0patr4 (big blind) collected ($8.50)



PokerStars Hand #254483177899:  Hold'em No Limit ($0.50/$1.00 USD) - 2025/01/21 13:14:50 WET [2025/01/21 8:14:50 ET]
Table 'Gyptis IV' 6-max Seat #5 is the button
Seat 1: Brookstj500 ($39 in chips) 
Seat 2: Gfoer ($100 in chips) 
Seat 3: DL1B ($102.72 in chips) 
Seat 4: nickreason17 ($100 in chips) 
Seat 5: Rdalonso ($100 in chips) 
Seat 6: Cle0patr4 ($105 in chips) 
Cle0patr4: posts small blind $0.50
Brookstj500: posts big blind $1
*** HOLE CARDS ***
Gfoer: folds 
Gfoer leaves the table
DL1B: raises $1 to $2
nickreason17: folds 
Rdalonso: folds 
chinokevin13 joins the table at seat #2 
Cle0patr4: raises $9.50 to $11.50
Brookstj500: folds 
DL1B: folds 
Uncalled bet ($9.50) returned to Cle0patr4
Cle0patr4 collected $5 from pot
Cle0patr4: doesn't show hand 
*** SUMMARY ***
Total pot $5 | Rake $0 
Seat 1: Brookstj500 (big blind) folded before Flop
Seat 2: Gfoer folded before Flop (didn't bet)
Seat 3: DL1B folded before Flop
Seat 4: nickreason17 folded before Flop (didn't bet)
Seat 5: Rdalonso (button) folded before Flop (didn't bet)
Seat 6: Cle0patr4 (small blind) collected ($5)



PokerStars Hand #254483182087:  Hold'em No Limit ($0.50/$1.00 USD) - 2025/01/21 13:15:18 WET [2025/01/21 8:15:18 ET]
Table 'Gyptis IV' 6-max Seat #6 is the button
Seat 1: Brookstj500 ($38 in chips) 
Seat 2: chinokevin13 ($100 in chips) 
Seat 3: DL1B ($100.72 in chips) 
Seat 4: nickreason17 ($100 in chips) 
Seat 5: Rdalonso ($100 in chips) 
Seat 6: Cle0patr4 ($108 in chips) 
Brookstj500: posts small blind $0.50
chinokevin13: posts big blind $1
*** HOLE CARDS ***
DL1B: folds 
nickreason17: folds 
Rdalonso: folds 
Cle0patr4: folds 
Brookstj500: calls $0.50
chinokevin13: checks 
*** FLOP *** [8h 4c Jc]
Brookstj500: bets $2
chinokevin13: calls $2
*** TURN *** [8h 4c Jc] [4d]
Brookstj500: checks 
chinokevin13: bets $5.70
Brookstj500: folds 
Uncalled bet ($5.70) returned to chinokevin13
chinokevin13 collected $5.70 from pot
chinokevin13: doesn't show hand 
*** SUMMARY ***
Total pot $6 | Rake $0.30 
Board [8h 4c Jc 4d]
Seat 1: Brookstj500 (small blind) folded on the Turn
Seat 2: chinokevin13 (big blind) collected ($5.70)
Seat 3: DL1B folded before Flop (didn't bet)
Seat 4: nickreason17 folded before Flop (didn't bet)
Seat 5: Rdalonso folded before Flop (didn't bet)
Seat 6: Cle0patr4 (button) folded before Flop (didn't bet)



PokerStars Hand #254483192791:  Hold'em No Limit ($0.50/$1.00 USD) - 2025/01/21 13:16:27 WET [2025/01/21 8:16:27 ET]
Table 'Gyptis IV' 6-max Seat #1 is the button
Seat 1: Brookstj500 ($35 in chips) 
Seat 2: chinokevin13 ($102.70 in chips) 
Seat 3: DL1B ($100.72 in chips) 
Seat 4: nickreason17 ($100 in chips) 
Seat 5: Rdalonso ($100 in chips) 
Seat 6: Cle0patr4 ($108 in chips) 
chinokevin13: posts small blind $0.50
DL1B: posts big blind $1
*** HOLE CARDS ***
nickreason17: folds 
Rdalonso: folds 
Cle0patr4: folds 
Brookstj500: raises $2.50 to $3.50
chinokevin13: folds 
DL1B: folds 
Uncalled bet ($2.50) returned to Brookstj500
Brookstj500 collected $2.50 from pot
Brookstj500: doesn't show hand 
*** SUMMARY ***
Total pot $2.50 | Rake $0 
Seat 1: Brookstj500 (button) collected ($2.50)
Seat 2: chinokevin13 (small blind) folded before Flop
Seat 3: DL1B (big blind) folded before Flop
Seat 4: nickreason17 folded before Flop (didn't bet)
Seat 5: Rdalonso folded before Flop (didn't bet)
Seat 6: Cle0patr4 folded before Flop (didn't bet)



PokerStars Hand #254483194859:  Hold'em No Limit ($0.50/$1.00 USD) - 2025/01/21 13:16:40 WET [2025/01/21 8:16:40 ET]
Table 'Gyptis IV' 6-max Seat #2 is the button
Seat 1: Brookstj500 ($36.50 in chips) 
Seat 2: chinokevin13 ($102.20 in chips) 
Seat 3: DL1B ($100 in chips) 
Seat 4: nickreason17 ($100 in chips) 
Seat 5: Rdalonso ($100 in chips) 
Seat 6: Cle0patr4 ($108 in chips) 
DL1B: posts small blind $0.50
nickreason17: posts big blind $1
*** HOLE CARDS ***
Rdalonso: folds 
Cle0patr4: folds 
Brookstj500: calls $1
chinokevin13: folds 
DL1B: folds 
nickreason17: checks 
*** FLOP *** [3s As 4s]
nickreason17: bets $1.19
Brookstj500: calls $1.19
*** TURN *** [3s As 4s] [3h]
nickreason17: checks 
Brookstj500: checks 
*** RIVER *** [3s As 4s 3h] [Ad]
nickreason17: bets $3
Brookstj500: folds 
Uncalled bet ($3) returned to nickreason17
nickreason17 collected $4.64 from pot
nickreason17: doesn't show hand 
*** SUMMARY ***
Total pot $4.88 | Rake $0.24 
Board [3s As 4s 3h Ad]
Seat 1: Brookstj500 folded on the River
Seat 2: chinokevin13 (button) folded before Flop (didn't bet)
Seat 3: DL1B (small blind) folded before Flop
Seat 4: nickreason17 (big blind) collected ($4.64)
Seat 5: Rdalonso folded before Flop (didn't bet)
Seat 6: Cle0patr4 folded before Flop (didn't bet)



PokerStars Hand #254483202718:  Hold'em No Limit ($0.50/$1.00 USD) - 2025/01/21 13:17:29 WET [2025/01/21 8:17:29 ET]
Table 'Gyptis IV' 6-max Seat #3 is the button
Seat 1: Brookstj500 ($34.31 in chips) 
Seat 2: chinokevin13 ($102.20 in chips) 
Seat 3: DL1B ($100 in chips) 
Seat 4: nickreason17 ($102.45 in chips) 
Seat 5: Rdalonso ($100 in chips) 
Seat 6: Cle0patr4 ($108 in chips) 
nickreason17: posts small blind $0.50
Rdalonso: posts big blind $1
*** HOLE CARDS ***
Cle0patr4: raises $1 to $2
Brookstj500: folds 
chinokevin13: folds 
DL1B: folds 
nickreason17: folds 
Rdalonso: folds 
Uncalled bet ($1) returned to Cle0patr4
Cle0patr4 collected $2.50 from pot
Cle0patr4: doesn't show hand 
*** SUMMARY ***
Total pot $2.50 | Rake $0 
Seat 1: Brookstj500 folded before Flop (didn't bet)
Seat 2: chinokevin13 folded before Flop (didn't bet)
Seat 3: DL1B (button) folded before Flop (didn't bet)
Seat 4: nickreason17 (small blind) folded before Flop
Seat 5: Rdalonso (big blind) folded before Flop
Seat 6: Cle0patr4 collected ($2.50)



PokerStars Hand #254483205387:  Hold'em No Limit ($0.50/$1.00 USD) - 2025/01/21 13:17:46 WET [2025/01/21 8:17:46 ET]
Table 'Gyptis IV' 6-max Seat #4 is the button
Seat 1: Brookstj500 ($34.31 in chips) 
Seat 2: chinokevin13 ($102.20 in chips) 
Seat 3: DL1B ($100 in chips) 
Seat 4: nickreason17 ($101.95 in chips) 
Seat 5: Rdalonso ($100 in chips) 
Seat 6: Cle0patr4 ($109.50 in chips) 
Rdalonso: posts small blind $0.50
Cle0patr4: posts big blind $1
*** HOLE CARDS ***
Brookstj500: calls $1
chinokevin13: raises $4 to $5
DL1B: folds 
nickreason17: folds 
Rdalonso: folds 
Cle0patr4: folds 
Brookstj500: raises $11.50 to $16.50
chinokevin13: folds 
Uncalled bet ($11.50) returned to Brookstj500
Brookstj500 collected $11.50 from pot
Brookstj500: doesn't show hand 
*** SUMMARY ***
Total pot $11.50 | Rake $0 
Seat 1: Brookstj500 collected ($11.50)
Seat 2: chinokevin13 folded before Flop
Seat 3: DL1B folded before Flop (didn't bet)
Seat 4: nickreason17 (button) folded before Flop (didn't bet)
Seat 5: Rdalonso (small blind) folded before Flop
Seat 6: Cle0patr4 (big blind) folded before Flop



PokerStars Hand #254483213365:  Hold'em No Limit ($0.50/$1.00 USD) - 2025/01/21 13:18:35 WET [2025/01/21 8:18:35 ET]
Table 'Gyptis IV' 6-max Seat #5 is the button
Seat 1: Brookstj500 ($40.81 in chips) 
Seat 2: chinokevin13 ($100 in chips) 
Seat 3: DL1B ($100 in chips) 
Seat 4: nickreason17 ($101.95 in chips) 
Seat 5: Rdalonso ($100 in chips) 
Seat 6: Cle0patr4 ($108.50 in chips) 
Cle0patr4: posts small blind $0.50
Brookstj500: posts big blind $1
*** HOLE CARDS ***
chinokevin13: folds 
DL1B: raises $1 to $2
nickreason17: folds 
Rdalonso: folds 
Cle0patr4: folds 
Brookstj500: calls $1
*** FLOP *** [Kd 6c Jd]
Brookstj500: checks 
DL1B: bets $3.25
Brookstj500: calls $3.25
*** TURN *** [Kd 6c Jd] [Qs]
Brookstj500: checks 
DL1B: checks 
*** RIVER *** [Kd 6c Jd Qs] [Ks]
Brookstj500: bets $6
DL1B: calls $6
*** SHOW DOWN ***
Brookstj500: shows [Qc Kh] (a full house, Kings full of Queens)
DL1B: mucks hand 
Brookstj500 collected $21.85 from pot
*** SUMMARY ***
Total pot $23 | Rake $1.15 
Board [Kd 6c Jd Qs Ks]
Seat 1: Brookstj500 (big blind) showed [Qc Kh] and won ($21.85) with a full house, Kings full of Queens
Seat 2: chinokevin13 folded before Flop (didn't bet)
Seat 3: DL1B mucked
Seat 4: nickreason17 folded before Flop (didn't bet)
Seat 5: Rdalonso (button) folded before Flop (didn't bet)
Seat 6: Cle0patr4 (small blind) folded before Flop



PokerStars Hand #254483222914:  Hold'em No Limit ($0.50/$1.00 USD) - 2025/01/21 13:19:36 WET [2025/01/21 8:19:36 ET]
Table 'Gyptis IV' 6-max Seat #6 is the button
Seat 1: Brookstj500 ($51.41 in chips) 
Seat 2: chinokevin13 ($100 in chips) 
Seat 3: DL1B ($100 in chips) 
Seat 4: nickreason17 ($101.95 in chips) 
Seat 5: Rdalonso ($100 in chips) 
Seat 6: Cle0patr4 ($108 in chips) 
Brookstj500: posts small blind $0.50
chinokevin13: posts big blind $1
*** HOLE CARDS ***
DL1B: folds 
nickreason17: folds 
Rdalonso: raises $1.50 to $2.50
Cle0patr4: folds 
Brookstj500: folds 
chinokevin13: folds 
Uncalled bet ($1.50) returned to Rdalonso
Rdalonso collected $2.50 from pot
Rdalonso: doesn't show hand 
*** SUMMARY ***
Total pot $2.50 | Rake $0 
Seat 1: Brookstj500 (small blind) folded before Flop
Seat 2: chinokevin13 (big blind) folded before Flop
Seat 3: DL1B folded before Flop (didn't bet)
Seat 4: nickreason17 folded before Flop (didn't bet)
Seat 5: Rdalonso collected ($2.50)
Seat 6: Cle0patr4 (button) folded before Flop (didn't bet)



PokerStars Hand #254483225961:  Hold'em No Limit ($0.50/$1.00 USD) - 2025/01/21 13:19:55 WET [2025/01/21 8:19:55 ET]
Table 'Gyptis IV' 6-max Seat #1 is the button
Seat 1: Brookstj500 ($50.91 in chips) 
Seat 2: chinokevin13 ($100 in chips) 
Seat 3: DL1B ($100 in chips) 
Seat 4: nickreason17 ($101.95 in chips) 
Seat 5: Rdalonso ($101.50 in chips) 
Seat 6: Cle0patr4 ($108 in chips) 
chinokevin13: posts small blind $0.50
DL1B: posts big blind $1
*** HOLE CARDS ***
nickreason17: folds 
Rdalonso: folds 
Cle0patr4: folds 
Brookstj500: folds 
chinokevin13: folds 
Uncalled bet ($0.50) returned to DL1B
DL1B collected $1 from pot
DL1B: doesn't show hand 
*** SUMMARY ***
Total pot $1 | Rake $0 
Seat 1: Brookstj500 (button) folded before Flop (didn't bet)
Seat 2: chinokevin13 (small blind) folded before Flop
Seat 3: DL1B (big blind) collected ($1)
Seat 4: nickreason17 folded before Flop (didn't bet)
Seat 5: Rdalonso folded before Flop (didn't bet)
Seat 6: Cle0patr4 folded before Flop (didn't bet)



PokerStars Hand #254483229589:  Hold'em No Limit ($0.50/$1.00 USD) - 2025/01/21 13:20:18 WET [2025/01/21 8:20:18 ET]
Table 'Gyptis IV' 6-max Seat #2 is the button
Seat 1: Brookstj500 ($50.91 in chips) 
Seat 2: chinokevin13 ($100 in chips) 
Seat 3: DL1B ($100.50 in chips) 
Seat 4: nickreason17 ($101.95 in chips) 
Seat 5: Rdalonso ($101.50 in chips) 
Seat 6: Cle0patr4 ($108 in chips) 
DL1B: posts small blind $0.50
nickreason17: posts big blind $1
*** HOLE CARDS ***
Rdalonso: folds 
Cle0patr4: folds 
Brookstj500: calls $1
chinokevin13: raises $4 to $5
DL1B: folds 
nickreason17: folds 
Brookstj500: calls $4
*** FLOP *** [4d 7c Ac]
Brookstj500: checks 
chinokevin13: bets $3.60
Brookstj500: folds 
Uncalled bet ($3.60) returned to chinokevin13
chinokevin13 collected $10.92 from pot
chinokevin13: doesn't show hand 
*** SUMMARY ***
Total pot $11.50 | Rake $0.58 
Board [4d 7c Ac]
Seat 1: Brookstj500 folded on the Flop
Seat 2: chinokevin13 (button) collected ($10.92)
Seat 3: DL1B (small blind) folded before Flop
Seat 4: nickreason17 (big blind) folded before Flop
Seat 5: Rdalonso folded before Flop (didn't bet)
Seat 6: Cle0patr4 folded before Flop (didn't bet)



PokerStars Hand #254483238248:  Hold'em No Limit ($0.50/$1.00 USD) - 2025/01/21 13:21:12 WET [2025/01/21 8:21:12 ET]
Table 'Gyptis IV' 6-max Seat #3 is the button
Seat 1: Brookstj500 ($45.91 in chips) 
Seat 2: chinokevin13 ($105.92 in chips) 
Seat 3: DL1B ($100 in chips) 
Seat 4: nickreason17 ($100.95 in chips) 
Seat 5: Rdalonso ($101.50 in chips) 
Seat 6: Cle0patr4 ($108 in chips) 
nickreason17: posts small blind $0.50
Rdalonso: posts big blind $1
*** HOLE CARDS ***
Cle0patr4: folds 
Brookstj500: folds 
chinokevin13: folds 
DL1B: raises $1.50 to $2.50
nickreason17: raises $8.50 to $11
Rdalonso: folds 
DL1B: calls $8.50
*** FLOP *** [2c 3h Kh]
nickreason17: bets $5.56
DL1B: calls $5.56
*** TURN *** [2c 3h Kh] [As]
nickreason17: checks 
DL1B: checks 
*** RIVER *** [2c 3h Kh As] [Td]
nickreason17: checks 
DL1B: bets $24.63
nickreason17: raises $59.76 to $84.39 and is all-in
DL1B: folds 
Uncalled bet ($59.76) returned to nickreason17
nickreason17 collected $80.88 from pot
nickreason17: doesn't show hand 
*** SUMMARY ***
Total pot $83.38 | Rake $2.50 
Board [2c 3h Kh As Td]
Seat 1: Brookstj500 folded before Flop (didn't bet)
Seat 2: chinokevin13 folded before Flop (didn't bet)
Seat 3: DL1B (button) folded on the River
Seat 4: nickreason17 (small blind) collected ($80.88)
Seat 5: Rdalonso (big blind) folded before Flop
Seat 6: Cle0patr4 folded before Flop (didn't bet)



PokerStars Hand #254483255640:  Hold'em No Limit ($0.50/$1.00 USD) - 2025/01/21 13:23:00 WET [2025/01/21 8:23:00 ET]
Table 'Gyptis IV' 6-max Seat #4 is the button
Seat 1: Brookstj500 ($45.91 in chips) 
Seat 2: chinokevin13 ($105.92 in chips) 
Seat 3: DL1B ($100 in chips) 
Seat 4: nickreason17 ($140.64 in chips) 
Seat 5: Rdalonso ($100.50 in chips) 
Seat 6: Cle0patr4 ($108 in chips) 
Rdalonso: posts small blind $0.50
Cle0patr4: posts big blind $1
*** HOLE CARDS ***
Brookstj500: calls $1
chinokevin13: folds 
DL1B: folds 
nickreason17: folds 
Rdalonso: folds 
Cle0patr4: checks 
*** FLOP *** [Jc 9s 7s]
Cle0patr4: checks 
Brookstj500: checks 
*** TURN *** [Jc 9s 7s] [Tc]
Cle0patr4: bets $1.26
Brookstj500: calls $1.26
*** RIVER *** [Jc 9s 7s Tc] [9d]
Cle0patr4: checks 
Brookstj500: checks 
*** SHOW DOWN ***
Cle0patr4: shows [3d 2s] (a pair of Nines)
Brookstj500: shows [Ad As] (two pair, Aces and Nines)
Brookstj500 collected $4.77 from pot
*** SUMMARY ***
Total pot $5.02 | Rake $0.25 
Board [Jc 9s 7s Tc 9d]
Seat 1: Brookstj500 showed [Ad As] and won ($4.77) with two pair, Aces and Nines
Seat 2: chinokevin13 folded before Flop (didn't bet)
Seat 3: DL1B folded before Flop (didn't bet)
Seat 4: nickreason17 (button) folded before Flop (didn't bet)
Seat 5: Rdalonso (small blind) folded before Flop
Seat 6: Cle0patr4 (big blind) showed [3d 2s] and lost with a pair of Nines



PokerStars Hand #254483263680:  Hold'em No Limit ($0.50/$1.00 USD) - 2025/01/21 13:23:51 WET [2025/01/21 8:23:51 ET]
Table 'Gyptis IV' 6-max Seat #5 is the button
Seat 1: Brookstj500 ($48.42 in chips) 
Seat 2: chinokevin13 ($105.92 in chips) 
Seat 3: DL1B ($100 in chips) 
Seat 4: nickreason17 ($140.64 in chips) 
Seat 5: Rdalonso ($100 in chips) 
Seat 6: Cle0patr4 ($105.74 in chips) 
Cle0patr4: posts small blind $0.50
Brookstj500: posts big blind $1
*** HOLE CARDS ***
chinokevin13: folds 
DL1B: folds 
nickreason17: folds 
Rdalonso: folds 
Cle0patr4: folds 
Uncalled bet ($0.50) returned to Brookstj500
Brookstj500 collected $1 from pot
Brookstj500: doesn't show hand 
*** SUMMARY ***
Total pot $1 | Rake $0 
Seat 1: Brookstj500 (big blind) collected ($1)
Seat 2: chinokevin13 folded before Flop (didn't bet)
Seat 3: DL1B folded before Flop (didn't bet)
Seat 4: nickreason17 folded before Flop (didn't bet)
Seat 5: Rdalonso (button) folded before Flop (didn't bet)
Seat 6: Cle0patr4 (small blind) folded before Flop



PokerStars Hand #254483265750:  Hold'em No Limit ($0.50/$1.00 USD) - 2025/01/21 13:24:04 WET [2025/01/21 8:24:04 ET]
Table 'Gyptis IV' 6-max Seat #6 is the button
Seat 1: Brookstj500 ($48.92 in chips) 
Seat 2: chinokevin13 ($105.92 in chips) 
Seat 3: DL1B ($100 in chips) 
Seat 4: nickreason17 ($140.64 in chips) 
Seat 5: Rdalonso ($100 in chips) 
Seat 6: Cle0patr4 ($105.24 in chips) 
Brookstj500: posts small blind $0.50
chinokevin13: posts big blind $1
*** HOLE CARDS ***
DL1B: folds 
nickreason17: raises $1.25 to $2.25
Rdalonso: folds 
Cle0patr4: folds 
Brookstj500: folds 
chinokevin13: folds 
Uncalled bet ($1.25) returned to nickreason17
nickreason17 collected $2.50 from pot
nickreason17: doesn't show hand 
*** SUMMARY ***
Total pot $2.50 | Rake $0 
Seat 1: Brookstj500 (small blind) folded before Flop
Seat 2: chinokevin13 (big blind) folded before Flop
Seat 3: DL1B folded before Flop (didn't bet)
Seat 4: nickreason17 collected ($2.50)
Seat 5: Rdalonso folded before Flop (didn't bet)
Seat 6: Cle0patr4 (button) folded before Flop (didn't bet)



PokerStars Hand #254483268176:  Hold'em No Limit ($0.50/$1.00 USD) - 2025/01/21 13:24:19 WET [2025/01/21 8:24:19 ET]
Table 'Gyptis IV' 6-max Seat #1 is the button
Seat 1: Brookstj500 ($48.42 in chips) 
Seat 2: chinokevin13 ($104.92 in chips) 
Seat 3: DL1B ($100 in chips) 
Seat 4: nickreason17 ($142.14 in chips) 
Seat 5: Rdalonso ($100 in chips) 
Seat 6: Cle0patr4 ($105.24 in chips) 
chinokevin13: posts small blind $0.50
DL1B: posts big blind $1
*** HOLE CARDS ***
nickreason17: folds 
Rdalonso: folds 
Cle0patr4: raises $1 to $2
Brookstj500: calls $2
chinokevin13: folds 
DL1B: calls $1
*** FLOP *** [9c Ah Jc]
DL1B: checks 
Cle0patr4: checks 
Brookstj500: bets $7
DL1B: folds 
Cle0patr4: folds 
Uncalled bet ($7) returned to Brookstj500
Brookstj500 collected $6.18 from pot
Brookstj500: doesn't show hand 
*** SUMMARY ***
Total pot $6.50 | Rake $0.32 
Board [9c Ah Jc]
Seat 1: Brookstj500 (button) collected ($6.18)
Seat 2: chinokevin13 (small blind) folded before Flop
Seat 3: DL1B (big blind) folded on the Flop
Seat 4: nickreason17 folded before Flop (didn't bet)
Seat 5: Rdalonso folded before Flop (didn't bet)
Seat 6: Cle0patr4 folded on the Flop



PokerStars Hand #254483276571:  Hold'em No Limit ($0.50/$1.00 USD) - 2025/01/21 13:25:12 WET [2025/01/21 8:25:12 ET]
Table 'Gyptis IV' 6-max Seat #2 is the button
Seat 4: nickreason17 ($142.14 in chips) is sitting out
Seat 1: Brookstj500 ($52.60 in chips) 
Seat 2: chinokevin13 ($104.42 in chips) 
Seat 3: DL1B ($100 in chips) 
Seat 5: Rdalonso ($100 in chips) 
Seat 6: Cle0patr4 ($103.24 in chips) 
DL1B: posts small blind $0.50
nickreason17: is sitting out 
Rdalonso: posts big blind $1
*** HOLE CARDS ***
Cle0patr4: raises $1 to $2
Brookstj500: calls $2
chinokevin13: folds 
DL1B: folds 
nickreason17 leaves the table
Rdalonso: calls $1
*** FLOP *** [Qc Ac 7s]
Rdalonso: checks 
Cle0patr4: checks 
Brookstj500 is disconnected 
Brookstj500 is connected 
Brookstj500: bets $6.18
Rdalonso: folds 
Cle0patr4: folds 
Uncalled bet ($6.18) returned to Brookstj500
Brookstj500 collected $6.18 from pot
Brookstj500: doesn't show hand 
*** SUMMARY ***
Total pot $6.50 | Rake $0.32 
Board [Qc Ac 7s]
Seat 4: nickreason17
Seat 1: Brookstj500 collected ($6.18)
Seat 2: chinokevin13 (button) folded before Flop (didn't bet)
Seat 3: DL1B (small blind) folded before Flop
Seat 5: Rdalonso (big blind) folded on the Flop
Seat 6: Cle0patr4 folded on the Flop



PokerStars Hand #254483285920:  Hold'em No Limit ($0.50/$1.00 USD) - 2025/01/21 13:26:11 WET [2025/01/21 8:26:11 ET]
Table 'Gyptis IV' 6-max Seat #3 is the button
Seat 1: Brookstj500 ($56.78 in chips) 
Seat 2: chinokevin13 ($104.42 in chips) 
Seat 3: DL1B ($100 in chips) 
Seat 5: Rdalonso ($100 in chips) 
Seat 6: Cle0patr4 ($101.24 in chips) 
Rdalonso: posts small blind $0.50
Cle0patr4: posts big blind $1
*** HOLE CARDS ***
Brookstj500: folds 
chinokevin13: raises $1.50 to $2.50
DL1B: raises $5 to $7.50
Rdalonso: folds 
Cle0patr4: folds 
chinokevin13: folds 
Uncalled bet ($5) returned to DL1B
DL1B collected $6.50 from pot
DL1B: doesn't show hand 
*** SUMMARY ***
Total pot $6.50 | Rake $0 
Seat 1: Brookstj500 folded before Flop (didn't bet)
Seat 2: chinokevin13 folded before Flop
Seat 3: DL1B (button) collected ($6.50)
Seat 5: Rdalonso (small blind) folded before Flop
Seat 6: Cle0patr4 (big blind) folded before Flop



PokerStars Hand #254483289135:  Hold'em No Limit ($0.50/$1.00 USD) - 2025/01/21 13:26:32 WET [2025/01/21 8:26:32 ET]
Table 'Gyptis IV' 6-max Seat #5 is the button
Seat 1: Brookstj500 ($56.78 in chips) 
Seat 2: chinokevin13 ($101.92 in chips) 
Seat 3: DL1B ($104 in chips) 
Seat 5: Rdalonso ($100 in chips) 
Seat 6: Cle0patr4 ($100.24 in chips) 
Cle0patr4: posts small blind $0.50
Brookstj500: posts big blind $1
*** HOLE CARDS ***
chinokevin13: folds 
DL1B: folds 
Rdalonso: raises $1.50 to $2.50
Cle0patr4: folds 
Brookstj500: folds 
Uncalled bet ($1.50) returned to Rdalonso
Rdalonso collected $2.50 from pot
Rdalonso: doesn't show hand 
*** SUMMARY ***
Total pot $2.50 | Rake $0 
Seat 1: Brookstj500 (big blind) folded before Flop
Seat 2: chinokevin13 folded before Flop (didn't bet)
Seat 3: DL1B folded before Flop (didn't bet)
Seat 5: Rdalonso (button) collected ($2.50)
Seat 6: Cle0patr4 (small blind) folded before Flop



PokerStars Hand #254483292412:  Hold'em No Limit ($0.50/$1.00 USD) - 2025/01/21 13:26:53 WET [2025/01/21 8:26:53 ET]
Table 'Gyptis IV' 6-max Seat #6 is the button
Seat 1: Brookstj500 ($55.78 in chips) 
Seat 2: chinokevin13 ($101.92 in chips) 
Seat 3: DL1B ($104 in chips) 
Seat 5: Rdalonso ($101.50 in chips) 
Seat 6: Cle0patr4 ($100 in chips) 
Brookstj500: posts small blind $0.50
chinokevin13: posts big blind $1
*** HOLE CARDS ***
DL1B: folds 
Rdalonso: folds 
Cle0patr4: raises $1 to $2
Brookstj500: calls $1.50
chinokevin13: calls $1
*** FLOP *** [4c Ah Jd]
Brookstj500: checks 
chinokevin13: checks 
Cle0patr4: bets $1.50
Brookstj500: folds 
chinokevin13: calls $1.50
*** TURN *** [4c Ah Jd] [2c]
chinokevin13: checks 
Cle0patr4: bets $11.54
chinokevin13: folds 
Uncalled bet ($11.54) returned to Cle0patr4
Cle0patr4 collected $8.55 from pot
Cle0patr4: doesn't show hand 
*** SUMMARY ***
Total pot $9 | Rake $0.45 
Board [4c Ah Jd 2c]
Seat 1: Brookstj500 (small blind) folded on the Flop
Seat 2: chinokevin13 (big blind) folded on the Turn
Seat 3: DL1B folded before Flop (didn't bet)
Seat 5: Rdalonso folded before Flop (didn't bet)
Seat 6: Cle0patr4 (button) collected ($8.55)



PokerStars Hand #254483307340:  Hold'em No Limit ($0.50/$1.00 USD) - 2025/01/21 13:28:27 WET [2025/01/21 8:28:27 ET]
Table 'Gyptis IV' 6-max Seat #1 is the button
Seat 1: Brookstj500 ($53.78 in chips) 
Seat 2: chinokevin13 ($100 in chips) 
Seat 3: DL1B ($104 in chips) 
Seat 5: Rdalonso ($101.50 in chips) 
Seat 6: Cle0patr4 ($105.05 in chips) 
chinokevin13: posts small blind $0.50
DL1B: posts big blind $1
*** HOLE CARDS ***
Rdalonso: folds 
Cle0patr4: folds 
Brookstj500: folds 
chinokevin13: raises $2 to $3
DL1B: raises $6 to $9
Evelexy1 joins the table at seat #4 
chinokevin13: folds 
Uncalled bet ($6) returned to DL1B
DL1B collected $6 from pot
DL1B: doesn't show hand 
*** SUMMARY ***
Total pot $6 | Rake $0 
Seat 1: Brookstj500 (button) folded before Flop (didn't bet)
Seat 2: chinokevin13 (small blind) folded before Flop
Seat 3: DL1B (big blind) collected ($6)
Seat 5: Rdalonso folded before Flop (didn't bet)
Seat 6: Cle0patr4 folded before Flop (didn't bet)



PokerStars Hand #254483311428:  Hold'em No Limit ($0.50/$1.00 USD) - 2025/01/21 13:28:52 WET [2025/01/21 8:28:52 ET]
Table 'Gyptis IV' 6-max Seat #2 is the button
Seat 1: Brookstj500 ($53.78 in chips) 
Seat 2: chinokevin13 ($100 in chips) 
Seat 3: DL1B ($107 in chips) 
Seat 4: Evelexy1 ($100 in chips) 
Seat 5: Rdalonso ($101.50 in chips) 
Seat 6: Cle0patr4 ($105.05 in chips) 
DL1B: posts small blind $0.50
Evelexy1: posts big blind $1
*** HOLE CARDS ***
Rdalonso: folds 
Cle0patr4: folds 
Brookstj500: folds 
chinokevin13: folds 
DL1B: folds 
Uncalled bet ($0.50) returned to Evelexy1
Evelexy1 collected $1 from pot
Evelexy1: doesn't show hand 
*** SUMMARY ***
Total pot $1 | Rake $0 
Seat 1: Brookstj500 folded before Flop (didn't bet)
Seat 2: chinokevin13 (button) folded before Flop (didn't bet)
Seat 3: DL1B (small blind) folded before Flop
Seat 4: Evelexy1 (big blind) collected ($1)
Seat 5: Rdalonso folded before Flop (didn't bet)
Seat 6: Cle0patr4 folded before Flop (didn't bet)



PokerStars Hand #254483312923:  Hold'em No Limit ($0.50/$1.00 USD) - 2025/01/21 13:29:02 WET [2025/01/21 8:29:02 ET]
Table 'Gyptis IV' 6-max Seat #3 is the button
Seat 1: Brookstj500 ($53.78 in chips) 
Seat 2: chinokevin13 ($100 in chips) 
Seat 3: DL1B ($106.50 in chips) 
Seat 4: Evelexy1 ($100.50 in chips) 
Seat 5: Rdalonso ($101.50 in chips) 
Seat 6: Cle0patr4 ($105.05 in chips) 
Evelexy1: posts small blind $0.50
Rdalonso: posts big blind $1
*** HOLE CARDS ***
Cle0patr4: folds 
Brookstj500: folds 
chinokevin13: folds 
DL1B: folds 
Evelexy1: raises $1.50 to $2.50
Rdalonso: calls $1.50
*** FLOP *** [2h 7d Qd]
Evelexy1: checks 
Rdalonso: checks 
*** TURN *** [2h 7d Qd] [Tc]
Evelexy1: checks 
Rdalonso: bets $3.14
Evelexy1: folds 
Uncalled bet ($3.14) returned to Rdalonso
Rdalonso collected $4.75 from pot
Rdalonso: doesn't show hand 
*** SUMMARY ***
Total pot $5 | Rake $0.25 
Board [2h 7d Qd Tc]
Seat 1: Brookstj500 folded before Flop (didn't bet)
Seat 2: chinokevin13 folded before Flop (didn't bet)
Seat 3: DL1B (button) folded before Flop (didn't bet)
Seat 4: Evelexy1 (small blind) folded on the Turn
Seat 5: Rdalonso (big blind) collected ($4.75)
Seat 6: Cle0patr4 folded before Flop (didn't bet)



PokerStars Hand #254483320320:  Hold'em No Limit ($0.50/$1.00 USD) - 2025/01/21 13:29:48 WET [2025/01/21 8:29:48 ET]
Table 'Gyptis IV' 6-max Seat #4 is the button
Seat 1: Brookstj500 ($53.78 in chips) 
Seat 2: chinokevin13 ($100 in chips) 
Seat 3: DL1B ($106.50 in chips) 
Seat 4: Evelexy1 ($100 in chips) 
Seat 5: Rdalonso ($103.75 in chips) 
Seat 6: Cle0patr4 ($105.05 in chips) 
Rdalonso: posts small blind $0.50
Cle0patr4: posts big blind $1
*** HOLE CARDS ***
Brookstj500: folds 
chinokevin13: folds 
DL1B: raises $1.50 to $2.50
Evelexy1: folds 
Rdalonso: folds 
Cle0patr4: folds 
Uncalled bet ($1.50) returned to DL1B
DL1B collected $2.50 from pot
DL1B: doesn't show hand 
*** SUMMARY ***
Total pot $2.50 | Rake $0 
Seat 1: Brookstj500 folded before Flop (didn't bet)
Seat 2: chinokevin13 folded before Flop (didn't bet)
Seat 3: DL1B collected ($2.50)
Seat 4: Evelexy1 (button) folded before Flop (didn't bet)
Seat 5: Rdalonso (small blind) folded before Flop
Seat 6: Cle0patr4 (big blind) folded before Flop



PokerStars Hand #254483324317:  Hold'em No Limit ($0.50/$1.00 USD) - 2025/01/21 13:30:13 WET [2025/01/21 8:30:13 ET]
Table 'Gyptis IV' 6-max Seat #5 is the button
Seat 1: Brookstj500 ($53.78 in chips) 
Seat 2: chinokevin13 ($100 in chips) 
Seat 3: DL1B ($108 in chips) 
Seat 4: Evelexy1 ($100 in chips) 
Seat 5: Rdalonso ($103.25 in chips) 
Seat 6: Cle0patr4 ($104.05 in chips) 
Cle0patr4: posts small blind $0.50
Brookstj500: posts big blind $1
*** HOLE CARDS ***
chinokevin13: folds 
DL1B: raises $1 to $2
Evelexy1: folds 
Rdalonso: folds 
Cle0patr4: folds 
Brookstj500: calls $1
*** FLOP *** [4c Jd 8c]
Brookstj500: checks 
DL1B: bets $3.25
Brookstj500: folds 
Uncalled bet ($3.25) returned to DL1B
DL1B collected $4.28 from pot
DL1B: doesn't show hand 
*** SUMMARY ***
Total pot $4.50 | Rake $0.22 
Board [4c Jd 8c]
Seat 1: Brookstj500 (big blind) folded on the Flop
Seat 2: chinokevin13 folded before Flop (didn't bet)
Seat 3: DL1B collected ($4.28)
Seat 4: Evelexy1 folded before Flop (didn't bet)
Seat 5: Rdalonso (button) folded before Flop (didn't bet)
Seat 6: Cle0patr4 (small blind) folded before Flop



PokerStars Hand #254483330374:  Hold'em No Limit ($0.50/$1.00 USD) - 2025/01/21 13:30:50 WET [2025/01/21 8:30:50 ET]
Table 'Gyptis IV' 6-max Seat #6 is the button
Seat 1: Brookstj500 ($51.78 in chips) 
Seat 2: chinokevin13 ($100 in chips) 
Seat 3: DL1B ($110.28 in chips) 
Seat 4: Evelexy1 ($100 in chips) 
Seat 5: Rdalonso ($103.25 in chips) 
Seat 6: Cle0patr4 ($103.55 in chips) 
Brookstj500: posts small blind $0.50
chinokevin13: posts big blind $1
*** HOLE CARDS ***
DL1B: folds 
Evelexy1: raises $1 to $2
Rdalonso: raises $5.50 to $7.50
Cle0patr4: folds 
Brookstj500: folds 
chinokevin13: folds 
Evelexy1: folds 
Uncalled bet ($5.50) returned to Rdalonso
Rdalonso collected $5.50 from pot
Rdalonso: doesn't show hand 
*** SUMMARY ***
Total pot $5.50 | Rake $0 
Seat 1: Brookstj500 (small blind) folded before Flop
Seat 2: chinokevin13 (big blind) folded before Flop
Seat 3: DL1B folded before Flop (didn't bet)
Seat 4: Evelexy1 folded before Flop
Seat 5: Rdalonso collected ($5.50)
Seat 6: Cle0patr4 (button) folded before Flop (didn't bet)



PokerStars Hand #254483334639:  Hold'em No Limit ($0.50/$1.00 USD) - 2025/01/21 13:31:16 WET [2025/01/21 8:31:16 ET]
Table 'Gyptis IV' 6-max Seat #1 is the button
Seat 1: Brookstj500 ($51.28 in chips) 
Seat 2: chinokevin13 ($100 in chips) 
Seat 3: DL1B ($110.28 in chips) 
Seat 4: Evelexy1 ($100 in chips) 
Seat 5: Rdalonso ($106.75 in chips) 
Seat 6: Cle0patr4 ($103.55 in chips) 
chinokevin13: posts small blind $0.50
DL1B: posts big blind $1
*** HOLE CARDS ***
Evelexy1: folds 
Rdalonso: folds 
Cle0patr4: folds 
Brookstj500: calls $1
chinokevin13: folds 
DL1B: checks 
*** FLOP *** [Ac Kc Ad]
DL1B: checks 
Brookstj500: checks 
*** TURN *** [Ac Kc Ad] [Ts]
DL1B: bets $2.06
Brookstj500: folds 
Uncalled bet ($2.06) returned to DL1B
DL1B collected $2.38 from pot
DL1B: doesn't show hand 
*** SUMMARY ***
Total pot $2.50 | Rake $0.12 
Board [Ac Kc Ad Ts]
Seat 1: Brookstj500 (button) folded on the Turn
Seat 2: chinokevin13 (small blind) folded before Flop
Seat 3: DL1B (big blind) collected ($2.38)
Seat 4: Evelexy1 folded before Flop (didn't bet)
Seat 5: Rdalonso folded before Flop (didn't bet)
Seat 6: Cle0patr4 folded before Flop (didn't bet)



PokerStars Hand #254483339082:  Hold'em No Limit ($0.50/$1.00 USD) - 2025/01/21 13:31:43 WET [2025/01/21 8:31:43 ET]
Table 'Gyptis IV' 6-max Seat #2 is the button
Seat 1: Brookstj500 ($50.28 in chips) 
Seat 2: chinokevin13 ($100 in chips) 
Seat 3: DL1B ($111.66 in chips) 
Seat 4: Evelexy1 ($100 in chips) 
Seat 5: Rdalonso ($106.75 in chips) 
Seat 6: Cle0patr4 ($103.55 in chips) 
DL1B: posts small blind $0.50
Evelexy1: posts big blind $1
*** HOLE CARDS ***
Rdalonso: raises $1.50 to $2.50
Cle0patr4: folds 
Brookstj500: folds 
chinokevin13: raises $4.50 to $7
DL1B: folds 
Evelexy1: folds 
Rdalonso: folds 
Uncalled bet ($4.50) returned to chinokevin13
chinokevin13 collected $6.50 from pot
chinokevin13: doesn't show hand 
*** SUMMARY ***
Total pot $6.50 | Rake $0 
Seat 1: Brookstj500 folded before Flop (didn't bet)
Seat 2: chinokevin13 (button) collected ($6.50)
Seat 3: DL1B (small blind) folded before Flop
Seat 4: Evelexy1 (big blind) folded before Flop
Seat 5: Rdalonso folded before Flop
Seat 6: Cle0patr4 folded before Flop (didn't bet)



PokerStars Hand #254483343367:  Hold'em No Limit ($0.50/$1.00 USD) - 2025/01/21 13:32:09 WET [2025/01/21 8:32:09 ET]
Table 'Gyptis IV' 6-max Seat #3 is the button
Seat 1: Brookstj500 ($50.28 in chips) 
Seat 2: chinokevin13 ($104 in chips) 
Seat 3: DL1B ($111.16 in chips) 
Seat 4: Evelexy1 ($100 in chips) 
Seat 5: Rdalonso ($104.25 in chips) 
Seat 6: Cle0patr4 ($103.55 in chips) 
Evelexy1: posts small blind $0.50
Rdalonso: posts big blind $1
*** HOLE CARDS ***
Cle0patr4: folds 
Brookstj500: calls $1
chinokevin13: raises $3 to $4
DL1B: folds 
Evelexy1: folds 
Rdalonso: folds 
Brookstj500: folds 
Uncalled bet ($3) returned to chinokevin13
chinokevin13 collected $3.50 from pot
chinokevin13: doesn't show hand 
*** SUMMARY ***
Total pot $3.50 | Rake $0 
Seat 1: Brookstj500 folded before Flop
Seat 2: chinokevin13 collected ($3.50)
Seat 3: DL1B (button) folded before Flop (didn't bet)
Seat 4: Evelexy1 (small blind) folded before Flop
Seat 5: Rdalonso (big blind) folded before Flop
Seat 6: Cle0patr4 folded before Flop (didn't bet)



PokerStars Hand #254483346388:  Hold'em No Limit ($0.50/$1.00 USD) - 2025/01/21 13:32:27 WET [2025/01/21 8:32:27 ET]
Table 'Gyptis IV' 6-max Seat #4 is the button
Seat 1: Brookstj500 ($49.28 in chips) 
Seat 2: chinokevin13 ($106.50 in chips) 
Seat 3: DL1B ($111.16 in chips) 
Seat 4: Evelexy1 ($100 in chips) 
Seat 5: Rdalonso ($103.25 in chips) 
Seat 6: Cle0patr4 ($103.55 in chips) 
Rdalonso: posts small blind $0.50
Cle0patr4: posts big blind $1
*** HOLE CARDS ***
Brookstj500: raises $2 to $3
chinokevin13: folds 
DL1B: folds 
Evelexy1: folds 
Rdalonso: folds 
Cle0patr4: raises $8.50 to $11.50
Brookstj500: folds 
Uncalled bet ($8.50) returned to Cle0patr4
Cle0patr4 collected $6.50 from pot
Cle0patr4: doesn't show hand 
*** SUMMARY ***
Total pot $6.50 | Rake $0 
Seat 1: Brookstj500 folded before Flop
Seat 2: chinokevin13 folded before Flop (didn't bet)
Seat 3: DL1B folded before Flop (didn't bet)
Seat 4: Evelexy1 (button) folded before Flop (didn't bet)
Seat 5: Rdalonso (small blind) folded before Flop
Seat 6: Cle0patr4 (big blind) collected ($6.50)



PokerStars Hand #254483351077:  Hold'em No Limit ($0.50/$1.00 USD) - 2025/01/21 13:32:56 WET [2025/01/21 8:32:56 ET]
Table 'Gyptis IV' 6-max Seat #5 is the button
Seat 1: Brookstj500 ($46.28 in chips) 
Seat 2: chinokevin13 ($106.50 in chips) 
Seat 3: DL1B ($111.16 in chips) 
Seat 4: Evelexy1 ($100 in chips) 
Seat 5: Rdalonso ($102.75 in chips) 
Seat 6: Cle0patr4 ($107.05 in chips) 
Cle0patr4: posts small blind $0.50
Brookstj500: posts big blind $1
*** HOLE CARDS ***
chinokevin13: folds 
DL1B: folds 
Evelexy1: folds 
Rdalonso: raises $1.50 to $2.50
Cle0patr4: raises $9 to $11.50
Brookstj500: folds 
Rdalonso: calls $9
*** FLOP *** [7d Jc 4s]
Cle0patr4: bets $7.50
Rdalonso: calls $7.50
*** TURN *** [7d Jc 4s] [6d]
Cle0patr4: bets $20.50
Rdalonso: calls $20.50
*** RIVER *** [7d Jc 4s 6d] [5d]
Cle0patr4: checks 
Evelexy1 leaves the table
Cositorto joins the table at seat #4 
Rdalonso: bets $63.25 and is all-in
Cle0patr4: folds 
Uncalled bet ($63.25) returned to Rdalonso
Rdalonso collected $77.50 from pot
Rdalonso: doesn't show hand 
*** SUMMARY ***
Total pot $80 | Rake $2.50 
Board [7d Jc 4s 6d 5d]
Seat 1: Brookstj500 (big blind) folded before Flop
Seat 2: chinokevin13 folded before Flop (didn't bet)
Seat 3: DL1B folded before Flop (didn't bet)
Seat 4: Evelexy1 folded before Flop (didn't bet)
Seat 5: Rdalonso (button) collected ($77.50)
Seat 6: Cle0patr4 (small blind) folded on the River



PokerStars Hand #254483367725:  Hold'em No Limit ($0.50/$1.00 USD) - 2025/01/21 13:34:37 WET [2025/01/21 8:34:37 ET]
Table 'Gyptis IV' 6-max Seat #6 is the button
Seat 4: Cositorto ($100 in chips) is sitting out
Seat 1: Brookstj500 ($45.28 in chips) 
Seat 2: chinokevin13 ($106.50 in chips) 
Seat 3: DL1B ($111.16 in chips) 
Seat 5: Rdalonso ($140.75 in chips) 
Seat 6: Cle0patr4 ($100 in chips) 
Brookstj500: posts small blind $0.50
chinokevin13: posts big blind $1
Cositorto: sits out 
*** HOLE CARDS ***
DL1B: folds 
Rdalonso: folds 
Cle0patr4: raises $1.50 to $2.50
Brookstj500: folds 
chinokevin13: folds 
Uncalled bet ($1.50) returned to Cle0patr4
Cle0patr4 collected $2.50 from pot
Cle0patr4: doesn't show hand 
*** SUMMARY ***
Total pot $2.50 | Rake $0 
Seat 4: Cositorto
Seat 1: Brookstj500 (small blind) folded before Flop
Seat 2: chinokevin13 (big blind) folded before Flop
Seat 3: DL1B folded before Flop (didn't bet)
Seat 5: Rdalonso folded before Flop (didn't bet)
Seat 6: Cle0patr4 (button) collected ($2.50)



PokerStars Hand #254483371094:  Hold'em No Limit ($0.50/$1.00 USD) - 2025/01/21 13:34:58 WET [2025/01/21 8:34:58 ET]
Table 'Gyptis IV' 6-max Seat #1 is the button
Seat 4: Cositorto ($100 in chips) is sitting out
Seat 1: Brookstj500 ($44.78 in chips) 
Seat 2: chinokevin13 ($105.50 in chips) 
Seat 3: DL1B ($111.16 in chips) 
Seat 5: Rdalonso ($140.75 in chips) 
Seat 6: Cle0patr4 ($101.50 in chips) 
chinokevin13: posts small blind $0.50
DL1B: posts big blind $1
Cositorto: sits out 
*** HOLE CARDS ***
Rdalonso: folds 
Cle0patr4: raises $1 to $2
Brookstj500: folds 
chinokevin13: folds 
DL1B: folds 
Uncalled bet ($1) returned to Cle0patr4
Cle0patr4 collected $2.50 from pot
Cle0patr4: doesn't show hand 
*** SUMMARY ***
Total pot $2.50 | Rake $0 
Seat 4: Cositorto
Seat 1: Brookstj500 (button) folded before Flop (didn't bet)
Seat 2: chinokevin13 (small blind) folded before Flop
Seat 3: DL1B (big blind) folded before Flop
Seat 5: Rdalonso folded before Flop (didn't bet)
Seat 6: Cle0patr4 collected ($2.50)



PokerStars Hand #254483373547:  Hold'em No Limit ($0.50/$1.00 USD) - 2025/01/21 13:35:13 WET [2025/01/21 8:35:13 ET]
Table 'Gyptis IV' 6-max Seat #2 is the button
Seat 1: Brookstj500 ($44.78 in chips) 
Seat 2: chinokevin13 ($105 in chips) 
Seat 3: DL1B ($110.16 in chips) 
Seat 4: Cositorto ($100 in chips) 
Seat 5: Rdalonso ($140.75 in chips) 
Seat 6: Cle0patr4 ($103 in chips) 
DL1B: posts small blind $0.50
Cositorto: posts big blind $1
*** HOLE CARDS ***
Rdalonso: folds 
Cle0patr4: raises $1 to $2
Brookstj500: folds 
chinokevin13: folds 
DL1B: folds 
Cositorto: folds 
Uncalled bet ($1) returned to Cle0patr4
Cle0patr4 collected $2.50 from pot
Cle0patr4: doesn't show hand 
*** SUMMARY ***
Total pot $2.50 | Rake $0 
Seat 1: Brookstj500 folded before Flop (didn't bet)
Seat 2: chinokevin13 (button) folded before Flop (didn't bet)
Seat 3: DL1B (small blind) folded before Flop
Seat 4: Cositorto (big blind) folded before Flop
Seat 5: Rdalonso folded before Flop (didn't bet)
Seat 6: Cle0patr4 collected ($2.50)



PokerStars Hand #254483377015:  Hold'em No Limit ($0.50/$1.00 USD) - 2025/01/21 13:35:33 WET [2025/01/21 8:35:33 ET]
Table 'Gyptis IV' 6-max Seat #3 is the button
Seat 1: Brookstj500 ($44.78 in chips) 
Seat 2: chinokevin13 ($105 in chips) 
Seat 3: DL1B ($109.66 in chips) 
Seat 4: Cositorto ($100 in chips) 
Seat 5: Rdalonso ($140.75 in chips) 
Seat 6: Cle0patr4 ($104.50 in chips) 
Cositorto: posts small blind $0.50
Rdalonso: posts big blind $1
*** HOLE CARDS ***
Cle0patr4: folds 
Brookstj500: calls $1
chinokevin13: folds 
DL1B: folds 
Cositorto: calls $0.50
Rdalonso: raises $5 to $6
Brookstj500: folds 
Cositorto: folds 
Uncalled bet ($5) returned to Rdalonso
Rdalonso collected $3 from pot
Rdalonso: doesn't show hand 
*** SUMMARY ***
Total pot $3 | Rake $0 
Seat 1: Brookstj500 folded before Flop
Seat 2: chinokevin13 folded before Flop (didn't bet)
Seat 3: DL1B (button) folded before Flop (didn't bet)
Seat 4: Cositorto (small blind) folded before Flop
Seat 5: Rdalonso (big blind) collected ($3)
Seat 6: Cle0patr4 folded before Flop (didn't bet)



PokerStars Hand #254483381917:  Hold'em No Limit ($0.50/$1.00 USD) - 2025/01/21 13:36:03 WET [2025/01/21 8:36:03 ET]
Table 'Gyptis IV' 6-max Seat #4 is the button
Seat 1: Brookstj500 ($43.78 in chips) 
Seat 2: chinokevin13 ($105 in chips) 
Seat 3: DL1B ($109.66 in chips) 
Seat 4: Cositorto ($100 in chips) 
Seat 5: Rdalonso ($142.75 in chips) 
Seat 6: Cle0patr4 ($104.50 in chips) 
Rdalonso: posts small blind $0.50
Cle0patr4: posts big blind $1
*** HOLE CARDS ***
Brookstj500: folds 
chinokevin13: folds 
DL1B: raises $1.50 to $2.50
Cositorto: raises $5 to $7.50
Rdalonso: folds 
Cle0patr4: folds 
DL1B: folds 
Uncalled bet ($5) returned to Cositorto
Cositorto collected $6.50 from pot
Cositorto: doesn't show hand 
*** SUMMARY ***
Total pot $6.50 | Rake $0 
Seat 1: Brookstj500 folded before Flop (didn't bet)
Seat 2: chinokevin13 folded before Flop (didn't bet)
Seat 3: DL1B folded before Flop
Seat 4: Cositorto (button) collected ($6.50)
Seat 5: Rdalonso (small blind) folded before Flop
Seat 6: Cle0patr4 (big blind) folded before Flop



PokerStars Hand #254483385189:  Hold'em No Limit ($0.50/$1.00 USD) - 2025/01/21 13:36:23 WET [2025/01/21 8:36:23 ET]
Table 'Gyptis IV' 6-max Seat #5 is the button
Seat 1: Brookstj500 ($43.78 in chips) 
Seat 2: chinokevin13 ($105 in chips) 
Seat 3: DL1B ($107.16 in chips) 
Seat 4: Cositorto ($104 in chips) 
Seat 5: Rdalonso ($142.25 in chips) 
Seat 6: Cle0patr4 ($103.50 in chips) 
Cle0patr4: posts small blind $0.50
Brookstj500: posts big blind $1
*** HOLE CARDS ***
chinokevin13: folds 
DL1B: folds 
Cositorto: folds 
Rdalonso: raises $1.50 to $2.50
Cle0patr4: folds 
Brookstj500: raises $7.50 to $10
Rdalonso: folds 
Uncalled bet ($7.50) returned to Brookstj500
Brookstj500 collected $5.50 from pot
Brookstj500: doesn't show hand 
*** SUMMARY ***
Total pot $5.50 | Rake $0 
Seat 1: Brookstj500 (big blind) collected ($5.50)
Seat 2: chinokevin13 folded before Flop (didn't bet)
Seat 3: DL1B folded before Flop (didn't bet)
Seat 4: Cositorto folded before Flop (didn't bet)
Seat 5: Rdalonso (button) folded before Flop
Seat 6: Cle0patr4 (small blind) folded before Flop



PokerStars Hand #254483389229:  Hold'em No Limit ($0.50/$1.00 USD) - 2025/01/21 13:36:48 WET [2025/01/21 8:36:48 ET]
Table 'Gyptis IV' 6-max Seat #6 is the button
Seat 1: Brookstj500 ($46.78 in chips) 
Seat 2: chinokevin13 ($105 in chips) 
Seat 3: DL1B ($107.16 in chips) 
Seat 4: Cositorto ($104 in chips) 
Seat 5: Rdalonso ($139.75 in chips) 
Seat 6: Cle0patr4 ($103 in chips) 
Brookstj500: posts small blind $0.50
chinokevin13: posts big blind $1
*** HOLE CARDS ***
DL1B: raises $1 to $2
Cositorto: folds 
Rdalonso: folds 
Cle0patr4: raises $5 to $7
Brookstj500: folds 
chinokevin13: folds 
DL1B: folds 
Uncalled bet ($5) returned to Cle0patr4
Cle0patr4 collected $5.50 from pot
Cle0patr4: doesn't show hand 
DL1B leaves the table
*** SUMMARY ***
Total pot $5.50 | Rake $0 
Seat 1: Brookstj500 (small blind) folded before Flop
Seat 2: chinokevin13 (big blind) folded before Flop
Seat 3: DL1B folded before Flop
Seat 4: Cositorto folded before Flop (didn't bet)
Seat 5: Rdalonso folded before Flop (didn't bet)
Seat 6: Cle0patr4 (button) collected ($5.50)



PokerStars Hand #254483392433:  Hold'em No Limit ($0.50/$1.00 USD) - 2025/01/21 13:37:07 WET [2025/01/21 8:37:07 ET]
Table 'Gyptis IV' 6-max Seat #1 is the button
Seat 1: Brookstj500 ($46.28 in chips) 
Seat 2: chinokevin13 ($104 in chips) 
Seat 4: Cositorto ($104 in chips) 
Seat 5: Rdalonso ($139.75 in chips) 
Seat 6: Cle0patr4 ($106.50 in chips) 
chinokevin13: posts small blind $0.50
Cositorto: posts big blind $1
*** HOLE CARDS ***
Rdalonso: folds 
Cle0patr4: folds 
Brookstj500: calls $1
chinokevin13: folds 
Cositorto: checks 
*** FLOP *** [Jh 8d 4d]
Cositorto: checks 
Brookstj500: bets $3
Cositorto: calls $3
*** TURN *** [Jh 8d 4d] [Ac]
Cositorto: checks 
LeaveItYeah joins the table at seat #3 
Brookstj500: checks 
*** RIVER *** [Jh 8d 4d Ac] [4s]
Cositorto: bets $4.04
Brookstj500: calls $4.04
*** SHOW DOWN ***
Cositorto: shows [Tc 4c] (three of a kind, Fours)
Brookstj500: mucks hand 
Cositorto collected $15.75 from pot
*** SUMMARY ***
Total pot $16.58 | Rake $0.83 
Board [Jh 8d 4d Ac 4s]
Seat 1: Brookstj500 (button) mucked
Seat 2: chinokevin13 (small blind) folded before Flop
Seat 4: Cositorto (big blind) showed [Tc 4c] and won ($15.75) with three of a kind, Fours
Seat 5: Rdalonso folded before Flop (didn't bet)
Seat 6: Cle0patr4 folded before Flop (didn't bet)



PokerStars Hand #254483402873:  Hold'em No Limit ($0.50/$1.00 USD) - 2025/01/21 13:38:09 WET [2025/01/21 8:38:09 ET]
Table 'Gyptis IV' 6-max Seat #2 is the button
Seat 3: LeaveItYeah ($100 in chips) is sitting out
Seat 1: Brookstj500 ($38.24 in chips) 
Seat 2: chinokevin13 ($103.50 in chips) 
Seat 4: Cositorto ($111.71 in chips) 
Seat 5: Rdalonso ($139.75 in chips) 
Seat 6: Cle0patr4 ($106.50 in chips) 
Cositorto: posts small blind $0.50
Rdalonso: posts big blind $1
*** HOLE CARDS ***
Cle0patr4: folds 
Brookstj500: calls $1
chinokevin13: raises $2 to $3
Cositorto: folds 
Rdalonso: folds 
Brookstj500: calls $2
*** FLOP *** [3c 6c Td]
Brookstj500: checks 
chinokevin13: bets $2.35
Brookstj500: folds 
Uncalled bet ($2.35) returned to chinokevin13
chinokevin13 collected $7.12 from pot
chinokevin13: doesn't show hand 
*** SUMMARY ***
Total pot $7.50 | Rake $0.38 
Board [3c 6c Td]
Seat 3: LeaveItYeah
Seat 1: Brookstj500 folded on the Flop
Seat 2: chinokevin13 (button) collected ($7.12)
Seat 4: Cositorto (small blind) folded before Flop
Seat 5: Rdalonso (big blind) folded before Flop
Seat 6: Cle0patr4 folded before Flop (didn't bet)



PokerStars Hand #254483410100:  Hold'em No Limit ($0.50/$1.00 USD) - 2025/01/21 13:38:53 WET [2025/01/21 8:38:53 ET]
Table 'Gyptis IV' 6-max Seat #4 is the button
Seat 3: LeaveItYeah ($100 in chips) is sitting out
Seat 1: Brookstj500 ($35.24 in chips) 
Seat 2: chinokevin13 ($107.62 in chips) 
Seat 4: Cositorto ($111.21 in chips) 
Seat 5: Rdalonso ($138.75 in chips) 
Seat 6: Cle0patr4 ($106.50 in chips) 
Rdalonso: posts small blind $0.50
Cle0patr4: posts big blind $1
LeaveItYeah: sits out 
*** HOLE CARDS ***
Brookstj500: folds 
chinokevin13: raises $1.50 to $2.50
Cositorto: folds 
Rdalonso: raises $8.50 to $11
Cle0patr4: folds 
chinokevin13: folds 
Uncalled bet ($8.50) returned to Rdalonso
Rdalonso collected $6 from pot
Rdalonso: doesn't show hand 
*** SUMMARY ***
Total pot $6 | Rake $0 
Seat 3: LeaveItYeah
Seat 1: Brookstj500 folded before Flop (didn't bet)
Seat 2: chinokevin13 folded before Flop
Seat 4: Cositorto (button) folded before Flop (didn't bet)
Seat 5: Rdalonso (small blind) collected ($6)
Seat 6: Cle0patr4 (big blind) folded before Flop



PokerStars Hand #254483416275:  Hold'em No Limit ($0.50/$1.00 USD) - 2025/01/21 13:39:30 WET [2025/01/21 8:39:30 ET]
Table 'Gyptis IV' 6-max Seat #5 is the button
Seat 3: LeaveItYeah ($100 in chips) is sitting out
Seat 1: Brookstj500 ($35.24 in chips) 
Seat 2: chinokevin13 ($105.12 in chips) 
Seat 4: Cositorto ($111.21 in chips) 
Seat 5: Rdalonso ($142.25 in chips) 
Seat 6: Cle0patr4 ($105.50 in chips) 
Cle0patr4: posts small blind $0.50
Brookstj500: posts big blind $1
LeaveItYeah: sits out 
*** HOLE CARDS ***
chinokevin13: raises $1.20 to $2.20
Cositorto: folds 
Rdalonso: folds 
Cle0patr4: folds 
Brookstj500: calls $1.20
*** FLOP *** [7c Td 7d]
Brookstj500: checks 
chinokevin13: bets $1.54
Brookstj500: calls $1.54
*** TURN *** [7c Td 7d] [8c]
Brookstj500: checks 
chinokevin13: bets $2.50
Brookstj500: calls $2.50
*** RIVER *** [7c Td 7d 8c] [5d]
Brookstj500: checks 
chinokevin13: bets $4.06
Brookstj500: calls $4.06
*** SHOW DOWN ***
chinokevin13: shows [Tc Ts] (a full house, Tens full of Sevens)
Brookstj500: mucks hand 
chinokevin13 collected $20.04 from pot
*** SUMMARY ***
Total pot $21.10 | Rake $1.06 
Board [7c Td 7d 8c 5d]
Seat 3: LeaveItYeah
Seat 1: Brookstj500 (big blind) mucked
Seat 2: chinokevin13 showed [Tc Ts] and won ($20.04) with a full house, Tens full of Sevens
Seat 4: Cositorto folded before Flop (didn't bet)
Seat 5: Rdalonso (button) folded before Flop (didn't bet)
Seat 6: Cle0patr4 (small blind) folded before Flop



PokerStars Hand #254483429590:  Hold'em No Limit ($0.50/$1.00 USD) - 2025/01/21 13:40:49 WET [2025/01/21 8:40:49 ET]
Table 'Gyptis IV' 6-max Seat #6 is the button
Seat 3: LeaveItYeah ($100 in chips) is sitting out
Seat 1: Brookstj500 ($24.94 in chips) 
Seat 2: chinokevin13 ($114.86 in chips) 
Seat 4: Cositorto ($111.21 in chips) 
Seat 5: Rdalonso ($142.25 in chips) 
Seat 6: Cle0patr4 ($105 in chips) 
Brookstj500: posts small blind $0.50
chinokevin13: posts big blind $1
LeaveItYeah: sits out 
*** HOLE CARDS ***
Cositorto: folds 
Rdalonso: folds 
Cle0patr4: raises $1 to $2
Brookstj500: calls $1.50
chinokevin13: folds 
*** FLOP *** [Ad 7h Qc]
Brookstj500: checks 
Cle0patr4: bets $3
Brookstj500: folds 
Uncalled bet ($3) returned to Cle0patr4
Cle0patr4 collected $4.75 from pot
Cle0patr4: doesn't show hand 
*** SUMMARY ***
Total pot $5 | Rake $0.25 
Board [Ad 7h Qc]
Seat 3: LeaveItYeah
Seat 1: Brookstj500 (small blind) folded on the Flop
Seat 2: chinokevin13 (big blind) folded before Flop
Seat 4: Cositorto folded before Flop (didn't bet)
Seat 5: Rdalonso folded before Flop (didn't bet)
Seat 6: Cle0patr4 (button) collected ($4.75)



PokerStars Hand #254483436389:  Hold'em No Limit ($0.50/$1.00 USD) - 2025/01/21 13:41:31 WET [2025/01/21 8:41:31 ET]
Table 'Gyptis IV' 6-max Seat #1 is the button
Seat 1: Brookstj500 ($22.94 in chips) 
Seat 2: chinokevin13 ($113.86 in chips) 
Seat 3: LeaveItYeah ($100 in chips) 
Seat 4: Cositorto ($111.21 in chips) 
Seat 5: Rdalonso ($142.25 in chips) 
Seat 6: Cle0patr4 ($107.75 in chips) 
chinokevin13: posts small blind $0.50
LeaveItYeah: posts big blind $1
*** HOLE CARDS ***
Cositorto: folds 
Rdalonso: raises $1.50 to $2.50
Cle0patr4: folds 
Brookstj500: folds 
chinokevin13: folds 
LeaveItYeah: folds 
Uncalled bet ($1.50) returned to Rdalonso
Rdalonso collected $2.50 from pot
Rdalonso: doesn't show hand 
*** SUMMARY ***
Total pot $2.50 | Rake $0 
Seat 1: Brookstj500 (button) folded before Flop (didn't bet)
Seat 2: chinokevin13 (small blind) folded before Flop
Seat 3: LeaveItYeah (big blind) folded before Flop
Seat 4: Cositorto folded before Flop (didn't bet)
Seat 5: Rdalonso collected ($2.50)
Seat 6: Cle0patr4 folded before Flop (didn't bet)



PokerStars Hand #254483440557:  Hold'em No Limit ($0.50/$1.00 USD) - 2025/01/21 13:41:56 WET [2025/01/21 8:41:56 ET]
Table 'Gyptis IV' 6-max Seat #2 is the button
Seat 1: Brookstj500 ($22.94 in chips) 
Seat 2: chinokevin13 ($113.36 in chips) 
Seat 3: LeaveItYeah ($100 in chips) 
Seat 4: Cositorto ($111.21 in chips) 
Seat 5: Rdalonso ($143.75 in chips) 
Seat 6: Cle0patr4 ($107.75 in chips) 
LeaveItYeah: posts small blind $0.50
Cositorto: posts big blind $1
*** HOLE CARDS ***
Rdalonso: folds 
Cle0patr4: folds 
Brookstj500: raises $3 to $4
chinokevin13: folds 
LeaveItYeah: folds 
Cositorto: folds 
Uncalled bet ($3) returned to Brookstj500
Brookstj500 collected $2.50 from pot
Brookstj500: doesn't show hand 
*** SUMMARY ***
Total pot $2.50 | Rake $0 
Seat 1: Brookstj500 collected ($2.50)
Seat 2: chinokevin13 (button) folded before Flop (didn't bet)
Seat 3: LeaveItYeah (small blind) folded before Flop
Seat 4: Cositorto (big blind) folded before Flop
Seat 5: Rdalonso folded before Flop (didn't bet)
Seat 6: Cle0patr4 folded before Flop (didn't bet)



PokerStars Hand #254483444441:  Hold'em No Limit ($0.50/$1.00 USD) - 2025/01/21 13:42:20 WET [2025/01/21 8:42:20 ET]
Table 'Gyptis IV' 6-max Seat #3 is the button
Seat 1: Brookstj500 ($24.44 in chips) 
Seat 2: chinokevin13 ($113.36 in chips) 
Seat 3: LeaveItYeah ($100 in chips) 
Seat 4: Cositorto ($110.21 in chips) 
Seat 5: Rdalonso ($143.75 in chips) 
Seat 6: Cle0patr4 ($107.75 in chips) 
Cositorto: posts small blind $0.50
Rdalonso: posts big blind $1
*** HOLE CARDS ***
Cle0patr4: folds 
Brookstj500: folds 
chinokevin13: folds 
LeaveItYeah: folds 
Cositorto: folds 
Uncalled bet ($0.50) returned to Rdalonso
Rdalonso collected $1 from pot
Rdalonso: doesn't show hand 
*** SUMMARY ***
Total pot $1 | Rake $0 
Seat 1: Brookstj500 folded before Flop (didn't bet)
Seat 2: chinokevin13 folded before Flop (didn't bet)
Seat 3: LeaveItYeah (button) folded before Flop (didn't bet)
Seat 4: Cositorto (small blind) folded before Flop
Seat 5: Rdalonso (big blind) collected ($1)
Seat 6: Cle0patr4 folded before Flop (didn't bet)



PokerStars Hand #254483446724:  Hold'em No Limit ($0.50/$1.00 USD) - 2025/01/21 13:42:33 WET [2025/01/21 8:42:33 ET]
Table 'Gyptis IV' 6-max Seat #4 is the button
Seat 1: Brookstj500 ($24.44 in chips) 
Seat 2: chinokevin13 ($113.36 in chips) 
Seat 3: LeaveItYeah ($100 in chips) 
Seat 4: Cositorto ($109.71 in chips) 
Seat 5: Rdalonso ($144.25 in chips) 
Seat 6: Cle0patr4 ($107.75 in chips) 
Rdalonso: posts small blind $0.50
Cle0patr4: posts big blind $1
*** HOLE CARDS ***
Brookstj500: folds 
chinokevin13: raises $1.20 to $2.20
LeaveItYeah: folds 
Cositorto: folds 
Rdalonso: folds 
Cle0patr4: folds 
Uncalled bet ($1.20) returned to chinokevin13
chinokevin13 collected $2.50 from pot
chinokevin13: doesn't show hand 
*** SUMMARY ***
Total pot $2.50 | Rake $0 
Seat 1: Brookstj500 folded before Flop (didn't bet)
Seat 2: chinokevin13 collected ($2.50)
Seat 3: LeaveItYeah folded before Flop (didn't bet)
Seat 4: Cositorto (button) folded before Flop (didn't bet)
Seat 5: Rdalonso (small blind) folded before Flop
Seat 6: Cle0patr4 (big blind) folded before Flop



PokerStars Hand #254483449925:  Hold'em No Limit ($0.50/$1.00 USD) - 2025/01/21 13:42:52 WET [2025/01/21 8:42:52 ET]
Table 'Gyptis IV' 6-max Seat #5 is the button
Seat 1: Brookstj500 ($24.44 in chips) 
Seat 2: chinokevin13 ($114.86 in chips) 
Seat 3: LeaveItYeah ($100 in chips) 
Seat 4: Cositorto ($109.71 in chips) 
Seat 5: Rdalonso ($143.75 in chips) 
Seat 6: Cle0patr4 ($106.75 in chips) 
Cle0patr4: posts small blind $0.50
Brookstj500: posts big blind $1
*** HOLE CARDS ***
chinokevin13: folds 
LeaveItYeah: folds 
Cositorto: folds 
Rdalonso: folds 
Cle0patr4: raises $2 to $3
Brookstj500: calls $2
*** FLOP *** [Kc Jd 3h]
Cle0patr4: bets $1.50
Brookstj500: folds 
Uncalled bet ($1.50) returned to Cle0patr4
Cle0patr4 collected $5.70 from pot
Cle0patr4: doesn't show hand 
*** SUMMARY ***
Total pot $6 | Rake $0.30 
Board [Kc Jd 3h]
Seat 1: Brookstj500 (big blind) folded on the Flop
Seat 2: chinokevin13 folded before Flop (didn't bet)
Seat 3: LeaveItYeah folded before Flop (didn't bet)
Seat 4: Cositorto folded before Flop (didn't bet)
Seat 5: Rdalonso (button) folded before Flop (didn't bet)
Seat 6: Cle0patr4 (small blind) collected ($5.70)



PokerStars Hand #254483455516:  Hold'em No Limit ($0.50/$1.00 USD) - 2025/01/21 13:43:26 WET [2025/01/21 8:43:26 ET]
Table 'Gyptis IV' 6-max Seat #6 is the button
Seat 1: Brookstj500 ($21.44 in chips) 
Seat 2: chinokevin13 ($114.86 in chips) 
Seat 3: LeaveItYeah ($100 in chips) 
Seat 4: Cositorto ($109.71 in chips) 
Seat 5: Rdalonso ($143.75 in chips) 
Seat 6: Cle0patr4 ($109.45 in chips) 
Brookstj500: posts small blind $0.50
chinokevin13: posts big blind $1
*** HOLE CARDS ***
LeaveItYeah: folds 
Cositorto: folds 
Rdalonso: raises $1.50 to $2.50
Cle0patr4: folds 
Brookstj500: folds 
chinokevin13: folds 
Uncalled bet ($1.50) returned to Rdalonso
Rdalonso collected $2.50 from pot
Rdalonso: doesn't show hand 
*** SUMMARY ***
Total pot $2.50 | Rake $0 
Seat 1: Brookstj500 (small blind) folded before Flop
Seat 2: chinokevin13 (big blind) folded before Flop
Seat 3: LeaveItYeah folded before Flop (didn't bet)
Seat 4: Cositorto folded before Flop (didn't bet)
Seat 5: Rdalonso collected ($2.50)
Seat 6: Cle0patr4 (button) folded before Flop (didn't bet)



PokerStars Hand #254483461599:  Hold'em No Limit ($0.50/$1.00 USD) - 2025/01/21 13:44:03 WET [2025/01/21 8:44:03 ET]
Table 'Gyptis IV' 6-max Seat #1 is the button
Seat 1: Brookstj500 ($20.94 in chips) 
Seat 2: chinokevin13 ($113.86 in chips) 
Seat 3: LeaveItYeah ($100 in chips) 
Seat 4: Cositorto ($109.71 in chips) 
Seat 5: Rdalonso ($145.25 in chips) 
Seat 6: Cle0patr4 ($109.45 in chips) 
chinokevin13: posts small blind $0.50
LeaveItYeah: posts big blind $1
*** HOLE CARDS ***
Cositorto: raises $1 to $2
Rdalonso: folds 
Cle0patr4: folds 
Brookstj500: folds 
chinokevin13: folds 
LeaveItYeah: folds 
Uncalled bet ($1) returned to Cositorto
Cositorto collected $2.50 from pot
Cositorto: doesn't show hand 
*** SUMMARY ***
Total pot $2.50 | Rake $0 
Seat 1: Brookstj500 (button) folded before Flop (didn't bet)
Seat 2: chinokevin13 (small blind) folded before Flop
Seat 3: LeaveItYeah (big blind) folded before Flop
Seat 4: Cositorto collected ($2.50)
Seat 5: Rdalonso folded before Flop (didn't bet)
Seat 6: Cle0patr4 folded before Flop (didn't bet)



PokerStars Hand #254483463923:  Hold'em No Limit ($0.50/$1.00 USD) - 2025/01/21 13:44:17 WET [2025/01/21 8:44:17 ET]
Table 'Gyptis IV' 6-max Seat #2 is the button
Seat 1: Brookstj500 ($20.94 in chips) 
Seat 2: chinokevin13 ($113.36 in chips) 
Seat 3: LeaveItYeah ($100 in chips) 
Seat 4: Cositorto ($111.21 in chips) 
Seat 5: Rdalonso ($145.25 in chips) 
Seat 6: Cle0patr4 ($109.45 in chips) 
LeaveItYeah: posts small blind $0.50
Cositorto: posts big blind $1
*** HOLE CARDS ***
Rdalonso: raises $1.50 to $2.50
Cle0patr4: folds 
Brookstj500: folds 
chinokevin13: raises $4.50 to $7
LeaveItYeah: folds 
Cositorto: folds 
Rdalonso: folds 
Uncalled bet ($4.50) returned to chinokevin13
chinokevin13 collected $6.50 from pot
chinokevin13: doesn't show hand 
*** SUMMARY ***
Total pot $6.50 | Rake $0 
Seat 1: Brookstj500 folded before Flop (didn't bet)
Seat 2: chinokevin13 (button) collected ($6.50)
Seat 3: LeaveItYeah (small blind) folded before Flop
Seat 4: Cositorto (big blind) folded before Flop
Seat 5: Rdalonso folded before Flop
Seat 6: Cle0patr4 folded before Flop (didn't bet)



PokerStars Hand #254483467502:  Hold'em No Limit ($0.50/$1.00 USD) - 2025/01/21 13:44:39 WET [2025/01/21 8:44:39 ET]
Table 'Gyptis IV' 6-max Seat #3 is the button
Seat 1: Brookstj500 ($20.94 in chips) 
Seat 2: chinokevin13 ($117.36 in chips) 
Seat 3: LeaveItYeah ($100 in chips) 
Seat 4: Cositorto ($110.21 in chips) 
Seat 5: Rdalonso ($142.75 in chips) 
Seat 6: Cle0patr4 ($109.45 in chips) 
Cositorto: posts small blind $0.50
Rdalonso: posts big blind $1
*** HOLE CARDS ***
Cle0patr4: raises $1 to $2
Brookstj500: folds 
chinokevin13: folds 
LeaveItYeah: folds 
Cositorto: folds 
Rdalonso: folds 
Uncalled bet ($1) returned to Cle0patr4
Cle0patr4 collected $2.50 from pot
Cle0patr4: doesn't show hand 
*** SUMMARY ***
Total pot $2.50 | Rake $0 
Seat 1: Brookstj500 folded before Flop (didn't bet)
Seat 2: chinokevin13 folded before Flop (didn't bet)
Seat 3: LeaveItYeah (button) folded before Flop (didn't bet)
Seat 4: Cositorto (small blind) folded before Flop
Seat 5: Rdalonso (big blind) folded before Flop
Seat 6: Cle0patr4 collected ($2.50)



PokerStars Hand #254483470787:  Hold'em No Limit ($0.50/$1.00 USD) - 2025/01/21 13:44:58 WET [2025/01/21 8:44:58 ET]
Table 'Gyptis IV' 6-max Seat #4 is the button
Seat 1: Brookstj500 ($20.94 in chips) 
Seat 2: chinokevin13 ($117.36 in chips) 
Seat 3: LeaveItYeah ($100 in chips) 
Seat 4: Cositorto ($109.71 in chips) 
Seat 5: Rdalonso ($141.75 in chips) 
Seat 6: Cle0patr4 ($110.95 in chips) 
Rdalonso: posts small blind $0.50
Cle0patr4: posts big blind $1
*** HOLE CARDS ***
Brookstj500: folds 
chinokevin13: folds 
LeaveItYeah has timed out
LeaveItYeah: folds 
Cositorto: folds 
Rdalonso: folds 
Uncalled bet ($0.50) returned to Cle0patr4
Cle0patr4 collected $1 from pot
Cle0patr4: doesn't show hand 
*** SUMMARY ***
Total pot $1 | Rake $0 
Seat 1: Brookstj500 folded before Flop (didn't bet)
Seat 2: chinokevin13 folded before Flop (didn't bet)
Seat 3: LeaveItYeah folded before Flop (didn't bet)
Seat 4: Cositorto (button) folded before Flop (didn't bet)
Seat 5: Rdalonso (small blind) folded before Flop
Seat 6: Cle0patr4 (big blind) collected ($1)



PokerStars Hand #254483474997:  Hold'em No Limit ($0.50/$1.00 USD) - 2025/01/21 13:45:24 WET [2025/01/21 8:45:24 ET]
Table 'Gyptis IV' 6-max Seat #5 is the button
Seat 3: LeaveItYeah ($100 in chips) is sitting out
Seat 1: Brookstj500 ($20.94 in chips) 
Seat 2: chinokevin13 ($117.36 in chips) 
Seat 4: Cositorto ($109.71 in chips) 
Seat 5: Rdalonso ($141.25 in chips) 
Seat 6: Cle0patr4 ($111.45 in chips) 
Cle0patr4: posts small blind $0.50
Brookstj500: posts big blind $1
*** HOLE CARDS ***
chinokevin13: folds 
Cositorto: raises $1 to $2
Rdalonso: folds 
Cle0patr4: folds 
Brookstj500: calls $1
*** FLOP *** [5s 8d 9h]
Brookstj500: checks 
Cositorto: bets $1.16
Brookstj500: calls $1.16
*** TURN *** [5s 8d 9h] [Ac]
Brookstj500: checks 
Cositorto: checks 
*** RIVER *** [5s 8d 9h Ac] [7s]
Brookstj500: checks 
Cositorto: checks 
*** SHOW DOWN ***
Brookstj500: shows [8s Jc] (a pair of Eights)
Cositorto: mucks hand 
Brookstj500 collected $6.48 from pot
*** SUMMARY ***
Total pot $6.82 | Rake $0.34 
Board [5s 8d 9h Ac 7s]
Seat 3: LeaveItYeah
Seat 1: Brookstj500 (big blind) showed [8s Jc] and won ($6.48) with a pair of Eights
Seat 2: chinokevin13 folded before Flop (didn't bet)
Seat 4: Cositorto mucked
Seat 5: Rdalonso (button) folded before Flop (didn't bet)
Seat 6: Cle0patr4 (small blind) folded before Flop



PokerStars Hand #254483484481:  Hold'em No Limit ($0.50/$1.00 USD) - 2025/01/21 13:46:21 WET [2025/01/21 8:46:21 ET]
Table 'Gyptis IV' 6-max Seat #6 is the button
Seat 1: Brookstj500 ($24.26 in chips) 
Seat 2: chinokevin13 ($117.36 in chips) 
Seat 3: LeaveItYeah ($100 in chips) 
Seat 4: Cositorto ($106.55 in chips) 
Seat 5: Rdalonso ($141.25 in chips) 
Seat 6: Cle0patr4 ($110.95 in chips) 
Brookstj500: posts small blind $0.50
chinokevin13: posts big blind $1
*** HOLE CARDS ***
LeaveItYeah: folds 
Cositorto: raises $1 to $2
Rdalonso: folds 
Cle0patr4: folds 
Brookstj500: folds 
chinokevin13: folds 
Uncalled bet ($1) returned to Cositorto
Cositorto collected $2.50 from pot
Cositorto: doesn't show hand 
*** SUMMARY ***
Total pot $2.50 | Rake $0 
Seat 1: Brookstj500 (small blind) folded before Flop
Seat 2: chinokevin13 (big blind) folded before Flop
Seat 3: LeaveItYeah folded before Flop (didn't bet)
Seat 4: Cositorto collected ($2.50)
Seat 5: Rdalonso folded before Flop (didn't bet)
Seat 6: Cle0patr4 (button) folded before Flop (didn't bet)



PokerStars Hand #254483490947:  Hold'em No Limit ($0.50/$1.00 USD) - 2025/01/21 13:47:00 WET [2025/01/21 8:47:00 ET]
Table 'Gyptis IV' 6-max Seat #1 is the button
Seat 1: Brookstj500 ($23.76 in chips) 
Seat 2: chinokevin13 ($116.36 in chips) 
Seat 3: LeaveItYeah ($100 in chips) 
Seat 4: Cositorto ($108.05 in chips) 
Seat 5: Rdalonso ($141.25 in chips) 
Seat 6: Cle0patr4 ($110.95 in chips) 
chinokevin13: posts small blind $0.50
LeaveItYeah: posts big blind $1
*** HOLE CARDS ***
Cositorto: folds 
Rdalonso: folds 
Cle0patr4: raises $1 to $2
Brookstj500: calls $2
chinokevin13: folds 
LeaveItYeah: folds 
*** FLOP *** [Kh 9s Ks]
Cle0patr4: bets $1.15
Brookstj500: calls $1.15
*** TURN *** [Kh 9s Ks] [Ah]
Cle0patr4: bets $3.93
Brookstj500: folds 
Uncalled bet ($3.93) returned to Cle0patr4
Cle0patr4 collected $7.41 from pot
Cle0patr4: doesn't show hand 
*** SUMMARY ***
Total pot $7.80 | Rake $0.39 
Board [Kh 9s Ks Ah]
Seat 1: Brookstj500 (button) folded on the Turn
Seat 2: chinokevin13 (small blind) folded before Flop
Seat 3: LeaveItYeah (big blind) folded before Flop
Seat 4: Cositorto folded before Flop (didn't bet)
Seat 5: Rdalonso folded before Flop (didn't bet)
Seat 6: Cle0patr4 collected ($7.41)



PokerStars Hand #254483496371:  Hold'em No Limit ($0.50/$1.00 USD) - 2025/01/21 13:47:33 WET [2025/01/21 8:47:33 ET]
Table 'Gyptis IV' 6-max Seat #2 is the button
Seat 1: Brookstj500 ($20.61 in chips) 
Seat 2: chinokevin13 ($115.86 in chips) 
Seat 3: LeaveItYeah ($100 in chips) 
Seat 4: Cositorto ($108.05 in chips) 
Seat 5: Rdalonso ($141.25 in chips) 
Seat 6: Cle0patr4 ($115.21 in chips) 
LeaveItYeah: posts small blind $0.50
Cositorto: posts big blind $1
*** HOLE CARDS ***
Rdalonso: raises $1.50 to $2.50
Cle0patr4: folds 
Brookstj500: folds 
chinokevin13: folds 
LeaveItYeah: folds 
Cositorto: folds 
Uncalled bet ($1.50) returned to Rdalonso
Rdalonso collected $2.50 from pot
Rdalonso: doesn't show hand 
*** SUMMARY ***
Total pot $2.50 | Rake $0 
Seat 1: Brookstj500 folded before Flop (didn't bet)
Seat 2: chinokevin13 (button) folded before Flop (didn't bet)
Seat 3: LeaveItYeah (small blind) folded before Flop
Seat 4: Cositorto (big blind) folded before Flop
Seat 5: Rdalonso collected ($2.50)
Seat 6: Cle0patr4 folded before Flop (didn't bet)



PokerStars Hand #254483500546:  Hold'em No Limit ($0.50/$1.00 USD) - 2025/01/21 13:47:58 WET [2025/01/21 8:47:58 ET]
Table 'Gyptis IV' 6-max Seat #3 is the button
Seat 1: Brookstj500 ($20.61 in chips) 
Seat 2: chinokevin13 ($115.86 in chips) 
Seat 3: LeaveItYeah ($100 in chips) 
Seat 4: Cositorto ($107.05 in chips) 
Seat 5: Rdalonso ($142.75 in chips) 
Seat 6: Cle0patr4 ($115.21 in chips) 
Cositorto: posts small blind $0.50
Rdalonso: posts big blind $1
*** HOLE CARDS ***
Cle0patr4: folds 
Brookstj500: folds 
chinokevin13: folds 
LeaveItYeah: raises $1.50 to $2.50
Cositorto: folds 
Rdalonso: calls $1.50
*** FLOP *** [4d 6d 3d]
Rdalonso: checks 
LeaveItYeah: checks 
*** TURN *** [4d 6d 3d] [9c]
Rdalonso: checks 
LeaveItYeah: checks 
*** RIVER *** [4d 6d 3d 9c] [5c]
Rdalonso: checks 
LeaveItYeah: checks 
*** SHOW DOWN ***
Rdalonso: shows [Ad Jc] (high card Ace)
LeaveItYeah: shows [Qs As] (high card Ace - Queen kicker)
LeaveItYeah collected $5.22 from pot
*** SUMMARY ***
Total pot $5.50 | Rake $0.28 
Board [4d 6d 3d 9c 5c]
Seat 1: Brookstj500 folded before Flop (didn't bet)
Seat 2: chinokevin13 folded before Flop (didn't bet)
Seat 3: LeaveItYeah (button) showed [Qs As] and won ($5.22) with high card Ace
Seat 4: Cositorto (small blind) folded before Flop
Seat 5: Rdalonso (big blind) showed [Ad Jc] and lost with high card Ace
Seat 6: Cle0patr4 folded before Flop (didn't bet)



PokerStars Hand #254483510175:  Hold'em No Limit ($0.50/$1.00 USD) - 2025/01/21 13:48:58 WET [2025/01/21 8:48:58 ET]
Table 'Gyptis IV' 6-max Seat #4 is the button
Seat 6: Cle0patr4 ($115.21 in chips) is sitting out
Seat 1: Brookstj500 ($20.61 in chips) 
Seat 2: chinokevin13 ($115.86 in chips) 
Seat 3: LeaveItYeah ($102.72 in chips) 
Seat 4: Cositorto ($106.55 in chips) 
Seat 5: Rdalonso ($140.25 in chips) 
Rdalonso: posts small blind $0.50
Brookstj500: posts big blind $1
*** HOLE CARDS ***
chinokevin13: folds 
LeaveItYeah: folds 
Cositorto: folds 
Rdalonso: folds 
Uncalled bet ($0.50) returned to Brookstj500
Brookstj500 collected $1 from pot
Brookstj500: doesn't show hand 
*** SUMMARY ***
Total pot $1 | Rake $0 
Seat 6: Cle0patr4
Seat 1: Brookstj500 (big blind) collected ($1)
Seat 2: chinokevin13 folded before Flop (didn't bet)
Seat 3: LeaveItYeah folded before Flop (didn't bet)
Seat 4: Cositorto (button) folded before Flop (didn't bet)
Seat 5: Rdalonso (small blind) folded before Flop



PokerStars Hand #254483512593:  Hold'em No Limit ($0.50/$1.00 USD) - 2025/01/21 13:49:13 WET [2025/01/21 8:49:13 ET]
Table 'Gyptis IV' 6-max Seat #5 is the button
Seat 6: Cle0patr4 ($115.21 in chips) is sitting out
Seat 1: Brookstj500 ($21.11 in chips) 
Seat 2: chinokevin13 ($115.86 in chips) 
Seat 3: LeaveItYeah ($102.72 in chips) 
Seat 4: Cositorto ($106.55 in chips) 
Seat 5: Rdalonso ($139.75 in chips) 
Brookstj500: posts small blind $0.50
chinokevin13: posts big blind $1
*** HOLE CARDS ***
LeaveItYeah: folds 
Cositorto: raises $1 to $2
Rdalonso: folds 
Brookstj500: folds 
chinokevin13: folds 
Uncalled bet ($1) returned to Cositorto
Cositorto collected $2.50 from pot
Cositorto: doesn't show hand 
*** SUMMARY ***
Total pot $2.50 | Rake $0 
Seat 6: Cle0patr4
Seat 1: Brookstj500 (small blind) folded before Flop
Seat 2: chinokevin13 (big blind) folded before Flop
Seat 3: LeaveItYeah folded before Flop (didn't bet)
Seat 4: Cositorto collected ($2.50)
Seat 5: Rdalonso (button) folded before Flop (didn't bet)



PokerStars Hand #254483516735:  Hold'em No Limit ($0.50/$1.00 USD) - 2025/01/21 13:49:39 WET [2025/01/21 8:49:39 ET]
Table 'Gyptis IV' 6-max Seat #1 is the button
Seat 6: Cle0patr4 ($115.21 in chips) is sitting out
Seat 1: Brookstj500 ($20.61 in chips) 
Seat 2: chinokevin13 ($114.86 in chips) 
Seat 3: LeaveItYeah ($102.72 in chips) 
Seat 4: Cositorto ($108.05 in chips) 
Seat 5: Rdalonso ($139.75 in chips) 
chinokevin13: posts small blind $0.50
LeaveItYeah: posts big blind $1
*** HOLE CARDS ***
Cositorto: folds 
Rdalonso: folds 
Brookstj500: folds 
chinokevin13: folds 
Uncalled bet ($0.50) returned to LeaveItYeah
LeaveItYeah collected $1 from pot
LeaveItYeah: doesn't show hand 
*** SUMMARY ***
Total pot $1 | Rake $0 
Seat 6: Cle0patr4
Seat 1: Brookstj500 (button) folded before Flop (didn't bet)
Seat 2: chinokevin13 (small blind) folded before Flop
Seat 3: LeaveItYeah (big blind) collected ($1)
Seat 4: Cositorto folded before Flop (didn't bet)
Seat 5: Rdalonso folded before Flop (didn't bet)



PokerStars Hand #254483518947:  Hold'em No Limit ($0.50/$1.00 USD) - 2025/01/21 13:49:52 WET [2025/01/21 8:49:52 ET]
Table 'Gyptis IV' 6-max Seat #2 is the button
Seat 6: Cle0patr4 ($115.21 in chips) is sitting out
Seat 1: Brookstj500 ($20.61 in chips) 
Seat 2: chinokevin13 ($114.36 in chips) 
Seat 3: LeaveItYeah ($103.22 in chips) 
Seat 4: Cositorto ($108.05 in chips) 
Seat 5: Rdalonso ($139.75 in chips) 
LeaveItYeah: posts small blind $0.50
Cositorto: posts big blind $1
Cle0patr4: sits out 
*** HOLE CARDS ***
Rdalonso: folds 
Brookstj500: raises $2.50 to $3.50
chinokevin13: folds 
LeaveItYeah: folds 
Cositorto: folds 
Uncalled bet ($2.50) returned to Brookstj500
Brookstj500 collected $2.50 from pot
Brookstj500: doesn't show hand 
*** SUMMARY ***
Total pot $2.50 | Rake $0 
Seat 6: Cle0patr4
Seat 1: Brookstj500 collected ($2.50)
Seat 2: chinokevin13 (button) folded before Flop (didn't bet)
Seat 3: LeaveItYeah (small blind) folded before Flop
Seat 4: Cositorto (big blind) folded before Flop
Seat 5: Rdalonso folded before Flop (didn't bet)



PokerStars Hand #254483523526:  Hold'em No Limit ($0.50/$1.00 USD) - 2025/01/21 13:50:21 WET [2025/01/21 8:50:21 ET]
Table 'Gyptis IV' 6-max Seat #3 is the button
Seat 6: Cle0patr4 ($115.21 in chips) is sitting out
Seat 1: Brookstj500 ($22.11 in chips) 
Seat 2: chinokevin13 ($114.36 in chips) 
Seat 3: LeaveItYeah ($102.72 in chips) 
Seat 4: Cositorto ($107.05 in chips) 
Seat 5: Rdalonso ($139.75 in chips) 
Cositorto: posts small blind $0.50
Rdalonso: posts big blind $1
Cle0patr4: sits out 
*** HOLE CARDS ***
Brookstj500: raises $2.50 to $3.50
chinokevin13: folds 
LeaveItYeah: folds 
Cositorto: folds 
Rdalonso: folds 
Uncalled bet ($2.50) returned to Brookstj500
Brookstj500 collected $2.50 from pot
Brookstj500: doesn't show hand 
*** SUMMARY ***
Total pot $2.50 | Rake $0 
Seat 6: Cle0patr4
Seat 1: Brookstj500 collected ($2.50)
Seat 2: chinokevin13 folded before Flop (didn't bet)
Seat 3: LeaveItYeah (button) folded before Flop (didn't bet)
Seat 4: Cositorto (small blind) folded before Flop
Seat 5: Rdalonso (big blind) folded before Flop



PokerStars Hand #254483525795:  Hold'em No Limit ($0.50/$1.00 USD) - 2025/01/21 13:50:34 WET [2025/01/21 8:50:34 ET]
Table 'Gyptis IV' 6-max Seat #4 is the button
Seat 1: Brookstj500 ($23.61 in chips) 
Seat 2: chinokevin13 ($114.36 in chips) 
Seat 3: LeaveItYeah ($102.72 in chips) 
Seat 4: Cositorto ($106.55 in chips) 
Seat 5: Rdalonso ($138.75 in chips) 
Seat 6: Cle0patr4 ($115.21 in chips) 
Rdalonso: posts small blind $0.50
Cle0patr4: posts big blind $1
*** HOLE CARDS ***
Brookstj500: calls $1
chinokevin13: folds 
LeaveItYeah: folds 
Cositorto: raises $2.50 to $3.50
Rdalonso: folds 
Cle0patr4: folds 
Brookstj500: calls $2.50
*** FLOP *** [As Jc 7d]
Brookstj500: checks 
Cositorto: bets $2.18
Brookstj500: folds 
Uncalled bet ($2.18) returned to Cositorto
Cositorto collected $8.08 from pot
Cositorto: doesn't show hand 
*** SUMMARY ***
Total pot $8.50 | Rake $0.42 
Board [As Jc 7d]
Seat 1: Brookstj500 folded on the Flop
Seat 2: chinokevin13 folded before Flop (didn't bet)
Seat 3: LeaveItYeah folded before Flop (didn't bet)
Seat 4: Cositorto (button) collected ($8.08)
Seat 5: Rdalonso (small blind) folded before Flop
Seat 6: Cle0patr4 (big blind) folded before Flop



PokerStars Hand #254483532786:  Hold'em No Limit ($0.50/$1.00 USD) - 2025/01/21 13:51:18 WET [2025/01/21 8:51:18 ET]
Table 'Gyptis IV' 6-max Seat #5 is the button
Seat 1: Brookstj500 ($20.11 in chips) 
Seat 2: chinokevin13 ($114.36 in chips) 
Seat 3: LeaveItYeah ($102.72 in chips) 
Seat 4: Cositorto ($111.13 in chips) 
Seat 5: Rdalonso ($138.25 in chips) 
Seat 6: Cle0patr4 ($114.21 in chips) 
Cle0patr4: posts small blind $0.50
Brookstj500: posts big blind $1
*** HOLE CARDS ***
chinokevin13: raises $1.20 to $2.20
LeaveItYeah: folds 
Cositorto: raises $4.40 to $6.60
Rdalonso: folds 
Cle0patr4: folds 
Brookstj500: folds 
chinokevin13: raises $11.40 to $18
Cositorto: calls $11.40
*** FLOP *** [6d 3s 5h]
chinokevin13: bets $11.75
Cositorto: calls $11.75
*** TURN *** [6d 3s 5h] [9d]
chinokevin13: checks 
Cositorto: checks 
*** RIVER *** [6d 3s 5h 9d] [2d]
chinokevin13: checks 
Cositorto: checks 
*** SHOW DOWN ***
chinokevin13: shows [Qc Ad] (high card Ace)
Cositorto: shows [Kd Ac] (high card Ace - King kicker)
Cositorto collected $58.50 from pot
*** SUMMARY ***
Total pot $61 | Rake $2.50 
Board [6d 3s 5h 9d 2d]
Seat 1: Brookstj500 (big blind) folded before Flop
Seat 2: chinokevin13 showed [Qc Ad] and lost with high card Ace
Seat 3: LeaveItYeah folded before Flop (didn't bet)
Seat 4: Cositorto showed [Kd Ac] and won ($58.50) with high card Ace
Seat 5: Rdalonso (button) folded before Flop (didn't bet)
Seat 6: Cle0patr4 (small blind) folded before Flop



PokerStars Hand #254483553084:  Hold'em No Limit ($0.50/$1.00 USD) - 2025/01/21 13:53:23 WET [2025/01/21 8:53:23 ET]
Table 'Gyptis IV' 6-max Seat #6 is the button
Seat 2: chinokevin13 ($100 in chips) is sitting out
Seat 1: Brookstj500 ($19.11 in chips) 
Seat 3: LeaveItYeah ($102.72 in chips) 
Seat 4: Cositorto ($139.88 in chips) 
Seat 5: Rdalonso ($138.25 in chips) 
Seat 6: Cle0patr4 ($113.71 in chips) 
Brookstj500: posts small blind $0.50
LeaveItYeah: posts big blind $1
*** HOLE CARDS ***
Cositorto: raises $1 to $2
Rdalonso: folds 
Cle0patr4: folds 
Brookstj500: folds 
LeaveItYeah: folds 
Uncalled bet ($1) returned to Cositorto
Cositorto collected $2.50 from pot
Cositorto: doesn't show hand 
*** SUMMARY ***
Total pot $2.50 | Rake $0 
Seat 2: chinokevin13
Seat 1: Brookstj500 (small blind) folded before Flop
Seat 3: LeaveItYeah (big blind) folded before Flop
Seat 4: Cositorto collected ($2.50)
Seat 5: Rdalonso folded before Flop (didn't bet)
Seat 6: Cle0patr4 (button) folded before Flop (didn't bet)



PokerStars Hand #254483556961:  Hold'em No Limit ($0.50/$1.00 USD) - 2025/01/21 13:53:46 WET [2025/01/21 8:53:46 ET]
Table 'Gyptis IV' 6-max Seat #1 is the button
Seat 2: chinokevin13 ($100 in chips) is sitting out
Seat 1: Brookstj500 ($18.61 in chips) 
Seat 3: LeaveItYeah ($101.72 in chips) 
Seat 4: Cositorto ($141.38 in chips) 
Seat 5: Rdalonso ($138.25 in chips) 
Seat 6: Cle0patr4 ($113.71 in chips) 
LeaveItYeah: posts small blind $0.50
Cositorto: posts big blind $1
*** HOLE CARDS ***
Rdalonso: folds 
Cle0patr4: raises $1 to $2
Brookstj500: folds 
LeaveItYeah: raises $9 to $11
Cositorto: folds 
Cle0patr4: folds 
Uncalled bet ($9) returned to LeaveItYeah
LeaveItYeah collected $5 from pot
LeaveItYeah: doesn't show hand 
*** SUMMARY ***
Total pot $5 | Rake $0 
Seat 2: chinokevin13
Seat 1: Brookstj500 (button) folded before Flop (didn't bet)
Seat 3: LeaveItYeah (small blind) collected ($5)
Seat 4: Cositorto (big blind) folded before Flop
Seat 5: Rdalonso folded before Flop (didn't bet)
Seat 6: Cle0patr4 folded before Flop



PokerStars Hand #254483559866:  Hold'em No Limit ($0.50/$1.00 USD) - 2025/01/21 13:54:04 WET [2025/01/21 8:54:04 ET]
Table 'Gyptis IV' 6-max Seat #3 is the button
Seat 2: chinokevin13 ($100 in chips) is sitting out
Seat 1: Brookstj500 ($18.61 in chips) 
Seat 3: LeaveItYeah ($104.72 in chips) 
Seat 4: Cositorto ($140.38 in chips) 
Seat 5: Rdalonso ($138.25 in chips) 
Seat 6: Cle0patr4 ($111.71 in chips) 
Cositorto: posts small blind $0.50
Rdalonso: posts big blind $1
*** HOLE CARDS ***
Cle0patr4: folds 
Brookstj500: folds 
LeaveItYeah: raises $1.50 to $2.50
Cositorto: raises $8.75 to $11.25
Rdalonso: folds 
LeaveItYeah: folds 
Uncalled bet ($8.75) returned to Cositorto
Cositorto collected $6 from pot
Cositorto: doesn't show hand 
*** SUMMARY ***
Total pot $6 | Rake $0 
Seat 2: chinokevin13
Seat 1: Brookstj500 folded before Flop (didn't bet)
Seat 3: LeaveItYeah (button) folded before Flop
Seat 4: Cositorto (small blind) collected ($6)
Seat 5: Rdalonso (big blind) folded before Flop
Seat 6: Cle0patr4 folded before Flop (didn't bet)



PokerStars Hand #254483564409:  Hold'em No Limit ($0.50/$1.00 USD) - 2025/01/21 13:54:32 WET [2025/01/21 8:54:32 ET]
Table 'Gyptis IV' 6-max Seat #4 is the button
Seat 2: chinokevin13 ($100 in chips) is sitting out
Seat 1: Brookstj500 ($18.61 in chips) 
Seat 3: LeaveItYeah ($102.22 in chips) 
Seat 4: Cositorto ($143.88 in chips) 
Seat 5: Rdalonso ($137.25 in chips) 
Seat 6: Cle0patr4 ($111.71 in chips) 
Rdalonso: posts small blind $0.50
Cle0patr4: posts big blind $1
*** HOLE CARDS ***
Brookstj500: folds 
LeaveItYeah: folds 
Cositorto: raises $1.50 to $2.50
Rdalonso: folds 
Cle0patr4: calls $1.50
*** FLOP *** [2c Ah 4s]
Cle0patr4: checks 
Cositorto: checks 
*** TURN *** [2c Ah 4s] [2s]
Cle0patr4: bets $2.77
Cositorto: folds 
Uncalled bet ($2.77) returned to Cle0patr4
Cle0patr4 collected $5.22 from pot
Cle0patr4: doesn't show hand 
*** SUMMARY ***
Total pot $5.50 | Rake $0.28 
Board [2c Ah 4s 2s]
Seat 2: chinokevin13
Seat 1: Brookstj500 folded before Flop (didn't bet)
Seat 3: LeaveItYeah folded before Flop (didn't bet)
Seat 4: Cositorto (button) folded on the Turn
Seat 5: Rdalonso (small blind) folded before Flop
Seat 6: Cle0patr4 (big blind) collected ($5.22)



PokerStars Hand #254483569366:  Hold'em No Limit ($0.50/$1.00 USD) - 2025/01/21 13:55:03 WET [2025/01/21 8:55:03 ET]
Table 'Gyptis IV' 6-max Seat #5 is the button
Seat 2: chinokevin13 ($100 in chips) is sitting out
Seat 1: Brookstj500 ($18.61 in chips) 
Seat 3: LeaveItYeah ($102.22 in chips) 
Seat 4: Cositorto ($141.38 in chips) 
Seat 5: Rdalonso ($136.75 in chips) 
Seat 6: Cle0patr4 ($114.43 in chips) 
Cle0patr4: posts small blind $0.50
Brookstj500: posts big blind $1
*** HOLE CARDS ***
LeaveItYeah: raises $1.10 to $2.10
Cositorto: folds 
Rdalonso: folds 
Cle0patr4: folds 
Brookstj500: calls $1.10
*** FLOP *** [Td Kh Qd]
Brookstj500: checks 
LeaveItYeah: bets $1.34
Brookstj500: folds 
Uncalled bet ($1.34) returned to LeaveItYeah
LeaveItYeah collected $4.46 from pot
LeaveItYeah: doesn't show hand 
*** SUMMARY ***
Total pot $4.70 | Rake $0.24 
Board [Td Kh Qd]
Seat 2: chinokevin13
Seat 1: Brookstj500 (big blind) folded on the Flop
Seat 3: LeaveItYeah collected ($4.46)
Seat 4: Cositorto folded before Flop (didn't bet)
Seat 5: Rdalonso (button) folded before Flop (didn't bet)
Seat 6: Cle0patr4 (small blind) folded before Flop



PokerStars Hand #254483574925:  Hold'em No Limit ($0.50/$1.00 USD) - 2025/01/21 13:55:46 WET [2025/01/21 8:55:46 ET]
Table 'Gyptis IV' 6-max Seat #6 is the button
Seat 2: chinokevin13 ($100 in chips) is sitting out
Seat 1: Brookstj500 ($16.51 in chips) 
Seat 3: LeaveItYeah ($104.58 in chips) 
Seat 4: Cositorto ($141.38 in chips) 
Seat 5: Rdalonso ($136.75 in chips) 
Seat 6: Cle0patr4 ($113.93 in chips) 
Brookstj500: posts small blind $0.50
LeaveItYeah: posts big blind $1
*** HOLE CARDS ***
Cositorto: folds 
Rdalonso: folds 
Cle0patr4: folds 
Brookstj500: raises $3 to $4
LeaveItYeah: folds 
Uncalled bet ($3) returned to Brookstj500
Brookstj500 collected $2 from pot
Brookstj500: doesn't show hand 
*** SUMMARY ***
Total pot $2 | Rake $0 
Seat 2: chinokevin13
Seat 1: Brookstj500 (small blind) collected ($2)
Seat 3: LeaveItYeah (big blind) folded before Flop
Seat 4: Cositorto folded before Flop (didn't bet)
Seat 5: Rdalonso folded before Flop (didn't bet)
Seat 6: Cle0patr4 (button) folded before Flop (didn't bet)



PokerStars Hand #254483577826:  Hold'em No Limit ($0.50/$1.00 USD) - 2025/01/21 13:56:09 WET [2025/01/21 8:56:09 ET]
Table 'Gyptis IV' 6-max Seat #1 is the button
Seat 2: chinokevin13 ($100 in chips) is sitting out
Seat 1: Brookstj500 ($17.51 in chips) 
Seat 3: LeaveItYeah ($103.58 in chips) 
Seat 4: Cositorto ($141.38 in chips) 
Seat 5: Rdalonso ($136.75 in chips) 
Seat 6: Cle0patr4 ($113.93 in chips) 
LeaveItYeah: posts small blind $0.50
Cositorto: posts big blind $1
*** HOLE CARDS ***
Rdalonso: folds 
Cle0patr4: raises $1 to $2
Brookstj500: calls $2
LeaveItYeah: folds 
Cositorto: folds 
*** FLOP *** [9h Ts Th]
Cle0patr4: checks 
Brookstj500: checks 
*** TURN *** [9h Ts Th] [4h]
Cle0patr4: bets $2.50
Brookstj500: calls $2.50
*** RIVER *** [9h Ts Th 4h] [8s]
Cle0patr4: bets $109.43 and is all-in
Brookstj500: calls $13.01 and is all-in
Uncalled bet ($96.42) returned to Cle0patr4
*** SHOW DOWN ***
Cle0patr4: shows [Qd Js] (a straight, Eight to Queen)
Brookstj500: shows [Jh Qc] (a straight, Eight to Queen)
Cle0patr4 collected $17.35 from pot
Brookstj500 collected $17.34 from pot
*** SUMMARY ***
Total pot $36.52 | Rake $1.83 
Board [9h Ts Th 4h 8s]
Seat 2: chinokevin13
Seat 1: Brookstj500 (button) showed [Jh Qc] and won ($17.34) with a straight, Eight to Queen
Seat 3: LeaveItYeah (small blind) folded before Flop
Seat 4: Cositorto (big blind) folded before Flop
Seat 5: Rdalonso folded before Flop (didn't bet)
Seat 6: Cle0patr4 showed [Qd Js] and won ($17.35) with a straight, Eight to Queen



PokerStars Hand #254483584359:  Hold'em No Limit ($0.50/$1.00 USD) - 2025/01/21 13:56:59 WET [2025/01/21 8:56:59 ET]
Table 'Gyptis IV' 6-max Seat #3 is the button
Seat 2: chinokevin13 ($100 in chips) is sitting out
Seat 1: Brookstj500 ($17.34 in chips) 
Seat 3: LeaveItYeah ($103.08 in chips) 
Seat 4: Cositorto ($140.38 in chips) 
Seat 5: Rdalonso ($136.75 in chips) 
Seat 6: Cle0patr4 ($113.77 in chips) 
Cositorto: posts small blind $0.50
Rdalonso: posts big blind $1
*** HOLE CARDS ***
Cle0patr4: folds 
Brookstj500: folds 
LeaveItYeah: raises $1.50 to $2.50
Cositorto: folds 
Rdalonso: calls $1.50
*** FLOP *** [3s 4d 5c]
Rdalonso: checks 
LeaveItYeah: checks 
*** TURN *** [3s 4d 5c] [7c]
Rdalonso: bets $1.72
LeaveItYeah: folds 
Uncalled bet ($1.72) returned to Rdalonso
Rdalonso collected $5.22 from pot
Rdalonso: doesn't show hand 
*** SUMMARY ***
Total pot $5.50 | Rake $0.28 
Board [3s 4d 5c 7c]
Seat 2: chinokevin13
Seat 1: Brookstj500 folded before Flop (didn't bet)
Seat 3: LeaveItYeah (button) folded on the Turn
Seat 4: Cositorto (small blind) folded before Flop
Seat 5: Rdalonso (big blind) collected ($5.22)
Seat 6: Cle0patr4 folded before Flop (didn't bet)



PokerStars Hand #254483590246:  Hold'em No Limit ($0.50/$1.00 USD) - 2025/01/21 13:57:44 WET [2025/01/21 8:57:44 ET]
Table 'Gyptis IV' 6-max Seat #4 is the button
Seat 2: chinokevin13 ($100 in chips) is sitting out
Seat 1: Brookstj500 ($17.34 in chips) 
Seat 3: LeaveItYeah ($100.58 in chips) 
Seat 4: Cositorto ($139.88 in chips) 
Seat 5: Rdalonso ($139.47 in chips) 
Seat 6: Cle0patr4 ($113.77 in chips) 
Rdalonso: posts small blind $0.50
Cle0patr4: posts big blind $1
*** HOLE CARDS ***
Brookstj500: folds 
LeaveItYeah: folds 
Cositorto: folds 
Rdalonso: folds 
Uncalled bet ($0.50) returned to Cle0patr4
Cle0patr4 collected $1 from pot
Cle0patr4: doesn't show hand 
*** SUMMARY ***
Total pot $1 | Rake $0 
Seat 2: chinokevin13
Seat 1: Brookstj500 folded before Flop (didn't bet)
Seat 3: LeaveItYeah folded before Flop (didn't bet)
Seat 4: Cositorto (button) folded before Flop (didn't bet)
Seat 5: Rdalonso (small blind) folded before Flop
Seat 6: Cle0patr4 (big blind) collected ($1)



PokerStars Hand #254483592446:  Hold'em No Limit ($0.50/$1.00 USD) - 2025/01/21 13:58:01 WET [2025/01/21 8:58:01 ET]
Table 'Gyptis IV' 6-max Seat #5 is the button
Seat 2: chinokevin13 ($100 in chips) is sitting out
Seat 1: Brookstj500 ($17.34 in chips) 
Seat 3: LeaveItYeah ($100.58 in chips) 
Seat 4: Cositorto ($139.88 in chips) 
Seat 5: Rdalonso ($138.97 in chips) 
Seat 6: Cle0patr4 ($114.27 in chips) 
Cle0patr4: posts small blind $0.50
Brookstj500: posts big blind $1
*** HOLE CARDS ***
LeaveItYeah: folds 
Cositorto: raises $1 to $2
Rdalonso: folds 
Cle0patr4: folds 
Brookstj500: calls $1
*** FLOP *** [5h As 8h]
Brookstj500: checks 
Cositorto: bets $1.16
Brookstj500: folds 
Uncalled bet ($1.16) returned to Cositorto
Cositorto collected $4.28 from pot
Cositorto: doesn't show hand 
*** SUMMARY ***
Total pot $4.50 | Rake $0.22 
Board [5h As 8h]
Seat 2: chinokevin13
Seat 1: Brookstj500 (big blind) folded on the Flop
Seat 3: LeaveItYeah folded before Flop (didn't bet)
Seat 4: Cositorto collected ($4.28)
Seat 5: Rdalonso (button) folded before Flop (didn't bet)
Seat 6: Cle0patr4 (small blind) folded before Flop



PokerStars Hand #254483596519:  Hold'em No Limit ($0.50/$1.00 USD) - 2025/01/21 13:58:32 WET [2025/01/21 8:58:32 ET]
Table 'Gyptis IV' 6-max Seat #6 is the button
Seat 2: chinokevin13 ($100 in chips) is sitting out
Seat 1: Brookstj500 ($15.34 in chips) 
Seat 3: LeaveItYeah ($100.58 in chips) 
Seat 4: Cositorto ($142.16 in chips) 
Seat 5: Rdalonso ($138.97 in chips) 
Seat 6: Cle0patr4 ($113.77 in chips) 
Brookstj500: posts small blind $0.50
LeaveItYeah: posts big blind $1
*** HOLE CARDS ***
Cositorto: folds 
Rdalonso: folds 
Cle0patr4: raises $1 to $2
Brookstj500: calls $1.50
LeaveItYeah: folds 
*** FLOP *** [Td 9c 8c]
Brookstj500: checks 
Cle0patr4: bets $1.05
Brookstj500: raises $12.29 to $13.34 and is all-in
Cle0patr4: folds 
Uncalled bet ($12.29) returned to Brookstj500
Brookstj500 collected $6.74 from pot
Brookstj500: doesn't show hand 
*** SUMMARY ***
Total pot $7.10 | Rake $0.36 
Board [Td 9c 8c]
Seat 2: chinokevin13
Seat 1: Brookstj500 (small blind) collected ($6.74)
Seat 3: LeaveItYeah (big blind) folded before Flop
Seat 4: Cositorto folded before Flop (didn't bet)
Seat 5: Rdalonso folded before Flop (didn't bet)
Seat 6: Cle0patr4 (button) folded on the Flop



PokerStars Hand #254483639958:  Hold'em No Limit ($0.50/$1.00 USD) - 2025/01/21 14:03:20 WET [2025/01/21 9:03:20 ET]
Table 'Gyptis IV' 6-max Seat #2 is the button
Seat 5: blistein ($100 in chips) is sitting out
Seat 6: peter76255 ($0 in chips) is sitting out
Seat 1: Cositorto ($186.01 in chips) 
Seat 2: Dearic99 ($143.18 in chips) 
Seat 3: LeaveItYeah ($100 in chips) 
Seat 4: Rysiff ($100 in chips) 
LeaveItYeah: posts small blind $0.50
Rysiff: posts big blind $1
blistein: sits out 
*** HOLE CARDS ***
Cositorto: folds 
peter76255 leaves the table
Dearic99: raises $1.50 to $2.50
LeaveItYeah: folds 
Rysiff: folds 
Uncalled bet ($1.50) returned to Dearic99
Dearic99 collected $2.50 from pot
Dearic99: doesn't show hand 
*** SUMMARY ***
Total pot $2.50 | Rake $0 
Seat 5: blistein
Seat 6: peter76255
Seat 1: Cositorto folded before Flop (didn't bet)
Seat 2: Dearic99 (button) collected ($2.50)
Seat 3: LeaveItYeah (small blind) folded before Flop
Seat 4: Rysiff (big blind) folded before Flop



PokerStars Hand #254483641843:  Hold'em No Limit ($0.50/$1.00 USD) - 2025/01/21 14:03:31 WET [2025/01/21 9:03:31 ET]
Table 'Gyptis IV' 6-max Seat #3 is the button
Seat 1: Cositorto ($186.01 in chips) 
Seat 2: Dearic99 ($144.68 in chips) 
Seat 3: LeaveItYeah ($100 in chips) 
Seat 4: Rysiff ($100 in chips) 
Seat 5: blistein ($100 in chips) 
Rysiff: posts small blind $0.50
blistein: posts big blind $1
*** HOLE CARDS ***
Cositorto: raises $1 to $2
Dearic99: folds 
LeaveItYeah: folds 
Rysiff: folds 
blistein: calls $1
*** FLOP *** [Ah Kc 8h]
blistein: checks 
Cositorto: bets $4.28
blistein: calls $4.28
*** TURN *** [Ah Kc 8h] [As]
blistein: checks 
Cositorto: checks 
*** RIVER *** [Ah Kc 8h As] [5d]
blistein: checks 
Cositorto: checks 
*** SHOW DOWN ***
blistein: shows [Ks Qh] (two pair, Aces and Kings)
Cositorto: mucks hand 
blistein collected $12.41 from pot
*** SUMMARY ***
Total pot $13.06 | Rake $0.65 
Board [Ah Kc 8h As 5d]
Seat 1: Cositorto mucked
Seat 2: Dearic99 folded before Flop (didn't bet)
Seat 3: LeaveItYeah (button) folded before Flop (didn't bet)
Seat 4: Rysiff (small blind) folded before Flop
Seat 5: blistein (big blind) showed [Ks Qh] and won ($12.41) with two pair, Aces and Kings



PokerStars Hand #254483655554:  Hold'em No Limit ($0.50/$1.00 USD) - 2025/01/21 14:04:52 WET [2025/01/21 9:04:52 ET]
Table 'Gyptis IV' 6-max Seat #4 is the button
Seat 1: Cositorto ($179.73 in chips) is sitting out
Seat 2: Dearic99 ($144.68 in chips) 
Seat 3: LeaveItYeah ($100 in chips) 
Seat 4: Rysiff ($100 in chips) 
Seat 5: blistein ($106.13 in chips) 
blistein: posts small blind $0.50
Cositorto: is sitting out 
Dearic99: posts big blind $1
*** HOLE CARDS ***
LeaveItYeah: folds 
Rysiff: folds 
blistein: raises $2 to $3
Rysiff leaves the table
Dearic99: folds 
Uncalled bet ($2) returned to blistein
blistein collected $2 from pot
blistein: doesn't show hand 
*** SUMMARY ***
Total pot $2 | Rake $0 
Seat 1: Cositorto
Seat 2: Dearic99 (big blind) folded before Flop
Seat 3: LeaveItYeah folded before Flop (didn't bet)
Seat 4: Rysiff (button) folded before Flop (didn't bet)
Seat 5: blistein (small blind) collected ($2)



PokerStars Hand #254483657918:  Hold'em No Limit ($0.50/$1.00 USD) - 2025/01/21 14:05:05 WET [2025/01/21 9:05:05 ET]
Table 'Gyptis IV' 6-max Seat #5 is the button
Seat 1: Cositorto ($179.73 in chips) is sitting out
Seat 2: Dearic99 ($143.68 in chips) 
Seat 3: LeaveItYeah ($100 in chips) 
Seat 5: blistein ($107.13 in chips) 
Dearic99: posts small blind $0.50
LeaveItYeah: posts big blind $1
*** HOLE CARDS ***
blistein: raises $1.50 to $2.50
Dearic99: folds 
LeaveItYeah: folds 
Uncalled bet ($1.50) returned to blistein
blistein collected $2.50 from pot
blistein: doesn't show hand 
LeaveItYeah leaves the table
*** SUMMARY ***
Total pot $2.50 | Rake $0 
Seat 1: Cositorto
Seat 2: Dearic99 (small blind) folded before Flop
Seat 3: LeaveItYeah (big blind) folded before Flop
Seat 5: blistein (button) collected ($2.50)



